type,id,status,description,amount,account,balance,direction,class,institution,connection,enrich,transactionDate,postDate,subClass,links
transaction,4957bcf6-f18f-43d7-94df-71f44a0bcf32,posted,Wdl ATM WES IGA BALGOWLAH HGT  BALGOWL        AU,-200,d3de1ca1,22109.56,debit,cash-withdrawal,AU00000,1bd6c08e-8457-4a74-bdd9-514df489d27e,null,3/08/2023,2023-08-03T00:07:36,null,"{""account"":""https://au-api.basiq.io/users/6a52015e/accounts/31eb30a0"",""institution"":""https://au-api.basiq.io/institutions/AU00000"",""self"":""https://au-api.basiq.io/users/6a52015e/transactions/2082c765""}"
transaction,0d6e11ab-e28e-4de0-a152-600cc44fb61c,posted,Non Hooli ATM Withdrawal Fee,-2.5,070c1d68-0ee0-477a-9679-294ea7059939,22309.56,debit,bank-fee,AU00000,1bd6c08e-8457-4a74-bdd9-514df489d27e,null,3/08/2023,2023-08-03T00:00:00Z,"{\title\"":\""\""","\""code\"":\""card\""}"""
transaction,323f6d42-a38e-4c46-83d2-6c8f3e999686,posted,Wdl ATM WES IGA BALGOWLAH HGT  BALGOWL        AU,-200,070c1d68-0ee0-477a-9679-294ea7059939,22312.06,debit,cash-withdrawal,AU00000,1bd6c08e-8457-4a74-bdd9-514df489d27e,null,3/08/2023,2023-08-03T00:00:00Z,null,"{\self\"":\""https://au-api.basiq.io/users/bca4b9cc-b7e2-4458-83bc-4855c147bd70/transactions/323f6d42-a38e-4c46-83d2-6c8f3e999686\"""
transaction,1ab3a3c5-faeb-4de3-b5aa-612e5bc76fd5,posted,Non Hooli ATM Withdrawal Fee,-2.5,070c1d68-0ee0-477a-9679-294ea7059939,22512.06,debit,bank-fee,AU00000,1bd6c08e-8457-4a74-bdd9-514df489d27e,null,3/08/2023,2023-08-03T00:00:00Z,"{\title\"":\""\""","\""code\"":\""card\""}"""
transaction,d12df6a2-48b6-4f5f-a718-ccb377aa330c,posted,Transfer Platnm Homeloan 346454,-3852.5,070c1d68-0ee0-477a-9679-294ea7059939,22514.56,debit,payment,AU00000,1bd6c08e-8457-4a74-bdd9-514df489d27e,null,29/07/2023,2023-07-29T00:00:00Z,"{\title\"":\""Auxiliary Finance and Investment Services\""","\""code\"":\""641\""}"""
transaction,08e6f7c9-f359-48f2-b086-a55f468f2f60,posted,TFR From Transaction to CC Acc 13,-9406,070c1d68-0ee0-477a-9679-294ea7059939,26367.06,debit,payment,AU00000,1bd6c08e-8457-4a74-bdd9-514df489d27e,null,28/07/2023,2023-07-28T00:00:00Z,"{\title\"":\""Civic","Professional and Other Interest Group Services\"""
transaction,53570fde-c731-4e33-8224-0583650eeaa7,posted,Payroll WFRMS 15439393,17098,070c1d68-0ee0-477a-9679-294ea7059939,35773.06,credit,transfer,AU00000,1bd6c08e-8457-4a74-bdd9-514df489d27e,null,28/07/2023,2023-07-28T00:00:00Z,"{\title\"":\""Unknown\""","\""code\"":\""0\""}"""
transaction,55dbdd71-9976-43ec-a724-7cf620d279d4,posted,Manly Maths Tutor Wages,201,070c1d68-0ee0-477a-9679-294ea7059939,18675.06,credit,transfer,AU00000,1bd6c08e-8457-4a74-bdd9-514df489d27e,null,17/07/2023,2023-07-17T00:00:00Z,"{\title\"":\""Educational Support Services\""","\""code\"":\""822\""}"""
transaction,17b710a5-da3d-42f8-ae31-f9d601f95c6d,posted,MANLY WEST SCHOOL,-1422.2,070c1d68-0ee0-477a-9679-294ea7059939,18474.06,debit,payment,AU00000,1bd6c08e-8457-4a74-bdd9-514df489d27e,null,16/07/2023,2023-07-16T00:00:00Z,"{\title\"":\""School Education\""","\""code\"":\""802\""}"""
transaction,d93fb495-8a7a-4997-8a16-b3581b778471,posted,MANLY WEST SCHOOL,-51,070c1d68-0ee0-477a-9679-294ea7059939,19896.26,debit,payment,AU00000,1bd6c08e-8457-4a74-bdd9-514df489d27e,null,16/07/2023,2023-07-16T00:00:00Z,"{\title\"":\""School Education\""","\""code\"":\""802\""}"""
transaction,6ba3dd59-4268-419d-b5aa-49df88c11c71,posted,Funds Transfer Transfer,3001,070c1d68-0ee0-477a-9679-294ea7059939,19947.26,credit,transfer,AU00000,1bd6c08e-8457-4a74-bdd9-514df489d27e,null,13/07/2023,2023-07-13T00:00:00Z,"{\title\"":\""Auxiliary Finance and Investment Services\""","\""code\"":\""641\""}"""
transaction,7d9413b0-694f-4b62-aac9-c178a6f069c6,posted,Manly Maths Tutor Wages,201,070c1d68-0ee0-477a-9679-294ea7059939,16946.26,credit,transfer,AU00000,1bd6c08e-8457-4a74-bdd9-514df489d27e,null,13/07/2023,2023-07-13T00:00:00Z,"{\title\"":\""Educational Support Services\""","\""code\"":\""822\""}"""
transaction,4f3bb9a5-9597-4d71-80db-fae35b70edcd,posted,TFR Acc14000 TO 12389,-500,070c1d68-0ee0-477a-9679-294ea7059939,16745.26,debit,payment,AU00000,1bd6c08e-8457-4a74-bdd9-514df489d27e,null,12/07/2023,2023-07-12T00:00:00Z,"{\title\"":\""Legal and Accounting Services\""","\""code\"":\""693\""}"""
transaction,9cf8a7ac-0e8b-4699-81e6-98181bdf18cf,posted,AGL RETAIL ENERGY LTD (GAS),-78,070c1d68-0ee0-477a-9679-294ea7059939,17245.26,debit,payment,AU00000,1bd6c08e-8457-4a74-bdd9-514df489d27e,null,9/07/2023,2023-07-09T00:00:00Z,"{\title\"":\""Electricity Distribution\""","\""code\"":\""263\""}"""
transaction,d5a36da2-5b9f-4dbf-aa95-eb518d163f0f,posted,Wdl ATM CBA ATM  SEAFORTH       NSW 225101   AUS,-750,070c1d68-0ee0-477a-9679-294ea7059939,17323.26,debit,cash-withdrawal,AU00000,1bd6c08e-8457-4a74-bdd9-514df489d27e,null,3/07/2023,2023-07-03T00:00:00Z,null,"{\self\"":\""https://au-api.basiq.io/users/bca4b9cc-b7e2-4458-83bc-4855c147bd70/transactions/d5a36da2-5b9f-4dbf-aa95-eb518d163f0f\"""
transaction,70aa3766-93eb-4da6-ab69-299b16507794,posted,Transfer Platnm Homeloan 346454,-3860,070c1d68-0ee0-477a-9679-294ea7059939,18073.26,debit,payment,AU00000,1bd6c08e-8457-4a74-bdd9-514df489d27e,null,28/06/2023,2023-06-28T00:00:00Z,"{\title\"":\""Auxiliary Finance and Investment Services\""","\""code\"":\""641\""}"""
transaction,6b8f916b-3317-4a5a-818b-82b008f67d84,posted,TFR From Transaction to CC Acc 13,-9398.5,070c1d68-0ee0-477a-9679-294ea7059939,21933.26,debit,payment,AU00000,1bd6c08e-8457-4a74-bdd9-514df489d27e,null,27/06/2023,2023-06-27T00:00:00Z,"{\title\"":\""Civic","Professional and Other Interest Group Services\"""
transaction,7dbf9e0f-e172-4474-9427-69fbb2d46752,posted,Payroll WFRMS 15439393,17098,070c1d68-0ee0-477a-9679-294ea7059939,31331.76,credit,transfer,AU00000,1bd6c08e-8457-4a74-bdd9-514df489d27e,null,27/06/2023,2023-06-27T00:00:00Z,"{\title\"":\""Unknown\""","\""code\"":\""0\""}"""
transaction,d4f55027-9c2f-4288-8580-0969738f4d78,posted,CTRLINK CARERS Ref: 998R6789201610974V,19.6,070c1d68-0ee0-477a-9679-294ea7059939,14233.76,credit,transfer,AU00000,1bd6c08e-8457-4a74-bdd9-514df489d27e,null,22/06/2023,2023-06-22T00:00:00Z,"{\title\"":\""Unknown\""","\""code\"":\""0\""}"""
transaction,e24adcd4-4a91-4a0e-bc57-48256635e051,posted,Manly Maths Tutor Wages,201,070c1d68-0ee0-477a-9679-294ea7059939,14214.16,credit,transfer,AU00000,1bd6c08e-8457-4a74-bdd9-514df489d27e,null,19/06/2023,2023-06-19T00:00:00Z,"{\title\"":\""Educational Support Services\""","\""code\"":\""822\""}"""
transaction,a5fd3de7-1d3b-44e9-8821-d01dc852a0d7,posted,MANLY WEST SCHOOL,-1422.2,070c1d68-0ee0-477a-9679-294ea7059939,14013.16,debit,payment,AU00000,1bd6c08e-8457-4a74-bdd9-514df489d27e,null,19/06/2023,2023-06-18T00:00:00Z,"{\title\"":\""School Education\""","\""code\"":\""802\""}"""
transaction,358ed9c0-46c0-486e-bedc-fe05cb2d7030,posted,MANLY WEST SCHOOL,-51,070c1d68-0ee0-477a-9679-294ea7059939,15435.36,debit,payment,AU00000,1bd6c08e-8457-4a74-bdd9-514df489d27e,null,18/06/2023,2023-06-18T00:00:00Z,"{\title\"":\""School Education\""","\""code\"":\""802\""}"""
transaction,7aa1234e-4132-4dcb-8cd2-c2adeeb43891,posted,Manly Maths Tutor Wages,201,070c1d68-0ee0-477a-9679-294ea7059939,15486.36,credit,transfer,AU00000,1bd6c08e-8457-4a74-bdd9-514df489d27e,null,15/06/2023,2023-06-15T00:00:00Z,"{\title\"":\""Educational Support Services\""","\""code\"":\""822\""}"""
transaction,793923f1-00e1-4181-b518-13feac5adca9,posted,TFR Acc14000 TO 12389,-500,070c1d68-0ee0-477a-9679-294ea7059939,15285.36,debit,payment,AU00000,1bd6c08e-8457-4a74-bdd9-514df489d27e,null,14/06/2023,2023-06-14T00:00:00Z,"{\title\"":\""Legal and Accounting Services\""","\""code\"":\""693\""}"""
transaction,305aba74-a09e-470d-9079-f386936b08b8,posted,AGL RETAIL ENERGY LTD (GAS),-78,070c1d68-0ee0-477a-9679-294ea7059939,15785.36,debit,payment,AU00000,1bd6c08e-8457-4a74-bdd9-514df489d27e,null,11/06/2023,2023-06-11T00:00:00Z,"{\title\"":\""Electricity Distribution\""","\""code\"":\""263\""}"""
transaction,32f52553-c38d-473f-994d-3e6dcf949268,posted,CTRLINK CARERS Ref: 998R6789201610974V,26,070c1d68-0ee0-477a-9679-294ea7059939,15863.36,credit,transfer,AU00000,1bd6c08e-8457-4a74-bdd9-514df489d27e,null,1/06/2023,2023-06-01T00:00:00Z,"{\title\"":\""Unknown\""","\""code\"":\""0\""}"""
transaction,78a8f7f6-5978-4985-a3d8-66f01838978c,posted,Transfer Platnm Homeloan 346454,-3867.5,070c1d68-0ee0-477a-9679-294ea7059939,15837.36,debit,payment,AU00000,1bd6c08e-8457-4a74-bdd9-514df489d27e,null,31/05/2023,2023-05-31T00:00:00Z,"{\title\"":\""Auxiliary Finance and Investment Services\""","\""code\"":\""641\""}"""
transaction,0b31ba00-2629-49d0-b5a3-ff18398efc7a,posted,TFR From Transaction to CC Acc 13,-9391,070c1d68-0ee0-477a-9679-294ea7059939,19704.86,debit,payment,AU00000,1bd6c08e-8457-4a74-bdd9-514df489d27e,null,30/05/2023,2023-05-30T00:00:00Z,"{\title\"":\""Civic","Professional and Other Interest Group Services\"""
transaction,d5944ba8-8211-4036-a412-aa25def5c61f,posted,Payroll WFRMS 15439393,17098,070c1d68-0ee0-477a-9679-294ea7059939,29095.86,credit,transfer,AU00000,1bd6c08e-8457-4a74-bdd9-514df489d27e,null,30/05/2023,2023-05-30T00:00:00Z,"{\title\"":\""Unknown\""","\""code\"":\""0\""}"""
transaction,1fe000a0-ccc3-4752-9fbc-f939a9473300,posted,MANLY WEST SCHOOL,-20,070c1d68-0ee0-477a-9679-294ea7059939,11997.86,debit,payment,AU00000,1bd6c08e-8457-4a74-bdd9-514df489d27e,null,28/05/2023,2023-05-28T00:00:00Z,"{\title\"":\""School Education\""","\""code\"":\""802\""}"""
transaction,5564eeb5-2aad-49ac-93bc-93d0c78c4ebc,posted,AGL RETAIL ENERGY LTD (GAS),-384.5,070c1d68-0ee0-477a-9679-294ea7059939,12017.86,debit,payment,AU00000,1bd6c08e-8457-4a74-bdd9-514df489d27e,null,22/05/2023,2023-05-22T00:00:00Z,"{\title\"":\""Electricity Distribution\""","\""code\"":\""263\""}"""
transaction,e50bf6c2-6ab1-4005-8c2e-590221581418,posted,AGL RETAIL ENERGY LTD,-186.79,070c1d68-0ee0-477a-9679-294ea7059939,12402.36,debit,payment,AU00000,1bd6c08e-8457-4a74-bdd9-514df489d27e,null,22/05/2023,2023-05-22T00:00:00Z,"{\title\"":\""Electricity Distribution\""","\""code\"":\""263\""}"""
transaction,3447238a-2fdb-4ece-80d3-64a1eb9b9324,posted,Funds Transfer transfer,3001,070c1d68-0ee0-477a-9679-294ea7059939,12589.15,credit,transfer,AU00000,1bd6c08e-8457-4a74-bdd9-514df489d27e,null,22/05/2023,2023-05-22T00:00:00Z,"{\title\"":\""Auxiliary Finance and Investment Services\""","\""code\"":\""641\""}"""
transaction,205e2a5b-dcd1-4fbe-8375-9d25a0366697,posted,TFR Acc14000 TO 12389,-500,070c1d68-0ee0-477a-9679-294ea7059939,9588.15,debit,payment,AU00000,1bd6c08e-8457-4a74-bdd9-514df489d27e,null,14/05/2023,2023-05-14T00:00:00Z,"{\title\"":\""Legal and Accounting Services\""","\""code\"":\""693\""}"""
transaction,b82187ad-dfcd-4d03-ada2-c0675dd270c4,posted,Funds Transfer topup,1301,070c1d68-0ee0-477a-9679-294ea7059939,10088.15,credit,transfer,AU00000,1bd6c08e-8457-4a74-bdd9-514df489d27e,null,11/05/2023,2023-05-11T00:00:00Z,"{\title\"":\""Telecommunications Services\""","\""code\"":\""580\""}"""
transaction,2f18608b-d9ec-4f7c-aab1-4d3ef53fe4d8,posted,AGL RETAIL ENERGY LTD (GAS),-78,070c1d68-0ee0-477a-9679-294ea7059939,8787.15,debit,payment,AU00000,1bd6c08e-8457-4a74-bdd9-514df489d27e,null,10/05/2023,2023-05-10T00:00:00Z,"{\title\"":\""Electricity Distribution\""","\""code\"":\""263\""}"""
transaction,51ce8653-b79f-4047-a20f-5829d53e9a34,posted,Transfer Platnm Homeloan 346454,-3875,070c1d68-0ee0-477a-9679-294ea7059939,8865.15,debit,payment,AU00000,1bd6c08e-8457-4a74-bdd9-514df489d27e,null,30/04/2023,2023-04-30T00:00:00Z,"{\title\"":\""Auxiliary Finance and Investment Services\""","\""code\"":\""641\""}"""
transaction,650ee7e3-59fb-4c4e-aba8-f061b15c96d5,posted,TFR From Transaction to CC Acc 13,-9383.5,070c1d68-0ee0-477a-9679-294ea7059939,12740.15,debit,payment,AU00000,1bd6c08e-8457-4a74-bdd9-514df489d27e,null,29/04/2023,2023-04-29T00:00:00Z,"{\title\"":\""Civic","Professional and Other Interest Group Services\"""
transaction,c88e1126-3e99-40fc-b733-d2c71cc15b8b,posted,Payroll WFRMS 15439393,17098,070c1d68-0ee0-477a-9679-294ea7059939,22123.65,credit,transfer,AU00000,1bd6c08e-8457-4a74-bdd9-514df489d27e,null,29/04/2023,2023-04-29T00:00:00Z,"{\title\"":\""Unknown\""","\""code\"":\""0\""}"""
transaction,536e0439-f9e1-4ebc-a256-22565dd19afc,posted,Manly Maths Tutor Wages,201,070c1d68-0ee0-477a-9679-294ea7059939,5025.65,credit,transfer,AU00000,1bd6c08e-8457-4a74-bdd9-514df489d27e,null,14/04/2023,2023-04-14T00:00:00Z,"{\title\"":\""Educational Support Services\""","\""code\"":\""822\""}"""
transaction,6e7b9ddc-f5f0-4a33-ab7f-82198378e043,posted,TFR Acc14000 TO 12389,-500,070c1d68-0ee0-477a-9679-294ea7059939,4824.65,debit,payment,AU00000,1bd6c08e-8457-4a74-bdd9-514df489d27e,null,13/04/2023,2023-04-13T00:00:00Z,"{\title\"":\""Legal and Accounting Services\""","\""code\"":\""693\""}"""
transaction,5267154d-9096-4e8b-9b43-8f8072fb0882,posted,AGL RETAIL LTD 005473584884,-78,070c1d68-0ee0-477a-9679-294ea7059939,5324.65,debit,payment,AU00000,1bd6c08e-8457-4a74-bdd9-514df489d27e,null,9/04/2023,2023-04-09T00:00:00Z,"{\title\"":\""Electricity Distribution\""","\""code\"":\""263\""}"""
transaction,ee7de86b-39f3-4cbf-b2e7-f20e1d46f841,posted,Wdl ATM WESTPAC IGA BALGOWLAH  BALGOWL        AU,-200,070c1d68-0ee0-477a-9679-294ea7059939,5402.65,debit,cash-withdrawal,AU00000,1bd6c08e-8457-4a74-bdd9-514df489d27e,null,7/04/2023,2023-04-07T00:00:00Z,null,"{\self\"":\""https://au-api.basiq.io/users/bca4b9cc-b7e2-4458-83bc-4855c147bd70/transactions/ee7de86b-39f3-4cbf-b2e7-f20e1d46f841\"""
transaction,5fa9e625-332c-476a-88d1-5f930f074177,posted,Non Hooli ATM Withdrawal Fee,-2.5,070c1d68-0ee0-477a-9679-294ea7059939,5602.65,debit,bank-fee,AU00000,1bd6c08e-8457-4a74-bdd9-514df489d27e,null,7/04/2023,2023-04-07T00:00:00Z,"{\title\"":\""\""","\""code\"":\""card\""}"""
transaction,ee7de86b-39f3-4cbf-b2e7-f20e1d46f841,posted,Wdl ATM WESTPAC IGA BALGOWLAH  BALGOWL        AU,-200,070c1d68-0ee0-477a-9679-294ea7059939,5402.65,debit,cash-withdrawal,AU00000,1bd6c08e-8457-4a74-bdd9-514df489d27e,null,7/04/2023,2023-04-07T00:00:00Z,null,"{\self\"":\""https://au-api.basiq.io/users/bca4b9cc-b7e2-4458-83bc-4855c147bd70/transactions/ee7de86b-39f3-4cbf-b2e7-f20e1d46f841\"""
transaction,5fa9e625-332c-476a-88d1-5f930f074177,posted,Non Hooli ATM Withdrawal Fee,-2.5,070c1d68-0ee0-477a-9679-294ea7059939,5602.65,debit,bank-fee,AU00000,1bd6c08e-8457-4a74-bdd9-514df489d27e,null,7/04/2023,2023-04-07T00:00:00Z,"{\title\"":\""\""","\""code\"":\""card\""}"""
transaction,ee7de86b-39f3-4cbf-b2e7-f20e1d46f841,posted,Wdl ATM WESTPAC IGA BALGOWLAH  BALGOWL        AU,-200,070c1d68-0ee0-477a-9679-294ea7059939,5402.65,debit,cash-withdrawal,AU00000,1bd6c08e-8457-4a74-bdd9-514df489d27e,null,7/04/2023,2023-04-07T00:00:00Z,null,"{\self\"":\""https://au-api.basiq.io/users/bca4b9cc-b7e2-4458-83bc-4855c147bd70/transactions/ee7de86b-39f3-4cbf-b2e7-f20e1d46f841\"""
transaction,5fa9e625-332c-476a-88d1-5f930f074177,posted,Non Hooli ATM Withdrawal Fee,-2.5,070c1d68-0ee0-477a-9679-294ea7059939,5602.65,debit,bank-fee,AU00000,1bd6c08e-8457-4a74-bdd9-514df489d27e,null,7/04/2023,2023-04-07T00:00:00Z,"{\title\"":\""\""","\""code\"":\""card\""}"""
transaction,f3470ce7-8fc9-42c6-8205-53cc78215d99,posted,AGL RETAIL ENERGY LTD (GAS),-18.22,070c1d68-0ee0-477a-9679-294ea7059939,6010.15,debit,payment,AU00000,1bd6c08e-8457-4a74-bdd9-514df489d27e,null,6/04/2023,2023-04-06T00:00:00Z,"{\title\"":\""Electricity Distribution\""","\""code\"":\""263\""}"""
transaction,3c68c201-c670-417e-a55a-d9ac0b05bd20,posted,Wdl ATM WESTPAC IGA BALGOWLAH  BALGOWL        AU,-450,070c1d68-0ee0-477a-9679-294ea7059939,6028.37,debit,cash-withdrawal,AU00000,1bd6c08e-8457-4a74-bdd9-514df489d27e,null,4/04/2023,2023-04-04T00:00:00Z,null,"{\self\"":\""https://au-api.basiq.io/users/bca4b9cc-b7e2-4458-83bc-4855c147bd70/transactions/3c68c201-c670-417e-a55a-d9ac0b05bd20\"""
transaction,986c390f-7251-45f1-b359-a1b6c3c6de60,posted,Non Hooli ATM Withdrawal Fee,-2.5,070c1d68-0ee0-477a-9679-294ea7059939,6478.37,debit,bank-fee,AU00000,1bd6c08e-8457-4a74-bdd9-514df489d27e,null,4/04/2023,2023-04-04T00:00:00Z,"{\title\"":\""\""","\""code\"":\""card\""}"""
transaction,3b3deb96-19b0-4e87-b177-586cad15bff7,posted,Wdl ATM WESTPAC IGA BALGOWLAH  BALGOWL        AU,-300,070c1d68-0ee0-477a-9679-294ea7059939,6480.87,debit,cash-withdrawal,AU00000,1bd6c08e-8457-4a74-bdd9-514df489d27e,null,4/04/2023,2023-04-04T00:00:00Z,null,"{\self\"":\""https://au-api.basiq.io/users/bca4b9cc-b7e2-4458-83bc-4855c147bd70/transactions/3b3deb96-19b0-4e87-b177-586cad15bff7\"""
transaction,3b3deb96-19b0-4e87-b177-586cad15bff7,posted,Wdl ATM WESTPAC IGA BALGOWLAH  BALGOWL        AU,-300,070c1d68-0ee0-477a-9679-294ea7059939,6480.87,debit,cash-withdrawal,AU00000,1bd6c08e-8457-4a74-bdd9-514df489d27e,null,4/04/2033,2023-04-04T00:00:00Z,null,"{\self\"":\""https://au-api.basiq.io/users/bca4b9cc-b7e2-4458-83bc-4855c147bd70/transactions/3b3deb96-19b0-4e87-b177-586cad15bff7\"""
transaction,b8f96f64-c37b-41ae-8270-c9a48cf9109e,posted,Non Hooli ATM Withdrawal Fee,-2.5,070c1d68-0ee0-477a-9679-294ea7059939,6780.87,debit,bank-fee,AU00000,1bd6c08e-8457-4a74-bdd9-514df489d27e,null,4/04/2023,2023-04-04T00:00:00Z,"{\title\"":\""\""","\""code\"":\""card\""}"""
transaction,cf105523-0ffc-41ba-b213-94c65d5b34d1,posted,Wdl ATM CBA ATM  BALGOWLAH A    NSW 210901   AUS,-200,070c1d68-0ee0-477a-9679-294ea7059939,6783.37,debit,cash-withdrawal,AU00000,1bd6c08e-8457-4a74-bdd9-514df489d27e,null,4/04/2023,2023-04-04T00:00:00Z,null,"{\self\"":\""https://au-api.basiq.io/users/bca4b9cc-b7e2-4458-83bc-4855c147bd70/transactions/cf105523-0ffc-41ba-b213-94c65d5b34d1\"""
transaction,188b6447-9cee-48e8-865d-1020d6e804c1,posted,Transfer Platnm Homeloan 346454,-3882.5,070c1d68-0ee0-477a-9679-294ea7059939,6983.37,debit,payment,AU00000,1bd6c08e-8457-4a74-bdd9-514df489d27e,null,30/03/2023,2023-03-30T00:00:00Z,"{\title\"":\""Auxiliary Finance and Investment Services\""","\""code\"":\""641\""}"""
transaction,ae019070-fd2f-4fa0-b34f-c1a6acb61bd7,posted,TFR From Transaction to CC Acc 13,-9376,070c1d68-0ee0-477a-9679-294ea7059939,10865.87,debit,payment,AU00000,1bd6c08e-8457-4a74-bdd9-514df489d27e,null,29/03/2023,2023-03-29T00:00:00Z,"{\title\"":\""Civic","Professional and Other Interest Group Services\"""
transaction,11f9508d-cf0e-48c7-b0d6-30248995ed64,posted,Payroll WFRMS 15439393,17098,070c1d68-0ee0-477a-9679-294ea7059939,20241.87,credit,transfer,AU00000,1bd6c08e-8457-4a74-bdd9-514df489d27e,null,29/03/2023,2023-03-29T00:00:00Z,"{\title\"":\""Unknown\""","\""code\"":\""0\""}"""
transaction,5fa7efe5-6c42-49fb-bc99-6fc0b1557826,posted,Manly Maths Tutor Wages,201,070c1d68-0ee0-477a-9679-294ea7059939,3143.87,credit,transfer,AU00000,1bd6c08e-8457-4a74-bdd9-514df489d27e,null,19/03/2023,2023-03-19T00:00:00Z,"{\title\"":\""Educational Support Services\""","\""code\"":\""822\""}"""
transaction,83536773-a3a6-4555-82f9-33f958233f0a,posted,MANLY WEST SCHOOL,-2530.81,070c1d68-0ee0-477a-9679-294ea7059939,2942.87,debit,payment,AU00000,1bd6c08e-8457-4a74-bdd9-514df489d27e,null,17/03/2023,2023-03-17T00:00:00Z,"{\title\"":\""School Education\""","\""code\"":\""802\""}"""
transaction,e78643d6-4029-4c7b-be92-7d2e0b864b0e,posted,MANLY WEST SCHOOL,-101,070c1d68-0ee0-477a-9679-294ea7059939,5473.68,debit,payment,AU00000,1bd6c08e-8457-4a74-bdd9-514df489d27e,null,17/03/2023,2023-03-17T00:00:00Z,"{\title\"":\""School Education\""","\""code\"":\""802\""}"""
transaction,4baf3412-5b84-4610-8748-2279e7ec9f3e,posted,Manly Maths Tutor Wages,201,070c1d68-0ee0-477a-9679-294ea7059939,5574.68,credit,transfer,AU00000,1bd6c08e-8457-4a74-bdd9-514df489d27e,null,15/03/2023,2023-03-15T00:00:00Z,"{\title\"":\""Educational Support Services\""","\""code\"":\""822\""}"""
transaction,f6d88111-52f6-4458-8cd0-86645a04fb6f,posted,Wdl ATM CBA ATM  MANLY D        NSW 219704   AUS,-420,070c1d68-0ee0-477a-9679-294ea7059939,5373.68,debit,cash-withdrawal,AU00000,1bd6c08e-8457-4a74-bdd9-514df489d27e,null,14/03/2023,2023-03-14T00:00:00Z,null,"{\self\"":\""https://au-api.basiq.io/users/bca4b9cc-b7e2-4458-83bc-4855c147bd70/transactions/f6d88111-52f6-4458-8cd0-86645a04fb6f\"""
transaction,f5848553-2d3a-4832-bcff-033ec1365669,posted,TFR Acc14000 TO 12389,-500,070c1d68-0ee0-477a-9679-294ea7059939,5793.68,debit,payment,AU00000,1bd6c08e-8457-4a74-bdd9-514df489d27e,null,14/03/2023,2023-03-14T00:00:00Z,"{\title\"":\""Legal and Accounting Services\""","\""code\"":\""693\""}"""
transaction,71db7860-ba64-4da1-99c0-2f0c6007266b,posted,AGL RETAIL ENERGY LTD (GAS),-95,070c1d68-0ee0-477a-9679-294ea7059939,6293.68,debit,payment,AU00000,1bd6c08e-8457-4a74-bdd9-514df489d27e,null,13/03/2023,2023-03-13T00:00:00Z,"{\title\"":\""Electricity Distribution\""","\""code\"":\""263\""}"""
transaction,9da8b932-0fe7-44be-9325-fbab17790e48,posted,AGL RETAIL ENERGY LTD (GAS),-78,070c1d68-0ee0-477a-9679-294ea7059939,6388.68,debit,payment,AU00000,1bd6c08e-8457-4a74-bdd9-514df489d27e,null,13/03/2023,2023-03-13T00:00:00Z,"{\title\"":\""Electricity Distribution\""","\""code\"":\""263\""}"""
transaction,ed597d14-0d6b-4be7-b6c7-54792ead565f,posted,AGL RETAIL ENERGY LTD (GAS),-95,070c1d68-0ee0-477a-9679-294ea7059939,6466.68,debit,payment,AU00000,1bd6c08e-8457-4a74-bdd9-514df489d27e,null,12/03/2023,2023-03-12T00:00:00Z,"{\title\"":\""Electricity Distribution\""","\""code\"":\""263\""}"""
transaction,0d5bf67f-3b32-4063-b78f-9d7e3d1d47e2,posted,AGL RETAIL ENERGY LTD (GAS),-78,070c1d68-0ee0-477a-9679-294ea7059939,6561.68,debit,payment,AU00000,1bd6c08e-8457-4a74-bdd9-514df489d27e,null,12/03/2023,2023-03-12T00:00:00Z,"{\title\"":\""Electricity Distribution\""","\""code\"":\""263\""}"""
transaction,fca582af-f723-48c9-9713-b1dbb0cae56f,posted,Wdl ATM WESTPAC IGA BALGOWLAH  BALGOWL        AU,-350,070c1d68-0ee0-477a-9679-294ea7059939,6639.68,debit,cash-withdrawal,AU00000,1bd6c08e-8457-4a74-bdd9-514df489d27e,null,5/03/2023,2023-03-05T00:00:00Z,null,"{\self\"":\""https://au-api.basiq.io/users/bca4b9cc-b7e2-4458-83bc-4855c147bd70/transactions/fca582af-f723-48c9-9713-b1dbb0cae56f\"""
transaction,e9ca7a17-2125-4f9c-a614-552269097b06,posted,Non Hooli ATM Withdrawal Fee,-2.5,070c1d68-0ee0-477a-9679-294ea7059939,6989.68,debit,bank-fee,AU00000,1bd6c08e-8457-4a74-bdd9-514df489d27e,null,5/03/2023,2023-03-05T00:00:00Z,"{\title\"":\""\""","\""code\"":\""card\""}"""
transaction,3f224d3d-544b-43d7-b7cf-7c0c342edb84,posted,Wdl ATM WESTPAC IGA BALGOWLAH  BALGOWL        AU,-350,070c1d68-0ee0-477a-9679-294ea7059939,6992.18,debit,cash-withdrawal,AU00000,1bd6c08e-8457-4a74-bdd9-514df489d27e,null,5/03/2023,2023-03-05T00:00:00Z,null,"{\self\"":\""https://au-api.basiq.io/users/bca4b9cc-b7e2-4458-83bc-4855c147bd70/transactions/3f224d3d-544b-43d7-b7cf-7c0c342edb84\"""
transaction,81822baa-3400-47fc-8371-2a5b7bffc578,posted,Non Hooli ATM Withdrawal Fee,-2.5,070c1d68-0ee0-477a-9679-294ea7059939,7342.18,debit,bank-fee,AU00000,1bd6c08e-8457-4a74-bdd9-514df489d27e,null,5/03/2023,2023-03-05T00:00:00Z,"{\title\"":\""\""","\""code\"":\""card\""}"""
transaction,74362203-4b97-49fd-b2d7-af8e2ee84cb2,posted,Transfer Platnm Homeloan 346454,-3890,070c1d68-0ee0-477a-9679-294ea7059939,7344.68,debit,payment,AU00000,1bd6c08e-8457-4a74-bdd9-514df489d27e,null,28/02/2023,2023-02-28T00:00:00Z,"{\title\"":\""Auxiliary Finance and Investment Services\""","\""code\"":\""641\""}"""
transaction,5204bdbd-024a-4220-a667-302df31ccc97,posted,TFR From Transaction to CC Acc 13,-9368.5,070c1d68-0ee0-477a-9679-294ea7059939,11234.68,debit,payment,AU00000,1bd6c08e-8457-4a74-bdd9-514df489d27e,null,27/02/2023,2023-02-27T00:00:00Z,"{\title\"":\""Civic","Professional and Other Interest Group Services\"""
transaction,2e6f6ed8-0069-401f-80b1-ad9ce86e59cb,posted,Payroll WFRMS 15439393,17098,070c1d68-0ee0-477a-9679-294ea7059939,20603.18,credit,transfer,AU00000,1bd6c08e-8457-4a74-bdd9-514df489d27e,null,27/02/2023,2023-02-27T00:00:00Z,"{\title\"":\""Unknown\""","\""code\"":\""0\""}"""
transaction,fe783962-54a6-4741-89bc-160d4c48601a,posted,Manly Maths Tutor Wages,201,070c1d68-0ee0-477a-9679-294ea7059939,3505.18,credit,transfer,AU00000,1bd6c08e-8457-4a74-bdd9-514df489d27e,null,14/02/2023,2023-02-14T00:00:00Z,"{\title\"":\""Educational Support Services\""","\""code\"":\""822\""}"""
transaction,40875b6b-1c5a-4df7-aec8-07a65a7d2fbf,posted,MANLY WEST SCHOOL,-2530.81,070c1d68-0ee0-477a-9679-294ea7059939,3304.18,debit,payment,AU00000,1bd6c08e-8457-4a74-bdd9-514df489d27e,null,14/02/2023,2023-02-14T00:00:00Z,"{\title\"":\""School Education\""","\""code\"":\""802\""}"""
transaction,4d633d46-7f31-401c-a5db-b6649deefa9b,posted,MANLY WEST SCHOOL,-101,070c1d68-0ee0-477a-9679-294ea7059939,5834.99,debit,payment,AU00000,1bd6c08e-8457-4a74-bdd9-514df489d27e,null,14/02/2023,2023-02-14T00:00:00Z,"{\title\"":\""School Education\""","\""code\"":\""802\""}"""
transaction,fe8c63f6-a1e4-4154-95f8-1dec02a99fd3,posted,CTRLINK CARERS Ref: 998R6789201610974V,171,070c1d68-0ee0-477a-9679-294ea7059939,5935.99,credit,transfer,AU00000,1bd6c08e-8457-4a74-bdd9-514df489d27e,null,14/02/2023,2023-02-14T00:00:00Z,"{\title\"":\""Unknown\""","\""code\"":\""0\""}"""
transaction,002dad4d-9c8c-4da0-921f-2bc1087f0b1f,posted,CTRLINK CARERS Ref: 998R6789201610974V,35,070c1d68-0ee0-477a-9679-294ea7059939,5764.99,credit,transfer,AU00000,1bd6c08e-8457-4a74-bdd9-514df489d27e,null,13/02/2023,2023-02-13T00:00:00Z,"{\title\"":\""Unknown\""","\""code\"":\""0\""}"""
transaction,59403070-bb5b-447b-9cdf-b82c4d136290,posted,TFR Acc14000 TO 12389,-500,070c1d68-0ee0-477a-9679-294ea7059939,5729.99,debit,payment,AU00000,1bd6c08e-8457-4a74-bdd9-514df489d27e,null,11/02/2023,2023-02-11T00:00:00Z,"{\title\"":\""Legal and Accounting Services\""","\""code\"":\""693\""}"""
transaction,100c5516-ccc1-4383-b660-0972ca7126f9,posted,Wdl ATM Redi ATM CEXP BERKSHIREBerkshire      AU,-100,070c1d68-0ee0-477a-9679-294ea7059939,6229.99,debit,cash-withdrawal,AU00000,1bd6c08e-8457-4a74-bdd9-514df489d27e,null,10/02/2023,2023-02-10T00:00:00Z,null,"{\self\"":\""https://au-api.basiq.io/users/bca4b9cc-b7e2-4458-83bc-4855c147bd70/transactions/100c5516-ccc1-4383-b660-0972ca7126f9\"""
transaction,ca51ee81-f26e-4bb3-a287-7c5028f7754c,posted,Non Hooli ATM Withdrawal Fee,-2.5,070c1d68-0ee0-477a-9679-294ea7059939,6329.99,debit,bank-fee,AU00000,1bd6c08e-8457-4a74-bdd9-514df489d27e,null,10/02/2023,2023-02-10T00:00:00Z,"{\title\"":\""\""","\""code\"":\""card\""}"""
transaction,79518563-7890-44d6-9c6f-2b0dcf62766a,posted,AGL RETAIL ENERGY LTD (GAS),-95,070c1d68-0ee0-477a-9679-294ea7059939,6332.49,debit,payment,AU00000,1bd6c08e-8457-4a74-bdd9-514df489d27e,null,8/02/2023,2023-02-08T00:00:00Z,"{\title\"":\""Electricity Distribution\""","\""code\"":\""263\""}"""
transaction,e77bc235-2cf0-4ce0-b862-2550511552bc,posted,AGL RETAIL ENERGY LTD (GAS),-78,070c1d68-0ee0-477a-9679-294ea7059939,6427.49,debit,payment,AU00000,1bd6c08e-8457-4a74-bdd9-514df489d27e,null,8/02/2023,2023-02-08T00:00:00Z,"{\title\"":\""Electricity Distribution\""","\""code\"":\""263\""}"""
transaction,9f0350cf-9d59-4c63-a11e-7b9f5c352ba1,posted,CTRLINK CARERS Ref: 998R6789201610974V,61,070c1d68-0ee0-477a-9679-294ea7059939,6505.49,credit,transfer,AU00000,1bd6c08e-8457-4a74-bdd9-514df489d27e,null,30/01/2023,2023-01-30T00:00:00Z,"{\title\"":\""Unknown\""","\""code\"":\""0\""}"""
transaction,19c34929-bb8d-4fd4-9648-82a0fbb31bb0,posted,Transfer Platnm Homeloan 346454,-3897.5,070c1d68-0ee0-477a-9679-294ea7059939,6444.49,debit,payment,AU00000,1bd6c08e-8457-4a74-bdd9-514df489d27e,null,28/01/2023,2023-01-28T00:00:00Z,"{\title\"":\""Auxiliary Finance and Investment Services\""","\""code\"":\""641\""}"""
transaction,74f74fef-4577-482d-a89d-8306ba11d69f,posted,TFR From Transaction to CC Acc 13,-9361,070c1d68-0ee0-477a-9679-294ea7059939,10341.99,debit,payment,AU00000,1bd6c08e-8457-4a74-bdd9-514df489d27e,null,27/01/2023,2023-01-27T00:00:00Z,"{\title\"":\""Civic","Professional and Other Interest Group Services\"""
transaction,8242021c-e160-4a7b-ba79-24902175ba57,posted,Payroll WFRMS 15439393,17098,070c1d68-0ee0-477a-9679-294ea7059939,19702.99,credit,transfer,AU00000,1bd6c08e-8457-4a74-bdd9-514df489d27e,null,27/01/2023,2023-01-27T00:00:00Z,"{\title\"":\""Unknown\""","\""code\"":\""0\""}"""
transaction,33d05927-387a-4377-bbae-2b05abbcdd30,posted,Wdl ATM CBA ATM  MANLY D        NSW 219704   AUS,-300,070c1d68-0ee0-477a-9679-294ea7059939,2604.99,debit,cash-withdrawal,AU00000,1bd6c08e-8457-4a74-bdd9-514df489d27e,null,17/01/2023,2023-01-17T00:00:00Z,null,"{\self\"":\""https://au-api.basiq.io/users/bca4b9cc-b7e2-4458-83bc-4855c147bd70/transactions/33d05927-387a-4377-bbae-2b05abbcdd30\"""
transaction,3070f91a-cde3-466e-a90e-20244be35bb8,posted,Manly Maths Tutor Wages,201,070c1d68-0ee0-477a-9679-294ea7059939,2904.99,credit,transfer,AU00000,1bd6c08e-8457-4a74-bdd9-514df489d27e,null,17/01/2023,2023-01-17T00:00:00Z,"{\title\"":\""Educational Support Services\""","\""code\"":\""822\""}"""
transaction,92f01adb-0ad3-4340-b9af-3043b44eb6ed,posted,Wdl ATM WESTPAC IGA BALGOWLAH  BALGOWL        AU,-200,070c1d68-0ee0-477a-9679-294ea7059939,2703.99,debit,cash-withdrawal,AU00000,1bd6c08e-8457-4a74-bdd9-514df489d27e,null,16/01/2023,2023-01-16T00:00:00Z,null,"{\self\"":\""https://au-api.basiq.io/users/bca4b9cc-b7e2-4458-83bc-4855c147bd70/transactions/92f01adb-0ad3-4340-b9af-3043b44eb6ed\"""
transaction,f88a8a0b-5738-4914-8c2e-38c42fac99e9,posted,Non Hooli ATM Withdrawal Fee,-2.5,070c1d68-0ee0-477a-9679-294ea7059939,2903.99,debit,bank-fee,AU00000,1bd6c08e-8457-4a74-bdd9-514df489d27e,null,16/01/2023,2023-01-16T00:00:00Z,"{\title\"":\""\""","\""code\"":\""card\""}"""
transaction,5a85f687-741e-4b44-8cb8-9b5a2039f04c,posted,Wdl ATM WESTPAC IGA BALGOWLAH  BALGOWL        AU,-100,070c1d68-0ee0-477a-9679-294ea7059939,2906.49,debit,cash-withdrawal,AU00000,1bd6c08e-8457-4a74-bdd9-514df489d27e,null,16/01/2023,2023-01-16T00:00:00Z,null,"{\self\"":\""https://au-api.basiq.io/users/bca4b9cc-b7e2-4458-83bc-4855c147bd70/transactions/5a85f687-741e-4b44-8cb8-9b5a2039f04c\"""
transaction,6df8ae78-9429-4c88-a997-4119ea707572,posted,Non Hooli ATM Withdrawal Fee,-2.5,070c1d68-0ee0-477a-9679-294ea7059939,3006.49,debit,bank-fee,AU00000,1bd6c08e-8457-4a74-bdd9-514df489d27e,null,16/01/2023,2023-01-16T00:00:00Z,"{\title\"":\""\""","\""code\"":\""card\""}"""
transaction,ead14f6c-0c6d-46b5-bcc3-96384756cfc7,posted,MANLY WEST SCHOOL,-2530.81,070c1d68-0ee0-477a-9679-294ea7059939,3008.99,debit,payment,AU00000,1bd6c08e-8457-4a74-bdd9-514df489d27e,null,16/01/2023,2023-01-16T00:00:00Z,"{\title\"":\""School Education\""","\""code\"":\""802\""}"""
transaction,4dcf54d8-f53c-48ea-8036-8fec24c8df58,posted,MANLY WEST SCHOOL,-101,070c1d68-0ee0-477a-9679-294ea7059939,5539.8,debit,payment,AU00000,1bd6c08e-8457-4a74-bdd9-514df489d27e,null,16/01/2023,2023-01-16T00:00:00Z,"{\title\"":\""School Education\""","\""code\"":\""802\""}"""
transaction,6214ed97-ac6d-4c1c-bc77-3bd37e435e42,posted,Wdl ATM CBA ATM  MANLY E        NSW 219705   AUS,-100,070c1d68-0ee0-477a-9679-294ea7059939,5640.8,debit,cash-withdrawal,AU00000,1bd6c08e-8457-4a74-bdd9-514df489d27e,null,15/01/2023,2023-01-15T00:00:00Z,null,"{\self\"":\""https://au-api.basiq.io/users/bca4b9cc-b7e2-4458-83bc-4855c147bd70/transactions/6214ed97-ac6d-4c1c-bc77-3bd37e435e42\"""
transaction,e5008e57-b692-4d6e-a1ba-7a2593997ca5,posted,Manly Maths Tutor Wages,201,070c1d68-0ee0-477a-9679-294ea7059939,5740.8,credit,transfer,AU00000,1bd6c08e-8457-4a74-bdd9-514df489d27e,null,13/01/2023,2023-01-13T00:00:00Z,"{\title\"":\""Educational Support Services\""","\""code\"":\""822\""}"""
transaction,e0cf7437-9d41-4f80-91c8-dc7809f0545a,posted,TFR Acc14000 TO 12389,-500,070c1d68-0ee0-477a-9679-294ea7059939,5539.8,debit,payment,AU00000,1bd6c08e-8457-4a74-bdd9-514df489d27e,null,12/01/2023,2023-01-12T00:00:00Z,"{\title\"":\""Legal and Accounting Services\""","\""code\"":\""693\""}"""
transaction,d55a0a51-92de-4a96-aef1-c6b58dec14f7,posted,AGL RETAIL ENERGY LTD,-95,070c1d68-0ee0-477a-9679-294ea7059939,6039.8,debit,payment,AU00000,1bd6c08e-8457-4a74-bdd9-514df489d27e,null,9/01/2023,2023-01-09T00:00:00Z,"{\title\"":\""Electricity Distribution\""","\""code\"":\""263\""}"""
transaction,7aed3afd-5405-41ea-904e-5d625bfb96d4,posted,AGL RETAIL ENERGY LTD (GAS),-78,070c1d68-0ee0-477a-9679-294ea7059939,6134.8,debit,payment,AU00000,1bd6c08e-8457-4a74-bdd9-514df489d27e,null,9/01/2023,2023-01-09T00:00:00Z,"{\title\"":\""Electricity Distribution\""","\""code\"":\""263\""}"""
transaction,c8356982-4ded-44b0-baca-c24d8411f314,posted,Wdl ATM WESTPAC IGA BALGOWLAH  BALGOWL        AU,-100,070c1d68-0ee0-477a-9679-294ea7059939,6212.8,debit,cash-withdrawal,AU00000,1bd6c08e-8457-4a74-bdd9-514df489d27e,null,2/01/2023,2023-01-02T00:00:00Z,null,"{\self\"":\""https://au-api.basiq.io/users/bca4b9cc-b7e2-4458-83bc-4855c147bd70/transactions/c8356982-4ded-44b0-baca-c24d8411f314\"""
transaction,68f1e960-e566-4f23-b9f2-a69ba2a05e5f,posted,Non Hooli ATM Withdrawal Fee,-2.5,070c1d68-0ee0-477a-9679-294ea7059939,6312.8,debit,bank-fee,AU00000,1bd6c08e-8457-4a74-bdd9-514df489d27e,null,2/01/2023,2023-01-02T00:00:00Z,"{\title\"":\""\""","\""code\"":\""card\""}"""
transaction,ea4f83f5-41f8-481d-bccc-7d83f73ebdd2,posted,Transfer Platnm Homeloan 346454,-3905,070c1d68-0ee0-477a-9679-294ea7059939,6315.3,debit,payment,AU00000,1bd6c08e-8457-4a74-bdd9-514df489d27e,null,29/12/2022,2022-12-29T00:00:00Z,"{\title\"":\""Auxiliary Finance and Investment Services\""","\""code\"":\""641\""}"""
transaction,fb847112-209c-4850-ad0a-2e16f138a3b1,posted,Wdl ATM CBA ATM  BALGOWLAH A    NSW 210901   AUS,-200,070c1d68-0ee0-477a-9679-294ea7059939,10220.3,debit,cash-withdrawal,AU00000,1bd6c08e-8457-4a74-bdd9-514df489d27e,null,28/12/2022,2022-12-28T00:00:00Z,null,"{\self\"":\""https://au-api.basiq.io/users/bca4b9cc-b7e2-4458-83bc-4855c147bd70/transactions/fb847112-209c-4850-ad0a-2e16f138a3b1\"""
transaction,289dffa5-44c5-42cc-895f-d349b396e2c5,posted,Wdl ATM CBA ATM  BALGOWLAH A    NSW 210901   AUS,-100,070c1d68-0ee0-477a-9679-294ea7059939,10420.3,debit,cash-withdrawal,AU00000,1bd6c08e-8457-4a74-bdd9-514df489d27e,null,28/12/2022,2022-12-28T00:00:00Z,null,"{\self\"":\""https://au-api.basiq.io/users/bca4b9cc-b7e2-4458-83bc-4855c147bd70/transactions/289dffa5-44c5-42cc-895f-d349b396e2c5\"""
transaction,abc39e1b-ef56-44bb-baa4-cab8a408c0a6,posted,TFR From Transaction to CC Acc 13,-9353.5,070c1d68-0ee0-477a-9679-294ea7059939,10520.3,debit,payment,AU00000,1bd6c08e-8457-4a74-bdd9-514df489d27e,null,28/12/2022,2022-12-28T00:00:00Z,"{\title\"":\""Civic","Professional and Other Interest Group Services\"""
transaction,9564a887-1a69-47aa-a889-6a4bdafa9f83,posted,Payroll WFRMS 15439393,17098,070c1d68-0ee0-477a-9679-294ea7059939,19873.8,credit,transfer,AU00000,1bd6c08e-8457-4a74-bdd9-514df489d27e,null,28/12/2022,2022-12-28T00:00:00Z,"{\title\"":\""Unknown\""","\""code\"":\""0\""}"""
transaction,b5609663-4a3b-462c-b02b-84fd5d057223,posted,Wdl ATM CBA ATM  MANLY A        NSW 219701   AUS,-400,070c1d68-0ee0-477a-9679-294ea7059939,2775.8,debit,cash-withdrawal,AU00000,1bd6c08e-8457-4a74-bdd9-514df489d27e,null,26/12/2022,2022-12-26T00:00:00Z,null,"{\self\"":\""https://au-api.basiq.io/users/bca4b9cc-b7e2-4458-83bc-4855c147bd70/transactions/b5609663-4a3b-462c-b02b-84fd5d057223\"""
transaction,315a3d59-28ac-456e-a8f4-f52d98bda0eb,posted,Wdl ATM WESTPAC IGA BALGOWLAH  BALGOWL        AU,-200,070c1d68-0ee0-477a-9679-294ea7059939,3175.8,debit,cash-withdrawal,AU00000,1bd6c08e-8457-4a74-bdd9-514df489d27e,null,25/12/2022,2022-12-25T00:00:00Z,null,"{\self\"":\""https://au-api.basiq.io/users/bca4b9cc-b7e2-4458-83bc-4855c147bd70/transactions/315a3d59-28ac-456e-a8f4-f52d98bda0eb\"""
transaction,0a744a39-f174-46f8-a319-72a9ff49d247,posted,Non Hooli ATM Withdrawal Fee,-2.5,070c1d68-0ee0-477a-9679-294ea7059939,3375.8,debit,bank-fee,AU00000,1bd6c08e-8457-4a74-bdd9-514df489d27e,null,25/12/2022,2022-12-25T00:00:00Z,"{\title\"":\""\""","\""code\"":\""card\""}"""
transaction,a3669631-200b-4515-9394-20d0dd3d3c1f,posted,Wdl ATM CBA ATM  MANLY B        NSW 219702   AUS,-200,070c1d68-0ee0-477a-9679-294ea7059939,3378.3,debit,cash-withdrawal,AU00000,1bd6c08e-8457-4a74-bdd9-514df489d27e,null,18/12/2022,2022-12-18T00:00:00Z,null,"{\self\"":\""https://au-api.basiq.io/users/bca4b9cc-b7e2-4458-83bc-4855c147bd70/transactions/a3669631-200b-4515-9394-20d0dd3d3c1f\"""
transaction,bdf88236-e22b-4b03-928a-c78e475f7705,posted,Manly Maths Tutor Wages,201,070c1d68-0ee0-477a-9679-294ea7059939,3578.3,credit,transfer,AU00000,1bd6c08e-8457-4a74-bdd9-514df489d27e,null,15/12/2022,2022-12-15T00:00:00Z,"{\title\"":\""Educational Support Services\""","\""code\"":\""822\""}"""
transaction,a084ff4f-7d58-49c3-a9f3-704ee7d916aa,posted,MANLY WEST SCHOOL,-2530.81,070c1d68-0ee0-477a-9679-294ea7059939,3377.3,debit,payment,AU00000,1bd6c08e-8457-4a74-bdd9-514df489d27e,null,15/12/2022,2022-12-15T00:00:00Z,"{\title\"":\""School Education\""","\""code\"":\""802\""}"""
transaction,8d5cb9e3-39ed-4c03-942e-4bc1326d2829,posted,MANLY WEST SCHOOL,-101,070c1d68-0ee0-477a-9679-294ea7059939,5908.11,debit,payment,AU00000,1bd6c08e-8457-4a74-bdd9-514df489d27e,null,15/12/2022,2022-12-15T00:00:00Z,"{\title\"":\""School Education\""","\""code\"":\""802\""}"""
transaction,80d0cd8a-3170-4f77-b9ab-5818843af2e9,posted,Manly Maths Tutor Wages,201,070c1d68-0ee0-477a-9679-294ea7059939,6009.11,credit,transfer,AU00000,1bd6c08e-8457-4a74-bdd9-514df489d27e,null,13/12/2022,2022-12-13T00:00:00Z,"{\title\"":\""Educational Support Services\""","\""code\"":\""822\""}"""
transaction,62c8daa1-da9a-4227-a3eb-05c7cd66feea,posted,TFR Acc14000 TO 12389,-500,070c1d68-0ee0-477a-9679-294ea7059939,5808.11,debit,payment,AU00000,1bd6c08e-8457-4a74-bdd9-514df489d27e,null,12/12/2022,2022-12-12T00:00:00Z,"{\title\"":\""Legal and Accounting Services\""","\""code\"":\""693\""}"""
transaction,3bfd5ebe-8945-4bbe-aa36-819cfee1f121,posted,AGL RETAIL ENERGY LTD,-95,070c1d68-0ee0-477a-9679-294ea7059939,6308.11,debit,payment,AU00000,1bd6c08e-8457-4a74-bdd9-514df489d27e,null,9/12/2022,2022-12-09T00:00:00Z,"{\title\"":\""Electricity Distribution\""","\""code\"":\""263\""}"""
transaction,679660a0-8ee5-460a-bf8f-edacee09b304,posted,AGL RETAIL ENERGY LTD,-78,070c1d68-0ee0-477a-9679-294ea7059939,6403.11,debit,payment,AU00000,1bd6c08e-8457-4a74-bdd9-514df489d27e,null,9/12/2022,2022-12-09T00:00:00Z,"{\title\"":\""Electricity Distribution\""","\""code\"":\""263\""}"""
transaction,d37e589e-c0af-4522-b207-a519c64fb61c,posted,Transfer Platnm Homeloan 346454,-3912.5,070c1d68-0ee0-477a-9679-294ea7059939,6481.11,debit,payment,AU00000,1bd6c08e-8457-4a74-bdd9-514df489d27e,null,28/11/2022,2022-11-28T00:00:00Z,"{\title\"":\""Auxiliary Finance and Investment Services\""","\""code\"":\""641\""}"""
transaction,e3535b29-cfe5-4c8f-91fb-12949e83715b,posted,TFR From Transaction to CC Acc 13,-9346,070c1d68-0ee0-477a-9679-294ea7059939,10393.61,debit,payment,AU00000,1bd6c08e-8457-4a74-bdd9-514df489d27e,null,27/11/2022,2022-11-27T00:00:00Z,"{\title\"":\""Civic","Professional and Other Interest Group Services\"""
transaction,572916d7-eb3b-4656-b5d0-13fb4cdd1524,posted,Payroll WFRMS 15439393,17098,070c1d68-0ee0-477a-9679-294ea7059939,19739.61,credit,transfer,AU00000,1bd6c08e-8457-4a74-bdd9-514df489d27e,null,27/11/2022,2022-11-27T00:00:00Z,"{\title\"":\""Unknown\""","\""code\"":\""0\""}"""
transaction,9cf42451-de4a-494d-8133-78be85ef4a4b,posted,Manly Maths Tutor Wages,201,070c1d68-0ee0-477a-9679-294ea7059939,2641.61,credit,transfer,AU00000,1bd6c08e-8457-4a74-bdd9-514df489d27e,null,15/11/2022,2022-11-15T00:00:00Z,"{\title\"":\""Educational Support Services\""","\""code\"":\""822\""}"""
transaction,60c1ca71-1eb7-4ac7-9b53-c99d8b7a290b,posted,Wdl ATM WESTPAC IGA BALGOWLAH  BALGOWL        AU,-200,070c1d68-0ee0-477a-9679-294ea7059939,2440.61,debit,cash-withdrawal,AU00000,1bd6c08e-8457-4a74-bdd9-514df489d27e,null,14/11/2022,2022-11-14T00:00:00Z,null,"{\self\"":\""https://au-api.basiq.io/users/bca4b9cc-b7e2-4458-83bc-4855c147bd70/transactions/60c1ca71-1eb7-4ac7-9b53-c99d8b7a290b\"""
transaction,a63a9d5b-f98d-46cc-b88f-43b20d07434a,posted,Non Hooli ATM Withdrawal Fee,-2.5,070c1d68-0ee0-477a-9679-294ea7059939,2640.61,debit,bank-fee,AU00000,1bd6c08e-8457-4a74-bdd9-514df489d27e,null,14/11/2022,2022-11-14T00:00:00Z,"{\title\"":\""\""","\""code\"":\""card\""}"""
transaction,7c4bc206-9afc-4aca-a661-e01c34e40ba8,posted,Wdl ATM WESTPAC IGA BALGOWLAH  BALGOWL        AU,-500,070c1d68-0ee0-477a-9679-294ea7059939,2643.11,debit,cash-withdrawal,AU00000,1bd6c08e-8457-4a74-bdd9-514df489d27e,null,14/11/2022,2022-11-14T00:00:00Z,null,"{\self\"":\""https://au-api.basiq.io/users/bca4b9cc-b7e2-4458-83bc-4855c147bd70/transactions/7c4bc206-9afc-4aca-a661-e01c34e40ba8\"""
transaction,429b55ce-d04e-4142-9dd7-add457afc847,posted,Non Hooli ATM Withdrawal Fee,-2.5,070c1d68-0ee0-477a-9679-294ea7059939,3143.11,debit,bank-fee,AU00000,1bd6c08e-8457-4a74-bdd9-514df489d27e,null,14/11/2022,2022-11-14T00:00:00Z,"{\title\"":\""\""","\""code\"":\""card\""}"""
transaction,e8c9c275-8700-4aa1-9edb-93a33ed3589d,posted,MANLY WEST SCHOOL,-2530.81,070c1d68-0ee0-477a-9679-294ea7059939,3145.61,debit,payment,AU00000,1bd6c08e-8457-4a74-bdd9-514df489d27e,null,14/11/2022,2022-11-14T00:00:00Z,"{\title\"":\""School Education\""","\""code\"":\""802\""}"""
transaction,ebbf2bf9-6142-45a9-bad3-4acab91db622,posted,MANLY WEST SCHOOL,-101,070c1d68-0ee0-477a-9679-294ea7059939,5676.42,debit,payment,AU00000,1bd6c08e-8457-4a74-bdd9-514df489d27e,null,14/11/2022,2022-11-14T00:00:00Z,"{\title\"":\""School Education\""","\""code\"":\""802\""}"""
transaction,0fca9914-d026-4f49-b122-03bbe2aef60d,posted,Manly Maths Tutor Wages,201,070c1d68-0ee0-477a-9679-294ea7059939,5777.42,credit,transfer,AU00000,1bd6c08e-8457-4a74-bdd9-514df489d27e,null,12/11/2022,2022-11-12T00:00:00Z,"{\title\"":\""Educational Support Services\""","\""code\"":\""822\""}"""
transaction,d72c17f1-cb68-49d8-ac90-4e8cfa862dfc,posted,TFR Acc14000 TO 12389,-500,070c1d68-0ee0-477a-9679-294ea7059939,5576.42,debit,payment,AU00000,1bd6c08e-8457-4a74-bdd9-514df489d27e,null,11/11/2022,2022-11-11T00:00:00Z,"{\title\"":\""Legal and Accounting Services\""","\""code\"":\""693\""}"""
transaction,d176ac7d-c5a0-49d4-bd06-b8adc10b9028,posted,AGL RETAIL ENERGY LTD,-95,070c1d68-0ee0-477a-9679-294ea7059939,6076.42,debit,payment,AU00000,1bd6c08e-8457-4a74-bdd9-514df489d27e,null,8/11/2022,2022-11-08T00:00:00Z,"{\title\"":\""Electricity Distribution\""","\""code\"":\""263\""}"""
transaction,17beb5c4-acf2-40b8-8a24-21f86b38940a,posted,AGL RETAIL ENERGY LTD,-78,070c1d68-0ee0-477a-9679-294ea7059939,6171.42,debit,payment,AU00000,1bd6c08e-8457-4a74-bdd9-514df489d27e,null,8/11/2022,2022-11-08T00:00:00Z,"{\title\"":\""Electricity Distribution\""","\""code\"":\""263\""}"""
transaction,73e09d4a-eabe-4fb1-b95b-d95753322a42,posted,V9193 04/07 FOREIGN CURRENCY TRAN FEE     Ref: 74973807186,-2.02,070c1d68-0ee0-477a-9679-294ea7059939,6249.42,debit,payment,AU00000,1bd6c08e-8457-4a74-bdd9-514df489d27e,null,3/11/2022,2022-11-03T00:00:00Z,"{\title\"":\""Civic","Professional and Other Interest Group Services\"""
transaction,8ad93bb2-f202-408b-b2db-99592a3ba93d,posted,V9193 04/07 FOREIGN CURRENCY TRAN FEE     Ref: 74974007186,-1.31,070c1d68-0ee0-477a-9679-294ea7059939,6251.44,debit,payment,AU00000,1bd6c08e-8457-4a74-bdd9-514df489d27e,null,3/11/2022,2022-11-03T00:00:00Z,"{\title\"":\""Civic","Professional and Other Interest Group Services\"""
transaction,49788910-9c61-4b72-a103-85441ea6b680,posted,Transfer Platnm Homeloan 346454,-3920,070c1d68-0ee0-477a-9679-294ea7059939,6252.75,debit,payment,AU00000,1bd6c08e-8457-4a74-bdd9-514df489d27e,null,28/10/2022,2022-10-28T00:00:00Z,"{\title\"":\""Auxiliary Finance and Investment Services\""","\""code\"":\""641\""}"""
transaction,b4baec80-264c-4ea5-a2b3-28a0f601f4cf,posted,TFR From Transaction to CC Acc 13,-9338.5,070c1d68-0ee0-477a-9679-294ea7059939,10172.75,debit,payment,AU00000,1bd6c08e-8457-4a74-bdd9-514df489d27e,null,27/10/2022,2022-10-27T00:00:00Z,"{\title\"":\""Civic","Professional and Other Interest Group Services\"""
transaction,f0a3da07-f77d-4881-9386-cbe5d72e51b4,posted,Payroll WFRMS 15439393,15985,070c1d68-0ee0-477a-9679-294ea7059939,19511.25,credit,transfer,AU00000,1bd6c08e-8457-4a74-bdd9-514df489d27e,null,27/10/2022,2022-10-27T00:00:00Z,"{\title\"":\""Unknown\""","\""code\"":\""0\""}"""
transaction,cf24f795-323f-4df6-8705-25e157b54f4e,posted,Wdl ATM WES IGA BALGOWLAH HGT  BALGOWL        AU,-200,070c1d68-0ee0-477a-9679-294ea7059939,3526.25,debit,cash-withdrawal,AU00000,1bd6c08e-8457-4a74-bdd9-514df489d27e,null,18/10/2022,2022-10-18T00:00:00Z,null,"{\self\"":\""https://au-api.basiq.io/users/bca4b9cc-b7e2-4458-83bc-4855c147bd70/transactions/cf24f795-323f-4df6-8705-25e157b54f4e\"""
transaction,9257bf47-3744-40a9-8cc9-2c18d4930d1f,posted,Non Hooli ATM Withdrawal Fee,-2.5,070c1d68-0ee0-477a-9679-294ea7059939,3726.25,debit,bank-fee,AU00000,1bd6c08e-8457-4a74-bdd9-514df489d27e,null,18/10/2022,2022-10-18T00:00:00Z,"{\title\"":\""\""","\""code\"":\""card\""}"""
transaction,5e8dc9dd-bb4e-4ed5-b4f1-367c22a6f7ab,posted,Manly Maths Tutor Wages,201,070c1d68-0ee0-477a-9679-294ea7059939,3728.75,credit,transfer,AU00000,1bd6c08e-8457-4a74-bdd9-514df489d27e,null,17/10/2022,2022-10-17T00:00:00Z,"{\title\"":\""Educational Support Services\""","\""code\"":\""822\""}"""
transaction,ccc7cf56-bc5c-4130-84da-edd888036813,posted,MANLY WEST SCHOOL,-2530.81,070c1d68-0ee0-477a-9679-294ea7059939,3527.75,debit,payment,AU00000,1bd6c08e-8457-4a74-bdd9-514df489d27e,null,17/10/2022,2022-10-17T00:00:00Z,"{\title\"":\""School Education\""","\""code\"":\""802\""}"""
transaction,55af5e4f-5ef1-4ffe-9650-07e7ed053da9,posted,MANLY WEST SCHOOL,-101,070c1d68-0ee0-477a-9679-294ea7059939,6058.56,debit,payment,AU00000,1bd6c08e-8457-4a74-bdd9-514df489d27e,null,17/10/2022,2022-10-17T00:00:00Z,"{\title\"":\""School Education\""","\""code\"":\""802\""}"""
transaction,ea19ebe1-87d7-43c1-80cf-1dacd83f15a4,posted,Manly Maths Tutor Wages,201,070c1d68-0ee0-477a-9679-294ea7059939,6159.56,credit,transfer,AU00000,1bd6c08e-8457-4a74-bdd9-514df489d27e,null,13/10/2022,2022-10-13T00:00:00Z,"{\title\"":\""Educational Support Services\""","\""code\"":\""822\""}"""
transaction,dbff00b8-6fde-4a83-9522-a948e3eb0035,posted,TFR Acc14000 TO 12389,-500,070c1d68-0ee0-477a-9679-294ea7059939,5958.56,debit,payment,AU00000,1bd6c08e-8457-4a74-bdd9-514df489d27e,null,12/10/2022,2022-10-12T00:00:00Z,"{\title\"":\""Legal and Accounting Services\""","\""code\"":\""693\""}"""
transaction,e032bda9-1c0a-47d3-9f0f-0588424a1f89,posted,AGL RETAIL ENERGY LTD (GAS),-95,070c1d68-0ee0-477a-9679-294ea7059939,6458.56,debit,payment,AU00000,1bd6c08e-8457-4a74-bdd9-514df489d27e,null,11/10/2022,2022-10-11T00:00:00Z,"{\title\"":\""Electricity Distribution\""","\""code\"":\""263\""}"""
transaction,4618ef43-67d7-43a7-98ba-f93be3505677,posted,AGL RETAIL ENERGY LTD (GAS),-78,070c1d68-0ee0-477a-9679-294ea7059939,6553.56,debit,payment,AU00000,1bd6c08e-8457-4a74-bdd9-514df489d27e,null,11/10/2022,2022-10-11T00:00:00Z,"{\title\"":\""Electricity Distribution\""","\""code\"":\""263\""}"""
transaction,acbec3d2-a932-43e0-bc12-3c26d45e3bd2,posted,Transfer Platnm Homeloan 346454,-3927.5,070c1d68-0ee0-477a-9679-294ea7059939,6631.56,debit,payment,AU00000,1bd6c08e-8457-4a74-bdd9-514df489d27e,null,28/09/2022,2022-09-28T00:00:00Z,"{\title\"":\""Auxiliary Finance and Investment Services\""","\""code\"":\""641\""}"""
transaction,3b3b98cc-bfd7-468e-840b-f4ce9c2a01d4,posted,TFR From Transaction to CC Acc 13,-9331,070c1d68-0ee0-477a-9679-294ea7059939,10559.06,debit,payment,AU00000,1bd6c08e-8457-4a74-bdd9-514df489d27e,null,27/09/2022,2022-09-27T00:00:00Z,"{\title\"":\""Civic","Professional and Other Interest Group Services\"""
transaction,1b9aad04-5271-4714-b1d7-2f8c1883e4c4,posted,Payroll WFRMS 15439393,15985,070c1d68-0ee0-477a-9679-294ea7059939,19890.06,credit,transfer,AU00000,1bd6c08e-8457-4a74-bdd9-514df489d27e,null,27/09/2022,2022-09-27T00:00:00Z,"{\title\"":\""Unknown\""","\""code\"":\""0\""}"""
transaction,56d93429-dee0-49a6-8350-2bf40671c8d8,posted,Wdl ATM BOQ BP Connect BalgowlaBalgowlahNS    AU,-900,070c1d68-0ee0-477a-9679-294ea7059939,3905.06,debit,cash-withdrawal,AU00000,1bd6c08e-8457-4a74-bdd9-514df489d27e,null,25/09/2022,2022-09-25T00:00:00Z,null,"{\self\"":\""https://au-api.basiq.io/users/bca4b9cc-b7e2-4458-83bc-4855c147bd70/transactions/56d93429-dee0-49a6-8350-2bf40671c8d8\"""
transaction,6c23e85a-dbe4-4ae3-a0a0-aacdfa0a4224,posted,Non Hooli ATM Withdrawal Fee,-2.5,070c1d68-0ee0-477a-9679-294ea7059939,4805.06,debit,bank-fee,AU00000,1bd6c08e-8457-4a74-bdd9-514df489d27e,null,25/09/2022,2022-09-25T00:00:00Z,"{\title\"":\""\""","\""code\"":\""card\""}"""
transaction,bef47dda-f657-48a3-9e75-a03ef2815253,posted,MANLY WEST SCHOOL,-31,070c1d68-0ee0-477a-9679-294ea7059939,4807.56,debit,payment,AU00000,1bd6c08e-8457-4a74-bdd9-514df489d27e,null,25/09/2022,2022-09-25T00:00:00Z,"{\title\"":\""School Education\""","\""code\"":\""802\""}"""
transaction,a24f8cbe-0eb1-4463-8de2-c76eccba54be,posted,Manly Maths Tutor Wages,201,070c1d68-0ee0-477a-9679-294ea7059939,4838.56,credit,transfer,AU00000,1bd6c08e-8457-4a74-bdd9-514df489d27e,null,14/09/2022,2022-09-14T00:00:00Z,"{\title\"":\""Educational Support Services\""","\""code\"":\""822\""}"""
transaction,b2d80403-be36-46ed-87ca-c35d6ffd9cd6,posted,MANLY WEST SCHOOL,-2530.81,070c1d68-0ee0-477a-9679-294ea7059939,4637.56,debit,payment,AU00000,1bd6c08e-8457-4a74-bdd9-514df489d27e,null,14/09/2022,2022-09-14T00:00:00Z,"{\title\"":\""School Education\""","\""code\"":\""802\""}"""
transaction,3900db8b-3871-483f-8301-d318d3a9bb86,posted,MANLY WEST SCHOOL,-101,070c1d68-0ee0-477a-9679-294ea7059939,7168.37,debit,payment,AU00000,1bd6c08e-8457-4a74-bdd9-514df489d27e,null,14/09/2022,2022-09-14T00:00:00Z,"{\title\"":\""School Education\""","\""code\"":\""802\""}"""
transaction,4ab3b32f-c109-4da4-95f6-15f82c4189ac,posted,MANLY WEST SCHOOL,-70.69,070c1d68-0ee0-477a-9679-294ea7059939,7269.37,debit,payment,AU00000,1bd6c08e-8457-4a74-bdd9-514df489d27e,null,12/09/2022,2022-09-12T00:00:00Z,"{\title\"":\""School Education\""","\""code\"":\""802\""}"""
transaction,1232cd68-fbe4-455c-9970-9b8fb433654a,posted,Wdl ATM WES IGA BALGOWLAH HGT  BALGOWL        AU,-500,070c1d68-0ee0-477a-9679-294ea7059939,7340.06,debit,cash-withdrawal,AU00000,1bd6c08e-8457-4a74-bdd9-514df489d27e,null,12/09/2022,2022-09-12T00:00:00Z,null,"{\self\"":\""https://au-api.basiq.io/users/bca4b9cc-b7e2-4458-83bc-4855c147bd70/transactions/1232cd68-fbe4-455c-9970-9b8fb433654a\"""
transaction,295b0279-0c49-44a4-a1c2-2a0a024e287b,posted,Non Hooli ATM Withdrawal Fee,-2.5,070c1d68-0ee0-477a-9679-294ea7059939,7840.06,debit,bank-fee,AU00000,1bd6c08e-8457-4a74-bdd9-514df489d27e,null,12/09/2022,2022-09-12T00:00:00Z,"{\title\"":\""\""","\""code\"":\""card\""}"""
transaction,1c452615-16d6-4947-bfa4-2896d4de5707,posted,Manly Maths Tutor Wages,201,070c1d68-0ee0-477a-9679-294ea7059939,7842.56,credit,transfer,AU00000,1bd6c08e-8457-4a74-bdd9-514df489d27e,null,12/09/2022,2022-09-12T00:00:00Z,"{\title\"":\""Educational Support Services\""","\""code\"":\""822\""}"""
transaction,7b8ca779-9832-4246-82e5-cfcf2b018fb1,posted,TFR Acc14000 TO 12389,-500,070c1d68-0ee0-477a-9679-294ea7059939,7641.56,debit,payment,AU00000,1bd6c08e-8457-4a74-bdd9-514df489d27e,null,11/09/2022,2022-09-11T00:00:00Z,"{\title\"":\""Legal and Accounting Services\""","\""code\"":\""693\""}"""
transaction,4fb3ae73-e089-4301-9ddd-4e1d0aeb297b,posted,AGL RETAIL ENERGY LTD (GAS),-95,070c1d68-0ee0-477a-9679-294ea7059939,8141.56,debit,payment,AU00000,1bd6c08e-8457-4a74-bdd9-514df489d27e,null,8/09/2022,2022-09-08T00:00:00Z,"{\title\"":\""Electricity Distribution\""","\""code\"":\""263\""}"""
transaction,917ca690-59e8-4c08-b97c-db881b318731,posted,AGL RETAIL ENERGY LTD (GAS),-69,070c1d68-0ee0-477a-9679-294ea7059939,8236.56,debit,payment,AU00000,1bd6c08e-8457-4a74-bdd9-514df489d27e,null,8/09/2022,2022-09-08T00:00:00Z,"{\title\"":\""Electricity Distribution\""","\""code\"":\""263\""}"""
transaction,c6fb51c0-fcff-463b-8e53-aaf3a10bb90e,posted,Wdl ATM WES IGA BALGOWLAH HGT  BALGOWL        AU,-200,070c1d68-0ee0-477a-9679-294ea7059939,8305.56,debit,cash-withdrawal,AU00000,1bd6c08e-8457-4a74-bdd9-514df489d27e,null,7/09/2022,2022-09-07T00:00:00Z,null,"{\self\"":\""https://au-api.basiq.io/users/bca4b9cc-b7e2-4458-83bc-4855c147bd70/transactions/c6fb51c0-fcff-463b-8e53-aaf3a10bb90e\"""
transaction,e11785ce-e82c-44ec-89fd-d40d6f8bf141,posted,Non Hooli ATM Withdrawal Fee,-2.5,070c1d68-0ee0-477a-9679-294ea7059939,8505.56,debit,bank-fee,AU00000,1bd6c08e-8457-4a74-bdd9-514df489d27e,null,7/09/2022,2022-09-07T00:00:00Z,"{\title\"":\""\""","\""code\"":\""card\""}"""
transaction,9e876d17-2d29-433c-b6a7-2807549120ea,posted,MEDIC ALERT,-36.35,070c1d68-0ee0-477a-9679-294ea7059939,8508.06,debit,payment,AU00000,1bd6c08e-8457-4a74-bdd9-514df489d27e,null,1/09/2022,2022-09-01T00:00:00Z,"{\title\"":\""Other Machinery and Equipment Wholesaling\""","\""code\"":\""349\""}"""
transaction,57f45596-3277-4d8d-bb02-253f70a05d8c,posted,Wdl ATM CBA ATM  BALGOWLAH A    NSW 210901   AUS,-400,070c1d68-0ee0-477a-9679-294ea7059939,8544.41,debit,cash-withdrawal,AU00000,1bd6c08e-8457-4a74-bdd9-514df489d27e,null,31/08/2022,2022-08-31T00:00:00Z,null,"{\self\"":\""https://au-api.basiq.io/users/bca4b9cc-b7e2-4458-83bc-4855c147bd70/transactions/57f45596-3277-4d8d-bb02-253f70a05d8c\"""
transaction,a422deed-be40-451e-b48a-86b0a835a222,posted,Transfer Platnm Homeloan 346454,-3935,070c1d68-0ee0-477a-9679-294ea7059939,8944.41,debit,payment,AU00000,1bd6c08e-8457-4a74-bdd9-514df489d27e,null,28/08/2022,2022-08-28T00:00:00Z,"{\title\"":\""Auxiliary Finance and Investment Services\""","\""code\"":\""641\""}"""
transaction,0c0997ce-f1ea-436a-9323-7f3b74f7d923,posted,TFR From Transaction to CC Acc 13,-9323.5,070c1d68-0ee0-477a-9679-294ea7059939,12879.41,debit,payment,AU00000,1bd6c08e-8457-4a74-bdd9-514df489d27e,null,27/08/2022,2022-08-27T00:00:00Z,"{\title\"":\""Civic","Professional and Other Interest Group Services\"""
transaction,db612ca6-20fe-4478-af7b-0bb858ca122a,posted,Payroll WFRMS 15439393,15985,070c1d68-0ee0-477a-9679-294ea7059939,22202.91,credit,transfer,AU00000,1bd6c08e-8457-4a74-bdd9-514df489d27e,null,27/08/2022,2022-08-27T00:00:00Z,"{\title\"":\""Unknown\""","\""code\"":\""0\""}"""
transaction,097c304f-b09d-4266-ad4b-fbb0ac6ed68d,posted,Manly Maths Tutor Wages,201,070c1d68-0ee0-477a-9679-294ea7059939,6217.91,credit,transfer,AU00000,1bd6c08e-8457-4a74-bdd9-514df489d27e,null,17/08/2022,2022-08-17T00:00:00Z,"{\title\"":\""Educational Support Services\""","\""code\"":\""822\""}"""
transaction,836c4dfb-88c9-48d2-b8ce-fa7ff36499d7,posted,MANLY WEST SCHOOL,-2530.81,070c1d68-0ee0-477a-9679-294ea7059939,6016.91,debit,payment,AU00000,1bd6c08e-8457-4a74-bdd9-514df489d27e,null,16/08/2022,2022-08-16T00:00:00Z,"{\title\"":\""School Education\""","\""code\"":\""802\""}"""
transaction,35a0061c-1567-4763-beba-93974897abf9,posted,MANLY WEST SCHOOL,-101,070c1d68-0ee0-477a-9679-294ea7059939,8547.72,debit,payment,AU00000,1bd6c08e-8457-4a74-bdd9-514df489d27e,null,16/08/2022,2022-08-16T00:00:00Z,"{\title\"":\""School Education\""","\""code\"":\""802\""}"""
transaction,f2b7baa0-eca7-4a90-9876-022732097d98,posted,Manly Maths Tutor Wages,201,070c1d68-0ee0-477a-9679-294ea7059939,8648.72,credit,transfer,AU00000,1bd6c08e-8457-4a74-bdd9-514df489d27e,null,13/08/2022,2022-08-13T00:00:00Z,"{\title\"":\""Educational Support Services\""","\""code\"":\""822\""}"""
transaction,73189bf4-4c0c-4207-8a19-8b3b3dc28a08,posted,TFR Acc14000 TO 12389,-500,070c1d68-0ee0-477a-9679-294ea7059939,8447.72,debit,payment,AU00000,1bd6c08e-8457-4a74-bdd9-514df489d27e,null,12/08/2022,2022-08-12T00:00:00Z,"{\title\"":\""Legal and Accounting Services\""","\""code\"":\""693\""}"""
transaction,1dd272f5-6c58-465b-8ab6-015344cd19a9,posted,AGL RETAIL ENERGY LTD,-160,070c1d68-0ee0-477a-9679-294ea7059939,8947.72,debit,payment,AU00000,1bd6c08e-8457-4a74-bdd9-514df489d27e,null,9/08/2022,2022-08-09T00:00:00Z,"{\title\"":\""Electricity Distribution\""","\""code\"":\""263\""}"""
transaction,67ab5af7-d851-4b01-a858-683a12bb2bf4,posted,AGL RETAIL ENERGY LTD (GAS),-69,070c1d68-0ee0-477a-9679-294ea7059939,9107.72,debit,payment,AU00000,1bd6c08e-8457-4a74-bdd9-514df489d27e,null,9/08/2022,2022-08-09T00:00:00Z,"{\title\"":\""Electricity Distribution\""","\""code\"":\""263\""}"""
transaction,acf03d71-894a-494f-9bf3-a1160ce5a8ac,posted,Wdl ATM WES IGA BALGOWLAH HGT  BALGOWL        AU,-200,070c1d68-0ee0-477a-9679-294ea7059939,9176.72,debit,cash-withdrawal,AU00000,1bd6c08e-8457-4a74-bdd9-514df489d27e,null,3/08/2022,2022-08-03T00:00:00Z,null,"{\self\"":\""https://au-api.basiq.io/users/bca4b9cc-b7e2-4458-83bc-4855c147bd70/transactions/acf03d71-894a-494f-9bf3-a1160ce5a8ac\"""
transaction,93c5d592-1b45-47fc-891d-54e3eca900aa,posted,Non Hooli ATM Withdrawal Fee,-2.5,070c1d68-0ee0-477a-9679-294ea7059939,9376.72,debit,bank-fee,AU00000,1bd6c08e-8457-4a74-bdd9-514df489d27e,null,3/08/2022,2022-08-03T00:00:00Z,"{\title\"":\""\""","\""code\"":\""card\""}"""
transaction,ea93880b-31cc-4be3-ae4e-5f6d20efa543,posted,Wdl ATM WES IGA BALGOWLAH HGT  BALGOWL        AU,-200,070c1d68-0ee0-477a-9679-294ea7059939,9379.22,debit,cash-withdrawal,AU00000,1bd6c08e-8457-4a74-bdd9-514df489d27e,null,3/08/2022,2022-08-03T00:00:00Z,null,"{\self\"":\""https://au-api.basiq.io/users/bca4b9cc-b7e2-4458-83bc-4855c147bd70/transactions/ea93880b-31cc-4be3-ae4e-5f6d20efa543\"""
transaction,43208918-2e36-4379-aa52-816aa609401e,posted,Non Hooli ATM Withdrawal Fee,-2.5,070c1d68-0ee0-477a-9679-294ea7059939,9579.22,debit,bank-fee,AU00000,1bd6c08e-8457-4a74-bdd9-514df489d27e,null,3/08/2022,2022-08-03T00:00:00Z,"{\title\"":\""\""","\""code\"":\""card\""}"""
transaction,3dc2ec2a-9524-446d-a7ce-d102b0affda9,posted,Transfer Platnm Homeloan 346454,-3942.5,070c1d68-0ee0-477a-9679-294ea7059939,9581.72,debit,payment,AU00000,1bd6c08e-8457-4a74-bdd9-514df489d27e,null,29/07/2022,2022-07-29T00:00:00Z,"{\title\"":\""Auxiliary Finance and Investment Services\""","\""code\"":\""641\""}"""
transaction,b1350666-6edb-4b10-bc51-6da9143504b7,posted,TFR From Transaction to CC Acc 13,-9316,070c1d68-0ee0-477a-9679-294ea7059939,13524.22,debit,payment,AU00000,1bd6c08e-8457-4a74-bdd9-514df489d27e,null,28/07/2022,2022-07-28T00:00:00Z,"{\title\"":\""Civic","Professional and Other Interest Group Services\"""
transaction,8fbf5f95-1841-4cb5-aee4-c3480d918262,posted,Payroll WFRMS 15439393,15985,070c1d68-0ee0-477a-9679-294ea7059939,22840.22,credit,transfer,AU00000,1bd6c08e-8457-4a74-bdd9-514df489d27e,null,28/07/2022,2022-07-28T00:00:00Z,"{\title\"":\""Unknown\""","\""code\"":\""0\""}"""
transaction,de890a88-4cf4-4b0f-9f01-7ad22cbb867a,posted,CTRLINK CARERS Ref: 998R6789201610974V,61,070c1d68-0ee0-477a-9679-294ea7059939,6855.22,credit,transfer,AU00000,1bd6c08e-8457-4a74-bdd9-514df489d27e,null,28/07/2022,2022-07-28T00:00:00Z,"{\title\"":\""Unknown\""","\""code\"":\""0\""}"""
transaction,59c5fe04-af69-4e16-a287-c828453da377,posted,Manly Maths Tutor Wages,201,070c1d68-0ee0-477a-9679-294ea7059939,6794.22,credit,transfer,AU00000,1bd6c08e-8457-4a74-bdd9-514df489d27e,null,17/07/2022,2022-07-17T00:00:00Z,"{\title\"":\""Educational Support Services\""","\""code\"":\""822\""}"""
transaction,4606cb79-a73d-4eb0-a84a-cfeb0b84db0a,posted,MANLY WEST SCHOOL,-2530.81,070c1d68-0ee0-477a-9679-294ea7059939,6593.22,debit,payment,AU00000,1bd6c08e-8457-4a74-bdd9-514df489d27e,null,15/07/2022,2022-07-15T00:00:00Z,"{\title\"":\""School Education\""","\""code\"":\""802\""}"""
transaction,3566b1fa-e743-4319-b694-cf5c39c544bd,posted,MANLY WEST SCHOOL,-101,070c1d68-0ee0-477a-9679-294ea7059939,9124.03,debit,payment,AU00000,1bd6c08e-8457-4a74-bdd9-514df489d27e,null,15/07/2022,2022-07-15T00:00:00Z,"{\title\"":\""School Education\""","\""code\"":\""802\""}"""
transaction,8c9fcd11-ac87-4828-97b9-7678fb9b7c89,posted,Manly Maths Tutor Wages,201,070c1d68-0ee0-477a-9679-294ea7059939,9225.03,credit,transfer,AU00000,1bd6c08e-8457-4a74-bdd9-514df489d27e,null,13/07/2022,2022-07-13T00:00:00Z,"{\title\"":\""Educational Support Services\""","\""code\"":\""822\""}"""
transaction,fb915385-cfc3-4b51-816c-4bd3b52e596f,posted,MANLY WEST SCHOOL,-26,070c1d68-0ee0-477a-9679-294ea7059939,9024.03,debit,payment,AU00000,1bd6c08e-8457-4a74-bdd9-514df489d27e,null,12/07/2022,2022-07-12T00:00:00Z,"{\title\"":\""School Education\""","\""code\"":\""802\""}"""
transaction,f454e2db-dbd3-4336-a180-3a140519f038,posted,TFR Acc14000 TO 12389,-500,070c1d68-0ee0-477a-9679-294ea7059939,9050.03,debit,payment,AU00000,1bd6c08e-8457-4a74-bdd9-514df489d27e,null,12/07/2022,2022-07-12T00:00:00Z,"{\title\"":\""Legal and Accounting Services\""","\""code\"":\""693\""}"""
transaction,bc55cadd-f1ca-40d2-a1d1-5f89195bafb8,posted,AGL RETAIL ENERGY LTD,-160,070c1d68-0ee0-477a-9679-294ea7059939,9550.03,debit,payment,AU00000,1bd6c08e-8457-4a74-bdd9-514df489d27e,null,11/07/2022,2022-07-11T00:00:00Z,"{\title\"":\""Electricity Distribution\""","\""code\"":\""263\""}"""
transaction,13e41e9c-c154-45f1-a85f-e3ed838cfc6b,posted,AGL RETAIL ENERGY LTD (GAS),-69,070c1d68-0ee0-477a-9679-294ea7059939,9710.03,debit,payment,AU00000,1bd6c08e-8457-4a74-bdd9-514df489d27e,null,11/07/2022,2022-07-11T00:00:00Z,"{\title\"":\""Electricity Distribution\""","\""code\"":\""263\""}"""
transaction,961110b0-d016-431e-b76b-14d9c8a8e288,posted,CTRLINK CARERS Ref: 998R6789201610974V,14,070c1d68-0ee0-477a-9679-294ea7059939,9779.03,credit,transfer,AU00000,1bd6c08e-8457-4a74-bdd9-514df489d27e,null,6/07/2022,2022-07-06T00:00:00Z,"{\title\"":\""Unknown\""","\""code\"":\""0\""}"""
transaction,2ab79b95-8a27-4266-8012-c7106cd46d81,posted,Wdl ATM CBA ATM  SEAFORTH       NSW 225101   AUS,-750,070c1d68-0ee0-477a-9679-294ea7059939,9765.03,debit,cash-withdrawal,AU00000,1bd6c08e-8457-4a74-bdd9-514df489d27e,null,3/07/2022,2022-07-03T00:00:00Z,null,"{\self\"":\""https://au-api.basiq.io/users/bca4b9cc-b7e2-4458-83bc-4855c147bd70/transactions/2ab79b95-8a27-4266-8012-c7106cd46d81\"""
transaction,a6c203a1-4adf-4e8d-a054-4a26f50b19b8,posted,Transfer Platnm Homeloan 346454,-3950,070c1d68-0ee0-477a-9679-294ea7059939,10515.03,debit,payment,AU00000,1bd6c08e-8457-4a74-bdd9-514df489d27e,null,28/06/2022,2022-06-28T00:00:00Z,"{\title\"":\""Auxiliary Finance and Investment Services\""","\""code\"":\""641\""}"""
transaction,8d3bf474-d04e-48f7-9b22-947556e44f28,posted,TFR From Transaction to CC Acc 13,-9308.5,070c1d68-0ee0-477a-9679-294ea7059939,14465.03,debit,payment,AU00000,1bd6c08e-8457-4a74-bdd9-514df489d27e,null,27/06/2022,2022-06-27T00:00:00Z,"{\title\"":\""Civic","Professional and Other Interest Group Services\"""
transaction,6caa5971-4e99-4329-b82b-ba6b8edc5133,posted,Payroll WFRMS 15439393,15985,070c1d68-0ee0-477a-9679-294ea7059939,23773.53,credit,transfer,AU00000,1bd6c08e-8457-4a74-bdd9-514df489d27e,null,27/06/2022,2022-06-27T00:00:00Z,"{\title\"":\""Unknown\""","\""code\"":\""0\""}"""
transaction,49203edf-3758-4db5-a3f5-f3bd6a47c8ec,posted,MANLY WEST SCHOOL,-2533.56,070c1d68-0ee0-477a-9679-294ea7059939,7788.53,debit,payment,AU00000,1bd6c08e-8457-4a74-bdd9-514df489d27e,null,27/06/2022,2022-06-27T00:00:00Z,"{\title\"":\""School Education\""","\""code\"":\""802\""}"""
transaction,31ca2f55-c341-447b-9a81-c00eb925636b,posted,MANLY WEST SCHOOL,-103.75,070c1d68-0ee0-477a-9679-294ea7059939,10322.09,debit,payment,AU00000,1bd6c08e-8457-4a74-bdd9-514df489d27e,null,27/06/2022,2022-06-27T00:00:00Z,"{\title\"":\""School Education\""","\""code\"":\""802\""}"""
transaction,56ed3c4b-88bc-425e-9105-0e5ce157aa54,posted,Manly Maths Tutor Wages,201,070c1d68-0ee0-477a-9679-294ea7059939,10425.84,credit,transfer,AU00000,1bd6c08e-8457-4a74-bdd9-514df489d27e,null,19/06/2022,2022-06-19T00:00:00Z,"{\title\"":\""Educational Support Services\""","\""code\"":\""822\""}"""
transaction,31958121-4752-4e3c-ac75-97dc541df3d7,posted,Manly Maths Tutor Wages,201,070c1d68-0ee0-477a-9679-294ea7059939,10224.84,credit,transfer,AU00000,1bd6c08e-8457-4a74-bdd9-514df489d27e,null,15/06/2022,2022-06-15T00:00:00Z,"{\title\"":\""Educational Support Services\""","\""code\"":\""822\""}"""
transaction,1e359899-06cd-48be-8b45-31f4cfbf0998,posted,TFR Acc14000 TO 12389,-500,070c1d68-0ee0-477a-9679-294ea7059939,10023.84,debit,payment,AU00000,1bd6c08e-8457-4a74-bdd9-514df489d27e,null,16/05/2022,2022-06-14T00:00:00Z,"{\title\"":\""Legal and Accounting Services\""","\""code\"":\""693\""}"""
transaction,9a3814e8-c12a-47c7-a467-8e8b62532ec6,posted,AGL RETAIL ENERGY LTD,-160,070c1d68-0ee0-477a-9679-294ea7059939,10523.84,debit,payment,AU00000,1bd6c08e-8457-4a74-bdd9-514df489d27e,null,13/06/2022,2022-06-13T00:00:00Z,"{\title\"":\""Electricity Distribution\""","\""code\"":\""263\""}"""
transaction,a4ef6948-bc5e-495a-bc67-2b0123459b57,posted,AGL RETAIL ENERGY LTD (GAS),-69,070c1d68-0ee0-477a-9679-294ea7059939,10683.84,debit,payment,AU00000,1bd6c08e-8457-4a74-bdd9-514df489d27e,null,13/06/2022,2022-06-13T00:00:00Z,"{\title\"":\""Electricity Distribution\""","\""code\"":\""263\""}"""
transaction,69a89726-9c99-4e37-9d67-36e679ba7851,posted,CTRLINK CARERS Ref: 998R6789201610974V,752.4,070c1d68-0ee0-477a-9679-294ea7059939,10752.84,credit,transfer,AU00000,1bd6c08e-8457-4a74-bdd9-514df489d27e,null,9/06/2022,2022-06-09T00:00:00Z,"{\title\"":\""Unknown\""","\""code\"":\""0\""}"""
transaction,6ea9a089-043a-4f0f-ad80-cee9c66e731b,posted,Transfer Platnm Homeloan 346454,-3957.5,070c1d68-0ee0-477a-9679-294ea7059939,10000.44,debit,payment,AU00000,1bd6c08e-8457-4a74-bdd9-514df489d27e,null,31/05/2022,2022-05-31T00:00:00Z,"{\title\"":\""Auxiliary Finance and Investment Services\""","\""code\"":\""641\""}"""
transaction,e8375d96-10be-46ab-8a82-2c61605aaffc,posted,CTRLINK CARERS Ref: 998R6789201610974V,261.78,070c1d68-0ee0-477a-9679-294ea7059939,13957.94,credit,transfer,AU00000,1bd6c08e-8457-4a74-bdd9-514df489d27e,null,31/05/2022,2022-05-31T00:00:00Z,"{\title\"":\""Unknown\""","\""code\"":\""0\""}"""
transaction,e8ab4144-c266-4bae-8878-08056292aef9,posted,TFR From Transaction to CC Acc 13,-9301,070c1d68-0ee0-477a-9679-294ea7059939,13696.16,debit,payment,AU00000,1bd6c08e-8457-4a74-bdd9-514df489d27e,null,30/05/2022,2022-05-30T00:00:00Z,"{\title\"":\""Civic","Professional and Other Interest Group Services\"""
transaction,f71aa57c-ddbe-4805-897d-81c133d72239,posted,Payroll WFRMS 15439393,15985,070c1d68-0ee0-477a-9679-294ea7059939,22997.16,credit,transfer,AU00000,1bd6c08e-8457-4a74-bdd9-514df489d27e,null,30/05/2022,2022-05-30T00:00:00Z,"{\title\"":\""Unknown\""","\""code\"":\""0\""}"""
transaction,a8842522-fc0a-4b79-a85d-4437511e01ae,posted,Manly Maths Tutor Wages,201,070c1d68-0ee0-477a-9679-294ea7059939,7012.16,credit,transfer,AU00000,1bd6c08e-8457-4a74-bdd9-514df489d27e,null,17/05/2022,2022-05-17T00:00:00Z,"{\title\"":\""Educational Support Services\""","\""code\"":\""822\""}"""
transaction,d3e5cd4d-cb33-4ab0-aaa2-4027762b6611,posted,Manly Maths Tutor Wages,201,070c1d68-0ee0-477a-9679-294ea7059939,6811.16,credit,transfer,AU00000,1bd6c08e-8457-4a74-bdd9-514df489d27e,null,15/05/2022,2022-05-15T00:00:00Z,"{\title\"":\""Educational Support Services\""","\""code\"":\""822\""}"""
transaction,cf21b11b-9be2-464e-b2e8-574840276adc,posted,TFR Acc14000 TO 12389,-500,070c1d68-0ee0-477a-9679-294ea7059939,6610.16,debit,payment,AU00000,1bd6c08e-8457-4a74-bdd9-514df489d27e,null,14/05/2022,2022-05-14T00:00:00Z,"{\title\"":\""Legal and Accounting Services\""","\""code\"":\""693\""}"""
transaction,78b3be1b-4fd7-4fc7-9561-62365570b319,posted,AGL RETAIL ENERGY LTD,-160,070c1d68-0ee0-477a-9679-294ea7059939,7110.16,debit,payment,AU00000,1bd6c08e-8457-4a74-bdd9-514df489d27e,null,11/05/2022,2022-05-11T00:00:00Z,"{\title\"":\""Electricity Distribution\""","\""code\"":\""263\""}"""
transaction,63028cbd-42c2-4f45-bc7e-dae4c135831e,posted,AGL RETAIL ENERGY LTD (GAS),-69,070c1d68-0ee0-477a-9679-294ea7059939,7270.16,debit,payment,AU00000,1bd6c08e-8457-4a74-bdd9-514df489d27e,null,11/05/2022,2022-05-11T00:00:00Z,"{\title\"":\""Electricity Distribution\""","\""code\"":\""263\""}"""
transaction,7d86d624-14d3-42ea-a00a-ad3cac8036ce,posted,Transfer Platnm Homeloan 346454,-3965,070c1d68-0ee0-477a-9679-294ea7059939,7339.16,debit,payment,AU00000,1bd6c08e-8457-4a74-bdd9-514df489d27e,null,30/04/2022,2022-04-30T00:00:00Z,"{\title\"":\""Auxiliary Finance and Investment Services\""","\""code\"":\""641\""}"""
transaction,c64a8892-b51e-4720-96d7-1a33dd140e3b,posted,TFR From Transaction to CC Acc 13,-9293.5,070c1d68-0ee0-477a-9679-294ea7059939,11304.16,debit,payment,AU00000,1bd6c08e-8457-4a74-bdd9-514df489d27e,null,29/04/2022,2022-04-29T00:00:00Z,"{\title\"":\""Civic","Professional and Other Interest Group Services\"""
transaction,f8370a2f-e894-4ee8-ab4d-474e5744e349,posted,Payroll WFRMS 15439393,15985,070c1d68-0ee0-477a-9679-294ea7059939,20597.66,credit,transfer,AU00000,1bd6c08e-8457-4a74-bdd9-514df489d27e,null,29/04/2022,2022-04-29T00:00:00Z,"{\title\"":\""Unknown\""","\""code\"":\""0\""}"""
transaction,2da800d4-d0a4-4c90-8ba4-018351ff7b0b,posted,Manly Maths Tutor Wages,201,070c1d68-0ee0-477a-9679-294ea7059939,4612.66,credit,transfer,AU00000,1bd6c08e-8457-4a74-bdd9-514df489d27e,null,18/04/2022,2022-04-18T00:00:00Z,"{\title\"":\""Educational Support Services\""","\""code\"":\""822\""}"""
transaction,4f45a037-33c1-4301-bfc9-490927257eab,posted,Manly Maths Tutor Wages,201,070c1d68-0ee0-477a-9679-294ea7059939,4411.66,credit,transfer,AU00000,1bd6c08e-8457-4a74-bdd9-514df489d27e,null,14/04/2022,2022-04-14T00:00:00Z,"{\title\"":\""Educational Support Services\""","\""code\"":\""822\""}"""
transaction,8eaedc76-de2f-4ea5-bfb4-5da5bdaccedf,posted,TFR Acc14000 TO 12389,-500,070c1d68-0ee0-477a-9679-294ea7059939,4210.66,debit,payment,AU00000,1bd6c08e-8457-4a74-bdd9-514df489d27e,null,13/04/2022,2022-04-13T00:00:00Z,"{\title\"":\""Legal and Accounting Services\""","\""code\"":\""693\""}"""
transaction,307a484f-94e2-4ef7-959f-aa05f3db8720,posted,AGL RETAIL ENERGY LTD,-160,070c1d68-0ee0-477a-9679-294ea7059939,4710.66,debit,payment,AU00000,1bd6c08e-8457-4a74-bdd9-514df489d27e,null,11/04/2022,2022-04-11T00:00:00Z,"{\title\"":\""Electricity Distribution\""","\""code\"":\""263\""}"""
transaction,e973beb5-99dd-427d-b11c-c7b7c3e30503,posted,AGL RETAIL ENERGY LTD (GAS),-69,070c1d68-0ee0-477a-9679-294ea7059939,4870.66,debit,payment,AU00000,1bd6c08e-8457-4a74-bdd9-514df489d27e,null,11/04/2022,2022-04-11T00:00:00Z,"{\title\"":\""Electricity Distribution\""","\""code\"":\""263\""}"""
transaction,2dbfa683-412d-42f3-9fad-c1cafdf63327,posted,Wdl ATM WESTPAC IGA BALGOWLAH  BALGOWL        AU,-200,070c1d68-0ee0-477a-9679-294ea7059939,4939.66,debit,cash-withdrawal,AU00000,1bd6c08e-8457-4a74-bdd9-514df489d27e,null,7/04/2022,2022-04-07T00:00:00Z,null,"{\self\"":\""https://au-api.basiq.io/users/bca4b9cc-b7e2-4458-83bc-4855c147bd70/transactions/2dbfa683-412d-42f3-9fad-c1cafdf63327\"""
transaction,8fb5f001-6228-4f93-8dea-35fc10351a21,posted,Non Hooli ATM Withdrawal Fee,-2.5,070c1d68-0ee0-477a-9679-294ea7059939,5139.66,debit,bank-fee,AU00000,1bd6c08e-8457-4a74-bdd9-514df489d27e,null,7/04/2022,2022-04-07T00:00:00Z,"{\title\"":\""\""","\""code\"":\""card\""}"""
transaction,42e4c47e-4f76-429a-981d-c65adec252dc,posted,Wdl ATM WESTPAC IGA BALGOWLAH  BALGOWL        AU,-200,070c1d68-0ee0-477a-9679-294ea7059939,5142.16,debit,cash-withdrawal,AU00000,1bd6c08e-8457-4a74-bdd9-514df489d27e,null,7/04/2022,2022-04-07T00:00:00Z,null,"{\self\"":\""https://au-api.basiq.io/users/bca4b9cc-b7e2-4458-83bc-4855c147bd70/transactions/42e4c47e-4f76-429a-981d-c65adec252dc\"""
transaction,05c0ced1-8883-4fd9-861c-0065defadb6a,posted,Non Hooli ATM Withdrawal Fee,-2.5,070c1d68-0ee0-477a-9679-294ea7059939,5342.16,debit,bank-fee,AU00000,1bd6c08e-8457-4a74-bdd9-514df489d27e,null,7/04/2022,2022-04-07T00:00:00Z,"{\title\"":\""\""","\""code\"":\""card\""}"""
transaction,90d85046-2813-4d01-9df2-4a51250cf667,posted,Wdl ATM WESTPAC IGA BALGOWLAH  BALGOWL        AU,-200,070c1d68-0ee0-477a-9679-294ea7059939,5344.66,debit,cash-withdrawal,AU00000,1bd6c08e-8457-4a74-bdd9-514df489d27e,null,7/04/2022,2022-04-07T00:00:00Z,null,"{\self\"":\""https://au-api.basiq.io/users/bca4b9cc-b7e2-4458-83bc-4855c147bd70/transactions/90d85046-2813-4d01-9df2-4a51250cf667\"""
transaction,848d1832-2d76-4353-8d2e-fac0003e2da3,posted,Non Hooli ATM Withdrawal Fee,-2.5,070c1d68-0ee0-477a-9679-294ea7059939,5544.66,debit,bank-fee,AU00000,1bd6c08e-8457-4a74-bdd9-514df489d27e,null,7/04/2022,2022-04-07T00:00:00Z,"{\title\"":\""\""","\""code\"":\""card\""}"""
transaction,767006a0-98ae-4b57-8a30-99f60bde2e52,posted,Wdl ATM WESTPAC IGA BALGOWLAH  BALGOWL        AU,-450,070c1d68-0ee0-477a-9679-294ea7059939,5547.16,debit,cash-withdrawal,AU00000,1bd6c08e-8457-4a74-bdd9-514df489d27e,null,4/04/2022,2022-04-04T00:00:00Z,null,"{\self\"":\""https://au-api.basiq.io/users/bca4b9cc-b7e2-4458-83bc-4855c147bd70/transactions/767006a0-98ae-4b57-8a30-99f60bde2e52\"""
transaction,55047046-dc28-4a1a-a37a-81cd0cc10bf1,posted,Non Hooli ATM Withdrawal Fee,-2.5,070c1d68-0ee0-477a-9679-294ea7059939,5997.16,debit,bank-fee,AU00000,1bd6c08e-8457-4a74-bdd9-514df489d27e,null,4/04/2022,2022-04-04T00:00:00Z,"{\title\"":\""\""","\""code\"":\""card\""}"""
transaction,d754e878-de08-461e-a835-c82360e11ce7,posted,Wdl ATM WESTPAC IGA BALGOWLAH  BALGOWL        AU,-300,070c1d68-0ee0-477a-9679-294ea7059939,5999.66,debit,cash-withdrawal,AU00000,1bd6c08e-8457-4a74-bdd9-514df489d27e,null,4/04/2022,2022-04-04T00:00:00Z,null,"{\self\"":\""https://au-api.basiq.io/users/bca4b9cc-b7e2-4458-83bc-4855c147bd70/transactions/d754e878-de08-461e-a835-c82360e11ce7\"""
transaction,0d2d0484-45ec-483d-800b-9f5b55484b7c,posted,Non Hooli ATM Withdrawal Fee,-2.5,070c1d68-0ee0-477a-9679-294ea7059939,6299.66,debit,bank-fee,AU00000,1bd6c08e-8457-4a74-bdd9-514df489d27e,null,4/04/2022,2022-04-04T00:00:00Z,"{\title\"":\""\""","\""code\"":\""card\""}"""
transaction,9d46d1fe-384a-49ae-9b87-83e18d68c7db,posted,Wdl ATM CBA ATM  BALGOWLAH A    NSW 210901   AUS,-200,070c1d68-0ee0-477a-9679-294ea7059939,6302.16,debit,cash-withdrawal,AU00000,1bd6c08e-8457-4a74-bdd9-514df489d27e,null,4/04/2022,2022-04-04T00:00:00Z,null,"{\self\"":\""https://au-api.basiq.io/users/bca4b9cc-b7e2-4458-83bc-4855c147bd70/transactions/9d46d1fe-384a-49ae-9b87-83e18d68c7db\"""
transaction,d7a77217-eb85-404c-97af-051fb96f7468,posted,Transfer Platnm Homeloan 346454,-3972.5,070c1d68-0ee0-477a-9679-294ea7059939,6502.16,debit,payment,AU00000,1bd6c08e-8457-4a74-bdd9-514df489d27e,null,30/03/2022,2022-03-30T00:00:00Z,"{\title\"":\""Auxiliary Finance and Investment Services\""","\""code\"":\""641\""}"""
transaction,ccd6f0ee-6b5f-479b-84b5-cd6068a1237e,posted,TFR From Transaction to CC Acc 13,-9286,070c1d68-0ee0-477a-9679-294ea7059939,10474.66,debit,payment,AU00000,1bd6c08e-8457-4a74-bdd9-514df489d27e,null,29/03/2022,2022-03-29T00:00:00Z,"{\title\"":\""Civic","Professional and Other Interest Group Services\"""
transaction,c336eeb3-2a0f-4079-919c-ac45d7edcb57,posted,Payroll WFRMS 15439393,15985,070c1d68-0ee0-477a-9679-294ea7059939,19760.66,credit,transfer,AU00000,1bd6c08e-8457-4a74-bdd9-514df489d27e,null,29/03/2022,2022-03-29T00:00:00Z,"{\title\"":\""Unknown\""","\""code\"":\""0\""}"""
transaction,3c5dd1d3-093d-471e-8ba5-bd8be51802ef,posted,Manly Maths Tutor Wages,201,070c1d68-0ee0-477a-9679-294ea7059939,3775.66,credit,transfer,AU00000,1bd6c08e-8457-4a74-bdd9-514df489d27e,null,17/03/2022,2022-03-17T00:00:00Z,"{\title\"":\""Educational Support Services\""","\""code\"":\""822\""}"""
transaction,3eb97278-1680-4704-bb48-f31b9ffc557c,posted,Manly Maths Tutor Wages,201,070c1d68-0ee0-477a-9679-294ea7059939,3574.66,credit,transfer,AU00000,1bd6c08e-8457-4a74-bdd9-514df489d27e,null,15/03/2022,2022-03-15T00:00:00Z,"{\title\"":\""Educational Support Services\""","\""code\"":\""822\""}"""
transaction,9e29f6db-bf7a-445e-9d57-c64a4ab6c79d,posted,Wdl ATM CBA ATM  MANLY D        NSW 219704   AUS,-420,070c1d68-0ee0-477a-9679-294ea7059939,3373.66,debit,cash-withdrawal,AU00000,1bd6c08e-8457-4a74-bdd9-514df489d27e,null,14/03/2022,2022-03-14T00:00:00Z,null,"{\self\"":\""https://au-api.basiq.io/users/bca4b9cc-b7e2-4458-83bc-4855c147bd70/transactions/9e29f6db-bf7a-445e-9d57-c64a4ab6c79d\"""
transaction,1fb7d9d5-c2a3-4796-8da3-3154b0c806ac,posted,TFR Acc14000 TO 12389,-500,070c1d68-0ee0-477a-9679-294ea7059939,3793.66,debit,payment,AU00000,1bd6c08e-8457-4a74-bdd9-514df489d27e,null,14/03/2022,2022-03-14T00:00:00Z,"{\title\"":\""Legal and Accounting Services\""","\""code\"":\""693\""}"""
transaction,0b2ca127-5d19-4fa3-8ecb-d810023bb936,posted,AGL RETAIL ENERGY LTD,-160,070c1d68-0ee0-477a-9679-294ea7059939,4293.66,debit,payment,AU00000,1bd6c08e-8457-4a74-bdd9-514df489d27e,null,11/03/2022,2022-03-11T00:00:00Z,"{\title\"":\""Electricity Distribution\""","\""code\"":\""263\""}"""
transaction,a1e66ab6-603f-47ed-9f81-8e2f98f2cfb4,posted,AGL RETAIL ENERGY LTD (GAS),-69,070c1d68-0ee0-477a-9679-294ea7059939,4453.66,debit,payment,AU00000,1bd6c08e-8457-4a74-bdd9-514df489d27e,null,11/03/2022,2022-03-11T00:00:00Z,"{\title\"":\""Electricity Distribution\""","\""code\"":\""263\""}"""
transaction,2967be0f-6cf5-4310-b4e6-e393b79af974,posted,Wdl ATM WESTPAC IGA BALGOWLAH  BALGOWL        AU,-350,070c1d68-0ee0-477a-9679-294ea7059939,4522.66,debit,cash-withdrawal,AU00000,1bd6c08e-8457-4a74-bdd9-514df489d27e,null,5/03/2022,2022-03-05T00:00:00Z,null,"{\self\"":\""https://au-api.basiq.io/users/bca4b9cc-b7e2-4458-83bc-4855c147bd70/transactions/2967be0f-6cf5-4310-b4e6-e393b79af974\"""
transaction,56099e15-5752-4a6c-9d7d-818a3e98c0b7,posted,Non Hooli ATM Withdrawal Fee,-2.5,070c1d68-0ee0-477a-9679-294ea7059939,4872.66,debit,bank-fee,AU00000,1bd6c08e-8457-4a74-bdd9-514df489d27e,null,3/05/2022,2022-03-05T00:00:00Z,"{\title\"":\""\""","\""code\"":\""card\""}"""
transaction,af70bf04-0d26-4e80-9840-16069ec7faa6,posted,Wdl ATM WESTPAC IGA BALGOWLAH  BALGOWL        AU,-350,070c1d68-0ee0-477a-9679-294ea7059939,4875.16,debit,cash-withdrawal,AU00000,1bd6c08e-8457-4a74-bdd9-514df489d27e,null,5/03/2022,2022-03-05T00:00:00Z,null,"{\self\"":\""https://au-api.basiq.io/users/bca4b9cc-b7e2-4458-83bc-4855c147bd70/transactions/af70bf04-0d26-4e80-9840-16069ec7faa6\"""
transaction,aad51618-53ee-4b00-a8c1-bb9916e25440,posted,Non Hooli ATM Withdrawal Fee,-2.5,070c1d68-0ee0-477a-9679-294ea7059939,5225.16,debit,bank-fee,AU00000,1bd6c08e-8457-4a74-bdd9-514df489d27e,null,3/05/2022,2022-03-05T00:00:00Z,"{\title\"":\""\""","\""code\"":\""card\""}"""
transaction,2f0f6eea-2eb0-4c99-9190-376901ec10a6,posted,TFR From Transaction to CC Acc 13,-9278.5,070c1d68-0ee0-477a-9679-294ea7059939,9207.66,debit,payment,AU00000,1bd6c08e-8457-4a74-bdd9-514df489d27e,null,28/02/2022,2022-02-28T00:00:00Z,"{\title\"":\""Civic","Professional and Other Interest Group Services\"""
transaction,8dca4865-8bfa-4114-b814-f25450bdda6a,posted,Payroll WFRMS 15439393,15985,070c1d68-0ee0-477a-9679-294ea7059939,18486.16,credit,transfer,AU00000,1bd6c08e-8457-4a74-bdd9-514df489d27e,null,28/02/2022,2022-02-28T00:00:00Z,"{\title\"":\""Unknown\""","\""code\"":\""0\""}"""
transaction,cdbdded4-b7bb-4423-a5cc-686614749f65,posted,Transfer Platnm Homeloan 346454,-3980,070c1d68-0ee0-477a-9679-294ea7059939,5227.66,debit,payment,AU00000,1bd6c08e-8457-4a74-bdd9-514df489d27e,null,28/02/2022,2022-02-28T00:00:00Z,"{\title\"":\""Auxiliary Finance and Investment Services\""","\""code\"":\""641\""}"""
transaction,65cc1679-36bb-448e-9a55-5b45e808f863,posted,Manly Maths Tutor Wages,201,070c1d68-0ee0-477a-9679-294ea7059939,2501.16,credit,transfer,AU00000,1bd6c08e-8457-4a74-bdd9-514df489d27e,null,16/02/2022,2022-02-16T00:00:00Z,"{\title\"":\""Educational Support Services\""","\""code\"":\""822\""}"""
transaction,a75b0fee-c10b-4512-807e-a394972c4d3d,posted,Manly Maths Tutor Wages,201,070c1d68-0ee0-477a-9679-294ea7059939,2300.16,credit,transfer,AU00000,1bd6c08e-8457-4a74-bdd9-514df489d27e,null,13/02/2022,2022-02-13T00:00:00Z,"{\title\"":\""Educational Support Services\""","\""code\"":\""822\""}"""
transaction,81403105-4a32-4274-a167-c4250e6ebdf8,posted,TFR Acc14000 TO 12389,-500,070c1d68-0ee0-477a-9679-294ea7059939,2099.16,debit,payment,AU00000,1bd6c08e-8457-4a74-bdd9-514df489d27e,null,12/02/2022,2022-02-12T00:00:00Z,"{\title\"":\""Legal and Accounting Services\""","\""code\"":\""693\""}"""
transaction,6faec5c6-c154-4f29-8fb6-fa656c06521b,posted,Wdl ATM Redi ATM CEXP BERKSHIREBerkshire      AU,-100,070c1d68-0ee0-477a-9679-294ea7059939,2599.16,debit,cash-withdrawal,AU00000,1bd6c08e-8457-4a74-bdd9-514df489d27e,null,11/02/2022,2022-02-11T00:00:00Z,null,"{\self\"":\""https://au-api.basiq.io/users/bca4b9cc-b7e2-4458-83bc-4855c147bd70/transactions/6faec5c6-c154-4f29-8fb6-fa656c06521b\"""
transaction,8421ff6c-03bb-4f7b-adfd-d220acb61982,posted,Non Hooli ATM Withdrawal Fee,-2.5,070c1d68-0ee0-477a-9679-294ea7059939,2699.16,debit,bank-fee,AU00000,1bd6c08e-8457-4a74-bdd9-514df489d27e,null,11/02/2022,2022-02-11T00:00:00Z,"{\title\"":\""\""","\""code\"":\""card\""}"""
transaction,2a5a20b9-11fe-402f-943e-57f98b33838a,posted,CTRLINK CARERS Ref: 998R6789201610974V,63,070c1d68-0ee0-477a-9679-294ea7059939,2701.66,credit,transfer,AU00000,1bd6c08e-8457-4a74-bdd9-514df489d27e,null,10/02/2022,2022-02-10T00:00:00Z,"{\title\"":\""Unknown\""","\""code\"":\""0\""}"""
transaction,fd49d2d9-02ce-4d7d-8150-b9df7a0f52f2,posted,AGL RETAIL ENERGY LTD,-160,070c1d68-0ee0-477a-9679-294ea7059939,2638.66,debit,payment,AU00000,1bd6c08e-8457-4a74-bdd9-514df489d27e,null,9/02/2022,2022-02-09T00:00:00Z,"{\title\"":\""Electricity Distribution\""","\""code\"":\""263\""}"""
transaction,09531ff9-5774-4cd3-9bb8-783cbb157a8d,posted,AGL RETAIL ENERGY LTD (GAS),-69,070c1d68-0ee0-477a-9679-294ea7059939,2798.66,debit,payment,AU00000,1bd6c08e-8457-4a74-bdd9-514df489d27e,null,9/02/2022,2022-02-09T00:00:00Z,"{\title\"":\""Electricity Distribution\""","\""code\"":\""263\""}"""
transaction,d94d55fa-a3a5-4b7d-89b3-aa18d5d7864f,posted,Transfer Platnm Homeloan 346454,-3987.5,070c1d68-0ee0-477a-9679-294ea7059939,2867.66,debit,payment,AU00000,1bd6c08e-8457-4a74-bdd9-514df489d27e,null,29/01/2022,2022-01-29T00:00:00Z,"{\title\"":\""Auxiliary Finance and Investment Services\""","\""code\"":\""641\""}"""
transaction,cc930c2b-93e5-4dd6-9202-b5da9ae3e7c4,posted,TFR From Transaction to CC Acc 13,-9271,070c1d68-0ee0-477a-9679-294ea7059939,6855.16,debit,payment,AU00000,1bd6c08e-8457-4a74-bdd9-514df489d27e,null,28/01/2022,2022-01-28T00:00:00Z,"{\title\"":\""Civic","Professional and Other Interest Group Services\"""
transaction,354ceeea-a689-4996-beec-f65351e0e2df,posted,Payroll WFRMS 15439393,15985,070c1d68-0ee0-477a-9679-294ea7059939,16126.16,credit,transfer,AU00000,1bd6c08e-8457-4a74-bdd9-514df489d27e,null,28/01/2022,2022-01-28T00:00:00Z,"{\title\"":\""Unknown\""","\""code\"":\""0\""}"""
transaction,177dfc3e-3f3f-4b00-81ac-47802154e66e,posted,CTRLINK CARERS Ref: 998R6789201610974V,16,070c1d68-0ee0-477a-9679-294ea7059939,141.16,credit,transfer,AU00000,1bd6c08e-8457-4a74-bdd9-514df489d27e,null,22/01/2022,2022-01-22T00:00:00Z,"{\title\"":\""Unknown\""","\""code\"":\""0\""}"""
transaction,f0aed035-7188-4913-b795-030946404417,posted,CTRLINK CARERS Ref: 998R6789201610974V,16,070c1d68-0ee0-477a-9679-294ea7059939,125.16,credit,transfer,AU00000,1bd6c08e-8457-4a74-bdd9-514df489d27e,null,22/01/2022,2022-01-22T00:00:00Z,"{\title\"":\""Unknown\""","\""code\"":\""0\""}"""
transaction,8eeaef0a-bf77-456a-9908-8edb3b812ae5,posted,Wdl ATM CBA ATM  MANLY D        NSW 219704   AUS,-300,070c1d68-0ee0-477a-9679-294ea7059939,109.16,debit,cash-withdrawal,AU00000,1bd6c08e-8457-4a74-bdd9-514df489d27e,null,18/01/2022,2022-01-18T00:00:00Z,null,"{\self\"":\""https://au-api.basiq.io/users/bca4b9cc-b7e2-4458-83bc-4855c147bd70/transactions/8eeaef0a-bf77-456a-9908-8edb3b812ae5\"""
transaction,6c16c34d-5b3d-47f7-a65c-39773ff31fe0,posted,Manly Maths Tutor Wages,201,070c1d68-0ee0-477a-9679-294ea7059939,409.16,credit,transfer,AU00000,1bd6c08e-8457-4a74-bdd9-514df489d27e,null,18/01/2022,2022-01-18T00:00:00Z,"{\title\"":\""Educational Support Services\""","\""code\"":\""822\""}"""
transaction,ac393e5e-ba34-461f-8fd9-7e14a77e660e,posted,Wdl ATM WESTPAC IGA BALGOWLAH  BALGOWL        AU,-200,070c1d68-0ee0-477a-9679-294ea7059939,208.16,debit,cash-withdrawal,AU00000,1bd6c08e-8457-4a74-bdd9-514df489d27e,null,17/01/2022,2022-01-17T00:00:00Z,null,"{\self\"":\""https://au-api.basiq.io/users/bca4b9cc-b7e2-4458-83bc-4855c147bd70/transactions/ac393e5e-ba34-461f-8fd9-7e14a77e660e\"""
transaction,64345762-2048-4a76-8e3e-25b8efcd9f0f,posted,Non Hooli ATM Withdrawal Fee,-2.5,070c1d68-0ee0-477a-9679-294ea7059939,408.16,debit,bank-fee,AU00000,1bd6c08e-8457-4a74-bdd9-514df489d27e,null,17/01/2022,2022-01-17T00:00:00Z,"{\title\"":\""\""","\""code\"":\""card\""}"""
transaction,a19587bd-03a1-4a88-a011-0d121c6b71a2,posted,Wdl ATM WESTPAC IGA BALGOWLAH  BALGOWL        AU,-100,070c1d68-0ee0-477a-9679-294ea7059939,410.66,debit,cash-withdrawal,AU00000,1bd6c08e-8457-4a74-bdd9-514df489d27e,null,17/01/2022,2022-01-17T00:00:00Z,null,"{\self\"":\""https://au-api.basiq.io/users/bca4b9cc-b7e2-4458-83bc-4855c147bd70/transactions/a19587bd-03a1-4a88-a011-0d121c6b71a2\"""
transaction,10cda4ed-235a-486c-99e9-ddad971949a7,posted,Non Hooli ATM Withdrawal Fee,-2.5,070c1d68-0ee0-477a-9679-294ea7059939,510.66,debit,bank-fee,AU00000,1bd6c08e-8457-4a74-bdd9-514df489d27e,null,17/01/2022,2022-01-17T00:00:00Z,"{\title\"":\""\""","\""code\"":\""card\""}"""
transaction,b8316d38-dc7c-4aa6-b6ee-0974f3c75c0f,posted,Wdl ATM CBA ATM  MANLY E        NSW 219705   AUS,-100,070c1d68-0ee0-477a-9679-294ea7059939,513.16,debit,cash-withdrawal,AU00000,1bd6c08e-8457-4a74-bdd9-514df489d27e,null,16/01/2022,2022-01-16T00:00:00Z,null,"{\self\"":\""https://au-api.basiq.io/users/bca4b9cc-b7e2-4458-83bc-4855c147bd70/transactions/b8316d38-dc7c-4aa6-b6ee-0974f3c75c0f\"""
transaction,4a3ae78d-2d40-49bd-b071-4cca25ac6f38,posted,Manly Maths Tutor Wages,201,070c1d68-0ee0-477a-9679-294ea7059939,613.16,credit,transfer,AU00000,1bd6c08e-8457-4a74-bdd9-514df489d27e,null,14/01/2022,2022-01-14T00:00:00Z,"{\title\"":\""Educational Support Services\""","\""code\"":\""822\""}"""
transaction,1f7c3bb6-eb49-4354-b1a0-a3f2ea6f1a0d,posted,TFR Acc14000 TO 12389,-500,070c1d68-0ee0-477a-9679-294ea7059939,412.16,debit,payment,AU00000,1bd6c08e-8457-4a74-bdd9-514df489d27e,null,13/01/2022,2022-01-13T00:00:00Z,"{\title\"":\""Legal and Accounting Services\""","\""code\"":\""693\""}"""
transaction,16ef4d5f-2c50-4ad7-8787-5cd62782c98e,posted,AGL RETAIL ENERGY LTD,-160,070c1d68-0ee0-477a-9679-294ea7059939,912.16,debit,payment,AU00000,1bd6c08e-8457-4a74-bdd9-514df489d27e,null,11/01/2022,2022-01-11T00:00:00Z,"{\title\"":\""Electricity Distribution\""","\""code\"":\""263\""}"""
transaction,674c5443-c7dc-4bbb-a083-b4701c1babf2,posted,AGL RETAIL ENERGY LTD (GAS),-92,070c1d68-0ee0-477a-9679-294ea7059939,1072.16,debit,payment,AU00000,1bd6c08e-8457-4a74-bdd9-514df489d27e,null,11/01/2022,2022-01-11T00:00:00Z,"{\title\"":\""Electricity Distribution\""","\""code\"":\""263\""}"""
transaction,38818609-4b72-4595-bdff-474898d6fb5d,posted,Wdl ATM WESTPAC IGA BALGOWLAH  BALGOWL        AU,-100,070c1d68-0ee0-477a-9679-294ea7059939,1164.16,debit,cash-withdrawal,AU00000,1bd6c08e-8457-4a74-bdd9-514df489d27e,null,3/01/2022,2022-01-03T00:00:00Z,null,"{\self\"":\""https://au-api.basiq.io/users/bca4b9cc-b7e2-4458-83bc-4855c147bd70/transactions/38818609-4b72-4595-bdff-474898d6fb5d\"""
transaction,47eb2d1f-b822-485e-acc4-9b1542769d73,posted,Non Hooli ATM Withdrawal Fee,-2.5,070c1d68-0ee0-477a-9679-294ea7059939,1264.16,debit,bank-fee,AU00000,1bd6c08e-8457-4a74-bdd9-514df489d27e,null,3/01/2022,2022-01-03T00:00:00Z,"{\title\"":\""\""","\""code\"":\""card\""}"""
transaction,21963cee-7164-40a3-92f4-808f096ab7d1,posted,Transfer Platnm Homeloan 346454,-3995,070c1d68-0ee0-477a-9679-294ea7059939,1266.66,debit,payment,AU00000,1bd6c08e-8457-4a74-bdd9-514df489d27e,null,30/12/2021,2021-12-30T00:00:00Z,"{\title\"":\""Auxiliary Finance and Investment Services\""","\""code\"":\""641\""}"""
transaction,b3fe049f-590e-403a-8429-aabeb7e64206,posted,Wdl ATM CBA ATM  BALGOWLAH A    NSW 210901   AUS,-200,070c1d68-0ee0-477a-9679-294ea7059939,5261.66,debit,cash-withdrawal,AU00000,1bd6c08e-8457-4a74-bdd9-514df489d27e,null,29/12/2021,2021-12-29T00:00:00Z,null,"{\self\"":\""https://au-api.basiq.io/users/bca4b9cc-b7e2-4458-83bc-4855c147bd70/transactions/b3fe049f-590e-403a-8429-aabeb7e64206\"""
transaction,137a1191-0b29-40ff-9a19-afc76bb65f74,posted,Wdl ATM CBA ATM  BALGOWLAH A    NSW 210901   AUS,-100,070c1d68-0ee0-477a-9679-294ea7059939,5461.66,debit,cash-withdrawal,AU00000,1bd6c08e-8457-4a74-bdd9-514df489d27e,null,29/12/2021,2021-12-29T00:00:00Z,null,"{\self\"":\""https://au-api.basiq.io/users/bca4b9cc-b7e2-4458-83bc-4855c147bd70/transactions/137a1191-0b29-40ff-9a19-afc76bb65f74\"""
transaction,3d4fa59e-278e-4141-9be3-4e3dbae736b1,posted,TFR From Transaction to CC Acc 13,-9263.5,070c1d68-0ee0-477a-9679-294ea7059939,5561.66,debit,payment,AU00000,1bd6c08e-8457-4a74-bdd9-514df489d27e,null,29/12/2021,2021-12-29T00:00:00Z,"{\title\"":\""Civic","Professional and Other Interest Group Services\"""
transaction,fba539c2-a946-4def-9577-66a23a24a121,posted,Payroll WFRMS 15439393,15985,070c1d68-0ee0-477a-9679-294ea7059939,14825.16,credit,transfer,AU00000,1bd6c08e-8457-4a74-bdd9-514df489d27e,null,29/12/2021,2021-12-29T00:00:00Z,"{\title\"":\""Unknown\""","\""code\"":\""0\""}"""
transaction,6b5f468f-8c43-491b-9789-76a50718ec5a,posted,Wdl ATM CBA ATM  MANLY A        NSW 219701   AUS,-400,070c1d68-0ee0-477a-9679-294ea7059939,-1159.84,debit,cash-withdrawal,AU00000,1bd6c08e-8457-4a74-bdd9-514df489d27e,null,27/12/2027,2021-12-27T00:00:00Z,null,"{\self\"":\""https://au-api.basiq.io/users/bca4b9cc-b7e2-4458-83bc-4855c147bd70/transactions/6b5f468f-8c43-491b-9789-76a50718ec5a\"""
transaction,69e204dd-ad4e-45cb-997d-ccec09e75a3d,posted,Wdl ATM WESTPAC IGA BALGOWLAH  BALGOWL        AU,-200,070c1d68-0ee0-477a-9679-294ea7059939,-759.84,debit,cash-withdrawal,AU00000,1bd6c08e-8457-4a74-bdd9-514df489d27e,null,26/12/2021,2021-12-26T00:00:00Z,null,"{\self\"":\""https://au-api.basiq.io/users/bca4b9cc-b7e2-4458-83bc-4855c147bd70/transactions/69e204dd-ad4e-45cb-997d-ccec09e75a3d\"""
transaction,5b20b38e-6c98-4bfc-97bc-7c9ea2ccc983,posted,Manly Maths Tutor Wages,201,070c1d68-0ee0-477a-9679-294ea7059939,-357.34,credit,transfer,AU00000,1bd6c08e-8457-4a74-bdd9-514df489d27e,null,26/12/2021,2021-12-16T00:00:00Z,"{\title\"":\""Educational Support Services\""","\""code\"":\""822\""}"""
transaction,1973ec3d-7680-45dd-ac2e-e1eb97c97ea3,posted,Manly Maths Tutor Wages,201,070c1d68-0ee0-477a-9679-294ea7059939,-558.34,credit,transfer,AU00000,1bd6c08e-8457-4a74-bdd9-514df489d27e,null,14/12/2021,2021-12-14T00:00:00Z,"{\title\"":\""Educational Support Services\""","\""code\"":\""822\""}"""
transaction,8598b570-b80f-42a6-9a52-e73425b3ccd0,posted,TFR Acc14000 TO 12389,-500,070c1d68-0ee0-477a-9679-294ea7059939,-759.34,debit,payment,AU00000,1bd6c08e-8457-4a74-bdd9-514df489d27e,null,13/12/2021,2021-12-13T00:00:00Z,"{\title\"":\""Legal and Accounting Services\""","\""code\"":\""693\""}"""
transaction,414279bc-9226-45c5-9722-b18269374373,posted,AGL RETAIL ENERGY LTD (GAS),-160,070c1d68-0ee0-477a-9679-294ea7059939,-259.34,debit,payment,AU00000,1bd6c08e-8457-4a74-bdd9-514df489d27e,null,10/12/2021,2021-12-10T00:00:00Z,"{\title\"":\""Electricity Distribution\""","\""code\"":\""263\""}"""
transaction,312885c2-6ff6-4d96-89c9-0bf1b2987f46,posted,AGL RETAIL ENERGY LTD (GAS),-92,070c1d68-0ee0-477a-9679-294ea7059939,-99.34,debit,payment,AU00000,1bd6c08e-8457-4a74-bdd9-514df489d27e,null,10/12/2021,2021-12-10T00:00:00Z,"{\title\"":\""Electricity Distribution\""","\""code\"":\""263\""}"""
