type,id,status,description,amount,account,balance,direction,class,institution,connection,enrich,transactionDate,postDate,subClass,links.self,links.account,links.institution,links.connection,subClass.title,subClass.code
transaction,8e4c0c2d-cb58-4e40-8082-ecef33db69c7,posted,Transfer Platnm Homeloan 346454,-3972.50,0b107c33-e858-4bbd-abba-f757ae4da1fc,6502.16,debit,transfer,AU00000,5453f0a3-083c-43c6-9086-adfe94df9918,,,2022-03-30T00:00:00Z,,https://au-api.basiq.io/users/11103cba-4a08-4397-84a5-22ac125ed2f6/transactions/8e4c0c2d-cb58-4e40-8082-ecef33db69c7,https://au-api.basiq.io/users/11103cba-4a08-4397-84a5-22ac125ed2f6/accounts/0b107c33-e858-4bbd-abba-f757ae4da1fc,https://au-api.basiq.io/institutions/AU00000,,,
transaction,b067491b-1abe-479c-88ae-62e96d44cc0e,posted,TFR From Transaction to CC Acc 13,-9286.00,0b107c33-e858-4bbd-abba-f757ae4da1fc,10474.66,debit,transfer,AU00000,5453f0a3-083c-43c6-9086-adfe94df9918,,,2022-03-29T00:00:00Z,,https://au-api.basiq.io/users/11103cba-4a08-4397-84a5-22ac125ed2f6/transactions/b067491b-1abe-479c-88ae-62e96d44cc0e,https://au-api.basiq.io/users/11103cba-4a08-4397-84a5-22ac125ed2f6/accounts/0b107c33-e858-4bbd-abba-f757ae4da1fc,https://au-api.basiq.io/institutions/AU00000,,,
transaction,32b08ba0-331e-4986-b032-c6adeb75a01d,posted,Payroll WFRMS 15439393,15985.00,0b107c33-e858-4bbd-abba-f757ae4da1fc,19760.66,credit,transfer,AU00000,5453f0a3-083c-43c6-9086-adfe94df9918,,,2022-03-29T00:00:00Z,,https://au-api.basiq.io/users/11103cba-4a08-4397-84a5-22ac125ed2f6/transactions/32b08ba0-331e-4986-b032-c6adeb75a01d,https://au-api.basiq.io/users/11103cba-4a08-4397-84a5-22ac125ed2f6/accounts/0b107c33-e858-4bbd-abba-f757ae4da1fc,https://au-api.basiq.io/institutions/AU00000,,,
transaction,569c9917-51c8-4d8f-96f3-5ba3000c1beb,posted,Manly Maths Tutor Wages,201.00,0b107c33-e858-4bbd-abba-f757ae4da1fc,3775.66,credit,transfer,AU00000,5453f0a3-083c-43c6-9086-adfe94df9918,,,2022-03-17T00:00:00Z,,https://au-api.basiq.io/users/11103cba-4a08-4397-84a5-22ac125ed2f6/transactions/569c9917-51c8-4d8f-96f3-5ba3000c1beb,https://au-api.basiq.io/users/11103cba-4a08-4397-84a5-22ac125ed2f6/accounts/0b107c33-e858-4bbd-abba-f757ae4da1fc,https://au-api.basiq.io/institutions/AU00000,,,
transaction,6cf243ed-e54a-4cfd-97a1-0844e43b81ad,posted,Manly Maths Tutor Wages,201.00,0b107c33-e858-4bbd-abba-f757ae4da1fc,3574.66,credit,transfer,AU00000,5453f0a3-083c-43c6-9086-adfe94df9918,,,2022-03-15T00:00:00Z,,https://au-api.basiq.io/users/11103cba-4a08-4397-84a5-22ac125ed2f6/transactions/6cf243ed-e54a-4cfd-97a1-0844e43b81ad,https://au-api.basiq.io/users/11103cba-4a08-4397-84a5-22ac125ed2f6/accounts/0b107c33-e858-4bbd-abba-f757ae4da1fc,https://au-api.basiq.io/institutions/AU00000,,,
transaction,ba27716f-e8b5-4a31-9b03-fb98edfbac60,posted,Wdl ATM CBA ATM  MANLY D        NSW 219704   AUS,-420.00,0b107c33-e858-4bbd-abba-f757ae4da1fc,3373.66,debit,cash-withdrawal,AU00000,5453f0a3-083c-43c6-9086-adfe94df9918,,,2022-03-14T00:00:00Z,,https://au-api.basiq.io/users/11103cba-4a08-4397-84a5-22ac125ed2f6/transactions/ba27716f-e8b5-4a31-9b03-fb98edfbac60,https://au-api.basiq.io/users/11103cba-4a08-4397-84a5-22ac125ed2f6/accounts/0b107c33-e858-4bbd-abba-f757ae4da1fc,https://au-api.basiq.io/institutions/AU00000,,,
transaction,295a38f4-4138-45af-8e95-fe42a3834615,posted,TFR Acc14000 TO 12389,-500.00,0b107c33-e858-4bbd-abba-f757ae4da1fc,3793.66,debit,transfer,AU00000,5453f0a3-083c-43c6-9086-adfe94df9918,,,2022-03-14T00:00:00Z,,https://au-api.basiq.io/users/11103cba-4a08-4397-84a5-22ac125ed2f6/transactions/295a38f4-4138-45af-8e95-fe42a3834615,https://au-api.basiq.io/users/11103cba-4a08-4397-84a5-22ac125ed2f6/accounts/0b107c33-e858-4bbd-abba-f757ae4da1fc,https://au-api.basiq.io/institutions/AU00000,,,
transaction,ee89c0b4-cc79-4986-966e-027ffb6266d6,posted,AGL RETAIL ENERGY LTD,-160.00,0b107c33-e858-4bbd-abba-f757ae4da1fc,4293.66,debit,payment,AU00000,5453f0a3-083c-43c6-9086-adfe94df9918,,,2022-03-11T00:00:00Z,,https://au-api.basiq.io/users/11103cba-4a08-4397-84a5-22ac125ed2f6/transactions/ee89c0b4-cc79-4986-966e-027ffb6266d6,https://au-api.basiq.io/users/11103cba-4a08-4397-84a5-22ac125ed2f6/accounts/0b107c33-e858-4bbd-abba-f757ae4da1fc,https://au-api.basiq.io/institutions/AU00000,,Electricity Distribution,263
transaction,7e681d12-8ce5-4525-a0ed-1405436ea1ee,posted,AGL RETAIL ENERGY LTD (GAS),-69.00,0b107c33-e858-4bbd-abba-f757ae4da1fc,4453.66,debit,payment,AU00000,5453f0a3-083c-43c6-9086-adfe94df9918,,,2022-03-11T00:00:00Z,,https://au-api.basiq.io/users/11103cba-4a08-4397-84a5-22ac125ed2f6/transactions/7e681d12-8ce5-4525-a0ed-1405436ea1ee,https://au-api.basiq.io/users/11103cba-4a08-4397-84a5-22ac125ed2f6/accounts/0b107c33-e858-4bbd-abba-f757ae4da1fc,https://au-api.basiq.io/institutions/AU00000,,Electricity Distribution,263
transaction,3175f0ef-bfbe-4297-954e-7803eb01f1e1,posted,Wdl ATM WESTPAC IGA BALGOWLAH  BALGOWL        AU,-350.00,0b107c33-e858-4bbd-abba-f757ae4da1fc,4522.66,debit,cash-withdrawal,AU00000,5453f0a3-083c-43c6-9086-adfe94df9918,,,2022-03-05T00:00:00Z,,https://au-api.basiq.io/users/11103cba-4a08-4397-84a5-22ac125ed2f6/transactions/3175f0ef-bfbe-4297-954e-7803eb01f1e1,https://au-api.basiq.io/users/11103cba-4a08-4397-84a5-22ac125ed2f6/accounts/0b107c33-e858-4bbd-abba-f757ae4da1fc,https://au-api.basiq.io/institutions/AU00000,,,
transaction,35934dc1-8702-49b6-bb42-1913aa09053b,posted,Non Hooli ATM Withdrawal Fee,-2.50,0b107c33-e858-4bbd-abba-f757ae4da1fc,4872.66,debit,bank-fee,AU00000,5453f0a3-083c-43c6-9086-adfe94df9918,,,2022-03-05T00:00:00Z,,https://au-api.basiq.io/users/11103cba-4a08-4397-84a5-22ac125ed2f6/transactions/35934dc1-8702-49b6-bb42-1913aa09053b,https://au-api.basiq.io/users/11103cba-4a08-4397-84a5-22ac125ed2f6/accounts/0b107c33-e858-4bbd-abba-f757ae4da1fc,https://au-api.basiq.io/institutions/AU00000,,,
transaction,210d4c84-8877-4535-9a8e-f74f0c9e4bb8,posted,Wdl ATM WESTPAC IGA BALGOWLAH  BALGOWL        AU,-350.00,0b107c33-e858-4bbd-abba-f757ae4da1fc,4875.16,debit,cash-withdrawal,AU00000,5453f0a3-083c-43c6-9086-adfe94df9918,,,2022-03-05T00:00:00Z,,https://au-api.basiq.io/users/11103cba-4a08-4397-84a5-22ac125ed2f6/transactions/210d4c84-8877-4535-9a8e-f74f0c9e4bb8,https://au-api.basiq.io/users/11103cba-4a08-4397-84a5-22ac125ed2f6/accounts/0b107c33-e858-4bbd-abba-f757ae4da1fc,https://au-api.basiq.io/institutions/AU00000,,,
transaction,30927c96-61cd-4965-95d5-b0ae7e143d60,posted,Non Hooli ATM Withdrawal Fee,-2.50,0b107c33-e858-4bbd-abba-f757ae4da1fc,5225.16,debit,bank-fee,AU00000,5453f0a3-083c-43c6-9086-adfe94df9918,,,2022-03-05T00:00:00Z,,https://au-api.basiq.io/users/11103cba-4a08-4397-84a5-22ac125ed2f6/transactions/30927c96-61cd-4965-95d5-b0ae7e143d60,https://au-api.basiq.io/users/11103cba-4a08-4397-84a5-22ac125ed2f6/accounts/0b107c33-e858-4bbd-abba-f757ae4da1fc,https://au-api.basiq.io/institutions/AU00000,,,
transaction,2ee4781d-4d0c-4cc9-ba98-3076736664be,posted,TFR From Transaction to CC Acc 13,-9278.50,0b107c33-e858-4bbd-abba-f757ae4da1fc,9207.66,debit,transfer,AU00000,5453f0a3-083c-43c6-9086-adfe94df9918,,,2022-02-28T00:00:00Z,,https://au-api.basiq.io/users/11103cba-4a08-4397-84a5-22ac125ed2f6/transactions/2ee4781d-4d0c-4cc9-ba98-3076736664be,https://au-api.basiq.io/users/11103cba-4a08-4397-84a5-22ac125ed2f6/accounts/0b107c33-e858-4bbd-abba-f757ae4da1fc,https://au-api.basiq.io/institutions/AU00000,,,
transaction,e2708ecc-e3fa-4a02-8c5c-36446f00c710,posted,Transfer Platnm Homeloan 346454,-3980.00,0b107c33-e858-4bbd-abba-f757ae4da1fc,5227.66,debit,transfer,AU00000,5453f0a3-083c-43c6-9086-adfe94df9918,,,2022-02-28T00:00:00Z,,https://au-api.basiq.io/users/11103cba-4a08-4397-84a5-22ac125ed2f6/transactions/e2708ecc-e3fa-4a02-8c5c-36446f00c710,https://au-api.basiq.io/users/11103cba-4a08-4397-84a5-22ac125ed2f6/accounts/0b107c33-e858-4bbd-abba-f757ae4da1fc,https://au-api.basiq.io/institutions/AU00000,,,
transaction,49db9f22-fffc-471e-a79d-8cac5facf876,posted,Payroll WFRMS 15439393,15985.00,0b107c33-e858-4bbd-abba-f757ae4da1fc,18486.16,credit,transfer,AU00000,5453f0a3-083c-43c6-9086-adfe94df9918,,,2022-02-28T00:00:00Z,,https://au-api.basiq.io/users/11103cba-4a08-4397-84a5-22ac125ed2f6/transactions/49db9f22-fffc-471e-a79d-8cac5facf876,https://au-api.basiq.io/users/11103cba-4a08-4397-84a5-22ac125ed2f6/accounts/0b107c33-e858-4bbd-abba-f757ae4da1fc,https://au-api.basiq.io/institutions/AU00000,,,
transaction,e87e9b37-46a9-44a7-9a58-fbbf83fe0006,posted,Manly Maths Tutor Wages,201.00,0b107c33-e858-4bbd-abba-f757ae4da1fc,2501.16,credit,transfer,AU00000,5453f0a3-083c-43c6-9086-adfe94df9918,,,2022-02-16T00:00:00Z,,https://au-api.basiq.io/users/11103cba-4a08-4397-84a5-22ac125ed2f6/transactions/e87e9b37-46a9-44a7-9a58-fbbf83fe0006,https://au-api.basiq.io/users/11103cba-4a08-4397-84a5-22ac125ed2f6/accounts/0b107c33-e858-4bbd-abba-f757ae4da1fc,https://au-api.basiq.io/institutions/AU00000,,,
transaction,dd298432-c060-418a-9fa6-66acb642ece8,posted,Manly Maths Tutor Wages,201.00,0b107c33-e858-4bbd-abba-f757ae4da1fc,2300.16,credit,transfer,AU00000,5453f0a3-083c-43c6-9086-adfe94df9918,,,2022-02-13T00:00:00Z,,https://au-api.basiq.io/users/11103cba-4a08-4397-84a5-22ac125ed2f6/transactions/dd298432-c060-418a-9fa6-66acb642ece8,https://au-api.basiq.io/users/11103cba-4a08-4397-84a5-22ac125ed2f6/accounts/0b107c33-e858-4bbd-abba-f757ae4da1fc,https://au-api.basiq.io/institutions/AU00000,,,
transaction,8d19928e-dad6-487d-accd-264c10780a99,posted,TFR Acc14000 TO 12389,-500.00,0b107c33-e858-4bbd-abba-f757ae4da1fc,2099.16,debit,transfer,AU00000,5453f0a3-083c-43c6-9086-adfe94df9918,,,2022-02-12T00:00:00Z,,https://au-api.basiq.io/users/11103cba-4a08-4397-84a5-22ac125ed2f6/transactions/8d19928e-dad6-487d-accd-264c10780a99,https://au-api.basiq.io/users/11103cba-4a08-4397-84a5-22ac125ed2f6/accounts/0b107c33-e858-4bbd-abba-f757ae4da1fc,https://au-api.basiq.io/institutions/AU00000,,,
transaction,5dc47815-dc71-4a2a-97f6-1e1902b6188e,posted,Wdl ATM Redi ATM CEXP BERKSHIREBerkshire      AU,-100.00,0b107c33-e858-4bbd-abba-f757ae4da1fc,2599.16,debit,cash-withdrawal,AU00000,5453f0a3-083c-43c6-9086-adfe94df9918,,,2022-02-11T00:00:00Z,,https://au-api.basiq.io/users/11103cba-4a08-4397-84a5-22ac125ed2f6/transactions/5dc47815-dc71-4a2a-97f6-1e1902b6188e,https://au-api.basiq.io/users/11103cba-4a08-4397-84a5-22ac125ed2f6/accounts/0b107c33-e858-4bbd-abba-f757ae4da1fc,https://au-api.basiq.io/institutions/AU00000,,,
transaction,bf8fddda-9820-43d5-9682-bbfd45ee181b,posted,Non Hooli ATM Withdrawal Fee,-2.50,0b107c33-e858-4bbd-abba-f757ae4da1fc,2699.16,debit,bank-fee,AU00000,5453f0a3-083c-43c6-9086-adfe94df9918,,,2022-02-11T00:00:00Z,,https://au-api.basiq.io/users/11103cba-4a08-4397-84a5-22ac125ed2f6/transactions/bf8fddda-9820-43d5-9682-bbfd45ee181b,https://au-api.basiq.io/users/11103cba-4a08-4397-84a5-22ac125ed2f6/accounts/0b107c33-e858-4bbd-abba-f757ae4da1fc,https://au-api.basiq.io/institutions/AU00000,,,
transaction,724fd80b-e1c0-4738-9c32-ed12bb00e973,posted,CTRLINK CARERS Ref: 998R6789201610974V,63.00,0b107c33-e858-4bbd-abba-f757ae4da1fc,2701.66,credit,transfer,AU00000,5453f0a3-083c-43c6-9086-adfe94df9918,,,2022-02-10T00:00:00Z,,https://au-api.basiq.io/users/11103cba-4a08-4397-84a5-22ac125ed2f6/transactions/724fd80b-e1c0-4738-9c32-ed12bb00e973,https://au-api.basiq.io/users/11103cba-4a08-4397-84a5-22ac125ed2f6/accounts/0b107c33-e858-4bbd-abba-f757ae4da1fc,https://au-api.basiq.io/institutions/AU00000,,,
transaction,51cb2bf5-80bd-4c4b-ac48-681fcd31ff32,posted,AGL RETAIL ENERGY LTD,-160.00,0b107c33-e858-4bbd-abba-f757ae4da1fc,2638.66,debit,payment,AU00000,5453f0a3-083c-43c6-9086-adfe94df9918,,,2022-02-09T00:00:00Z,,https://au-api.basiq.io/users/11103cba-4a08-4397-84a5-22ac125ed2f6/transactions/51cb2bf5-80bd-4c4b-ac48-681fcd31ff32,https://au-api.basiq.io/users/11103cba-4a08-4397-84a5-22ac125ed2f6/accounts/0b107c33-e858-4bbd-abba-f757ae4da1fc,https://au-api.basiq.io/institutions/AU00000,,Electricity Distribution,263
transaction,d573e39a-9ad5-463e-a9e9-d058bbfe2f48,posted,AGL RETAIL ENERGY LTD (GAS),-69.00,0b107c33-e858-4bbd-abba-f757ae4da1fc,2798.66,debit,payment,AU00000,5453f0a3-083c-43c6-9086-adfe94df9918,,,2022-02-09T00:00:00Z,,https://au-api.basiq.io/users/11103cba-4a08-4397-84a5-22ac125ed2f6/transactions/d573e39a-9ad5-463e-a9e9-d058bbfe2f48,https://au-api.basiq.io/users/11103cba-4a08-4397-84a5-22ac125ed2f6/accounts/0b107c33-e858-4bbd-abba-f757ae4da1fc,https://au-api.basiq.io/institutions/AU00000,,Electricity Distribution,263
transaction,2acf752b-4b46-46d4-80eb-9f6e4a4bb441,posted,Transfer Platnm Homeloan 346454,-3987.50,0b107c33-e858-4bbd-abba-f757ae4da1fc,2867.66,debit,transfer,AU00000,5453f0a3-083c-43c6-9086-adfe94df9918,,,2022-01-29T00:00:00Z,,https://au-api.basiq.io/users/11103cba-4a08-4397-84a5-22ac125ed2f6/transactions/2acf752b-4b46-46d4-80eb-9f6e4a4bb441,https://au-api.basiq.io/users/11103cba-4a08-4397-84a5-22ac125ed2f6/accounts/0b107c33-e858-4bbd-abba-f757ae4da1fc,https://au-api.basiq.io/institutions/AU00000,,,
transaction,ac459c23-8c50-42ee-aed8-b5856cdf3b06,posted,TFR From Transaction to CC Acc 13,-9271.00,0b107c33-e858-4bbd-abba-f757ae4da1fc,6855.16,debit,transfer,AU00000,5453f0a3-083c-43c6-9086-adfe94df9918,,,2022-01-28T00:00:00Z,,https://au-api.basiq.io/users/11103cba-4a08-4397-84a5-22ac125ed2f6/transactions/ac459c23-8c50-42ee-aed8-b5856cdf3b06,https://au-api.basiq.io/users/11103cba-4a08-4397-84a5-22ac125ed2f6/accounts/0b107c33-e858-4bbd-abba-f757ae4da1fc,https://au-api.basiq.io/institutions/AU00000,,,
transaction,af6b2ca4-0fec-426c-88b3-b7c56831e7cb,posted,Payroll WFRMS 15439393,15985.00,0b107c33-e858-4bbd-abba-f757ae4da1fc,16126.16,credit,transfer,AU00000,5453f0a3-083c-43c6-9086-adfe94df9918,,,2022-01-28T00:00:00Z,,https://au-api.basiq.io/users/11103cba-4a08-4397-84a5-22ac125ed2f6/transactions/af6b2ca4-0fec-426c-88b3-b7c56831e7cb,https://au-api.basiq.io/users/11103cba-4a08-4397-84a5-22ac125ed2f6/accounts/0b107c33-e858-4bbd-abba-f757ae4da1fc,https://au-api.basiq.io/institutions/AU00000,,,
transaction,e567adbb-730d-46bd-be54-4d1359518daf,posted,CTRLINK CARERS Ref: 998R6789201610974V,16.00,0b107c33-e858-4bbd-abba-f757ae4da1fc,141.16,credit,transfer,AU00000,5453f0a3-083c-43c6-9086-adfe94df9918,,,2022-01-22T00:00:00Z,,https://au-api.basiq.io/users/11103cba-4a08-4397-84a5-22ac125ed2f6/transactions/e567adbb-730d-46bd-be54-4d1359518daf,https://au-api.basiq.io/users/11103cba-4a08-4397-84a5-22ac125ed2f6/accounts/0b107c33-e858-4bbd-abba-f757ae4da1fc,https://au-api.basiq.io/institutions/AU00000,,,
transaction,60846936-3e00-4f36-ac04-62750ecc81de,posted,CTRLINK CARERS Ref: 998R6789201610974V,16.00,0b107c33-e858-4bbd-abba-f757ae4da1fc,125.16,credit,transfer,AU00000,5453f0a3-083c-43c6-9086-adfe94df9918,,,2022-01-22T00:00:00Z,,https://au-api.basiq.io/users/11103cba-4a08-4397-84a5-22ac125ed2f6/transactions/60846936-3e00-4f36-ac04-62750ecc81de,https://au-api.basiq.io/users/11103cba-4a08-4397-84a5-22ac125ed2f6/accounts/0b107c33-e858-4bbd-abba-f757ae4da1fc,https://au-api.basiq.io/institutions/AU00000,,,
transaction,88150acc-ad0d-4e71-8bb2-7a4743a47d01,posted,Wdl ATM CBA ATM  MANLY D        NSW 219704   AUS,-300.00,0b107c33-e858-4bbd-abba-f757ae4da1fc,109.16,debit,cash-withdrawal,AU00000,5453f0a3-083c-43c6-9086-adfe94df9918,,,2022-01-18T00:00:00Z,,https://au-api.basiq.io/users/11103cba-4a08-4397-84a5-22ac125ed2f6/transactions/88150acc-ad0d-4e71-8bb2-7a4743a47d01,https://au-api.basiq.io/users/11103cba-4a08-4397-84a5-22ac125ed2f6/accounts/0b107c33-e858-4bbd-abba-f757ae4da1fc,https://au-api.basiq.io/institutions/AU00000,,,
transaction,fbcfacbf-5787-4795-9781-b62dfee0dd60,posted,Manly Maths Tutor Wages,201.00,0b107c33-e858-4bbd-abba-f757ae4da1fc,409.16,credit,transfer,AU00000,5453f0a3-083c-43c6-9086-adfe94df9918,,,2022-01-18T00:00:00Z,,https://au-api.basiq.io/users/11103cba-4a08-4397-84a5-22ac125ed2f6/transactions/fbcfacbf-5787-4795-9781-b62dfee0dd60,https://au-api.basiq.io/users/11103cba-4a08-4397-84a5-22ac125ed2f6/accounts/0b107c33-e858-4bbd-abba-f757ae4da1fc,https://au-api.basiq.io/institutions/AU00000,,,
transaction,0502a551-780b-4a85-ac5f-a76c75c8ef44,posted,Wdl ATM WESTPAC IGA BALGOWLAH  BALGOWL        AU,-200.00,0b107c33-e858-4bbd-abba-f757ae4da1fc,208.16,debit,cash-withdrawal,AU00000,5453f0a3-083c-43c6-9086-adfe94df9918,,,2022-01-17T00:00:00Z,,https://au-api.basiq.io/users/11103cba-4a08-4397-84a5-22ac125ed2f6/transactions/0502a551-780b-4a85-ac5f-a76c75c8ef44,https://au-api.basiq.io/users/11103cba-4a08-4397-84a5-22ac125ed2f6/accounts/0b107c33-e858-4bbd-abba-f757ae4da1fc,https://au-api.basiq.io/institutions/AU00000,,,
transaction,d8bcd072-ec58-4d54-865d-283b57d0e5d6,posted,Non Hooli ATM Withdrawal Fee,-2.50,0b107c33-e858-4bbd-abba-f757ae4da1fc,408.16,debit,bank-fee,AU00000,5453f0a3-083c-43c6-9086-adfe94df9918,,,2022-01-17T00:00:00Z,,https://au-api.basiq.io/users/11103cba-4a08-4397-84a5-22ac125ed2f6/transactions/d8bcd072-ec58-4d54-865d-283b57d0e5d6,https://au-api.basiq.io/users/11103cba-4a08-4397-84a5-22ac125ed2f6/accounts/0b107c33-e858-4bbd-abba-f757ae4da1fc,https://au-api.basiq.io/institutions/AU00000,,,
transaction,87b8e14a-3f45-445b-9ab3-5d0b5dd547db,posted,Wdl ATM WESTPAC IGA BALGOWLAH  BALGOWL        AU,-100.00,0b107c33-e858-4bbd-abba-f757ae4da1fc,410.66,debit,cash-withdrawal,AU00000,5453f0a3-083c-43c6-9086-adfe94df9918,,,2022-01-17T00:00:00Z,,https://au-api.basiq.io/users/11103cba-4a08-4397-84a5-22ac125ed2f6/transactions/87b8e14a-3f45-445b-9ab3-5d0b5dd547db,https://au-api.basiq.io/users/11103cba-4a08-4397-84a5-22ac125ed2f6/accounts/0b107c33-e858-4bbd-abba-f757ae4da1fc,https://au-api.basiq.io/institutions/AU00000,,,
transaction,c7520391-851e-4c6b-ac31-2435ff77e391,posted,Non Hooli ATM Withdrawal Fee,-2.50,0b107c33-e858-4bbd-abba-f757ae4da1fc,510.66,debit,bank-fee,AU00000,5453f0a3-083c-43c6-9086-adfe94df9918,,,2022-01-17T00:00:00Z,,https://au-api.basiq.io/users/11103cba-4a08-4397-84a5-22ac125ed2f6/transactions/c7520391-851e-4c6b-ac31-2435ff77e391,https://au-api.basiq.io/users/11103cba-4a08-4397-84a5-22ac125ed2f6/accounts/0b107c33-e858-4bbd-abba-f757ae4da1fc,https://au-api.basiq.io/institutions/AU00000,,,
transaction,0806ba92-4244-4c9c-92d5-136794f7cee7,posted,Wdl ATM CBA ATM  MANLY E        NSW 219705   AUS,-100.00,0b107c33-e858-4bbd-abba-f757ae4da1fc,513.16,debit,cash-withdrawal,AU00000,5453f0a3-083c-43c6-9086-adfe94df9918,,,2022-01-16T00:00:00Z,,https://au-api.basiq.io/users/11103cba-4a08-4397-84a5-22ac125ed2f6/transactions/0806ba92-4244-4c9c-92d5-136794f7cee7,https://au-api.basiq.io/users/11103cba-4a08-4397-84a5-22ac125ed2f6/accounts/0b107c33-e858-4bbd-abba-f757ae4da1fc,https://au-api.basiq.io/institutions/AU00000,,,
transaction,db426dd1-65b4-43dc-bd49-cdac25587552,posted,Manly Maths Tutor Wages,201.00,0b107c33-e858-4bbd-abba-f757ae4da1fc,613.16,credit,transfer,AU00000,5453f0a3-083c-43c6-9086-adfe94df9918,,,2022-01-14T00:00:00Z,,https://au-api.basiq.io/users/11103cba-4a08-4397-84a5-22ac125ed2f6/transactions/db426dd1-65b4-43dc-bd49-cdac25587552,https://au-api.basiq.io/users/11103cba-4a08-4397-84a5-22ac125ed2f6/accounts/0b107c33-e858-4bbd-abba-f757ae4da1fc,https://au-api.basiq.io/institutions/AU00000,,,
transaction,e96e41e3-bb89-41eb-a377-8722e60e8e89,posted,TFR Acc14000 TO 12389,-500.00,0b107c33-e858-4bbd-abba-f757ae4da1fc,412.16,debit,transfer,AU00000,5453f0a3-083c-43c6-9086-adfe94df9918,,,2022-01-13T00:00:00Z,,https://au-api.basiq.io/users/11103cba-4a08-4397-84a5-22ac125ed2f6/transactions/e96e41e3-bb89-41eb-a377-8722e60e8e89,https://au-api.basiq.io/users/11103cba-4a08-4397-84a5-22ac125ed2f6/accounts/0b107c33-e858-4bbd-abba-f757ae4da1fc,https://au-api.basiq.io/institutions/AU00000,,,
transaction,569115c1-da9c-4ef8-b0e2-37b4beb0e971,posted,AGL RETAIL ENERGY LTD,-160.00,0b107c33-e858-4bbd-abba-f757ae4da1fc,912.16,debit,payment,AU00000,5453f0a3-083c-43c6-9086-adfe94df9918,,,2022-01-11T00:00:00Z,,https://au-api.basiq.io/users/11103cba-4a08-4397-84a5-22ac125ed2f6/transactions/569115c1-da9c-4ef8-b0e2-37b4beb0e971,https://au-api.basiq.io/users/11103cba-4a08-4397-84a5-22ac125ed2f6/accounts/0b107c33-e858-4bbd-abba-f757ae4da1fc,https://au-api.basiq.io/institutions/AU00000,,Electricity Distribution,263
transaction,d3f1291f-096d-4f21-9a87-840024a647c5,posted,AGL RETAIL ENERGY LTD (GAS),-92.00,0b107c33-e858-4bbd-abba-f757ae4da1fc,1072.16,debit,payment,AU00000,5453f0a3-083c-43c6-9086-adfe94df9918,,,2022-01-11T00:00:00Z,,https://au-api.basiq.io/users/11103cba-4a08-4397-84a5-22ac125ed2f6/transactions/d3f1291f-096d-4f21-9a87-840024a647c5,https://au-api.basiq.io/users/11103cba-4a08-4397-84a5-22ac125ed2f6/accounts/0b107c33-e858-4bbd-abba-f757ae4da1fc,https://au-api.basiq.io/institutions/AU00000,,Electricity Distribution,263
transaction,883cd598-d952-433f-ba69-33a0e59d88d2,posted,Wdl ATM WESTPAC IGA BALGOWLAH  BALGOWL        AU,-100.00,0b107c33-e858-4bbd-abba-f757ae4da1fc,1164.16,debit,cash-withdrawal,AU00000,5453f0a3-083c-43c6-9086-adfe94df9918,,,2022-01-03T00:00:00Z,,https://au-api.basiq.io/users/11103cba-4a08-4397-84a5-22ac125ed2f6/transactions/883cd598-d952-433f-ba69-33a0e59d88d2,https://au-api.basiq.io/users/11103cba-4a08-4397-84a5-22ac125ed2f6/accounts/0b107c33-e858-4bbd-abba-f757ae4da1fc,https://au-api.basiq.io/institutions/AU00000,,,
transaction,498efa67-86f7-4e07-a5d4-74470ed81f43,posted,Non Hooli ATM Withdrawal Fee,-2.50,0b107c33-e858-4bbd-abba-f757ae4da1fc,1264.16,debit,bank-fee,AU00000,5453f0a3-083c-43c6-9086-adfe94df9918,,,2022-01-03T00:00:00Z,,https://au-api.basiq.io/users/11103cba-4a08-4397-84a5-22ac125ed2f6/transactions/498efa67-86f7-4e07-a5d4-74470ed81f43,https://au-api.basiq.io/users/11103cba-4a08-4397-84a5-22ac125ed2f6/accounts/0b107c33-e858-4bbd-abba-f757ae4da1fc,https://au-api.basiq.io/institutions/AU00000,,,
transaction,0d469890-6c6a-4acc-a38e-f0cb8e26b06c,posted,Transfer Platnm Homeloan 346454,3972.50,2df58481-c77a-40b1-8249-949cb3ea9670,-355695.25,credit,loan-repayment,AU00000,5453f0a3-083c-43c6-9086-adfe94df9918,,,2022-03-30T00:00:00Z,,https://au-api.basiq.io/users/11103cba-4a08-4397-84a5-22ac125ed2f6/transactions/0d469890-6c6a-4acc-a38e-f0cb8e26b06c,https://au-api.basiq.io/users/11103cba-4a08-4397-84a5-22ac125ed2f6/accounts/2df58481-c77a-40b1-8249-949cb3ea9670,https://au-api.basiq.io/institutions/AU00000,,,
transaction,6e0f7b0d-8302-4284-b6df-3cb6d9b45e89,posted,Mortgage Interest Payment 746833,-3638.50,2df58481-c77a-40b1-8249-949cb3ea9670,-359667.75,debit,loan-interest,AU00000,5453f0a3-083c-43c6-9086-adfe94df9918,,,2022-03-19T00:00:00Z,,https://au-api.basiq.io/users/11103cba-4a08-4397-84a5-22ac125ed2f6/transactions/6e0f7b0d-8302-4284-b6df-3cb6d9b45e89,https://au-api.basiq.io/users/11103cba-4a08-4397-84a5-22ac125ed2f6/accounts/2df58481-c77a-40b1-8249-949cb3ea9670,https://au-api.basiq.io/institutions/AU00000,,,
transaction,499d23e8-7e1e-4d8b-b74f-e642ec62ed40,posted,Transfer Platnm Homeloan 346454,3980.00,2df58481-c77a-40b1-8249-949cb3ea9670,-356029.25,credit,loan-repayment,AU00000,5453f0a3-083c-43c6-9086-adfe94df9918,,,2022-02-28T00:00:00Z,,https://au-api.basiq.io/users/11103cba-4a08-4397-84a5-22ac125ed2f6/transactions/499d23e8-7e1e-4d8b-b74f-e642ec62ed40,https://au-api.basiq.io/users/11103cba-4a08-4397-84a5-22ac125ed2f6/accounts/2df58481-c77a-40b1-8249-949cb3ea9670,https://au-api.basiq.io/institutions/AU00000,,,
transaction,22b95c28-7d7f-4067-932d-70741f07561b,posted,Mortgage Interest Payment 746833,-3630.75,2df58481-c77a-40b1-8249-949cb3ea9670,-360009.25,debit,loan-interest,AU00000,5453f0a3-083c-43c6-9086-adfe94df9918,,,2022-02-17T00:00:00Z,,https://au-api.basiq.io/users/11103cba-4a08-4397-84a5-22ac125ed2f6/transactions/22b95c28-7d7f-4067-932d-70741f07561b,https://au-api.basiq.io/users/11103cba-4a08-4397-84a5-22ac125ed2f6/accounts/2df58481-c77a-40b1-8249-949cb3ea9670,https://au-api.basiq.io/institutions/AU00000,,,
transaction,14ce2c96-3864-4729-832f-e27b39bdb323,posted,Transfer Platnm Homeloan 346454,3987.50,2df58481-c77a-40b1-8249-949cb3ea9670,-356378.50,credit,loan-repayment,AU00000,5453f0a3-083c-43c6-9086-adfe94df9918,,,2022-01-29T00:00:00Z,,https://au-api.basiq.io/users/11103cba-4a08-4397-84a5-22ac125ed2f6/transactions/14ce2c96-3864-4729-832f-e27b39bdb323,https://au-api.basiq.io/users/11103cba-4a08-4397-84a5-22ac125ed2f6/accounts/2df58481-c77a-40b1-8249-949cb3ea9670,https://au-api.basiq.io/institutions/AU00000,,,
transaction,4f161578-a148-4629-b416-1e5c3a533b21,posted,Mortgage Interest Payment 746833,-3623.50,2df58481-c77a-40b1-8249-949cb3ea9670,-360366.00,debit,loan-interest,AU00000,5453f0a3-083c-43c6-9086-adfe94df9918,,,2022-01-18T00:00:00Z,,https://au-api.basiq.io/users/11103cba-4a08-4397-84a5-22ac125ed2f6/transactions/4f161578-a148-4629-b416-1e5c3a533b21,https://au-api.basiq.io/users/11103cba-4a08-4397-84a5-22ac125ed2f6/accounts/2df58481-c77a-40b1-8249-949cb3ea9670,https://au-api.basiq.io/institutions/AU00000,,,
transaction,6a21152f-b875-499b-b82e-03495a761794,posted,BROWN SUGAR CAFE ESPERAN,-76.00,49544383-c19c-4c97-b8d1-5322d0faa6af,703.15,debit,payment,AU00000,5453f0a3-083c-43c6-9086-adfe94df9918,,,2022-03-31T00:00:00Z,,https://au-api.basiq.io/users/11103cba-4a08-4397-84a5-22ac125ed2f6/transactions/6a21152f-b875-499b-b82e-03495a761794,https://au-api.basiq.io/users/11103cba-4a08-4397-84a5-22ac125ed2f6/accounts/49544383-c19c-4c97-b8d1-5322d0faa6af,https://au-api.basiq.io/institutions/AU00000,,"Cafes, Restaurants and Takeaway Food Services",451
transaction,71460183-fbad-48fc-bda8-153001e4aa40,posted,BROWN SUGAR CAFE ESPERAN,-17.25,49544383-c19c-4c97-b8d1-5322d0faa6af,779.15,debit,payment,AU00000,5453f0a3-083c-43c6-9086-adfe94df9918,,,2022-03-31T00:00:00Z,,https://au-api.basiq.io/users/11103cba-4a08-4397-84a5-22ac125ed2f6/transactions/71460183-fbad-48fc-bda8-153001e4aa40,https://au-api.basiq.io/users/11103cba-4a08-4397-84a5-22ac125ed2f6/accounts/49544383-c19c-4c97-b8d1-5322d0faa6af,https://au-api.basiq.io/institutions/AU00000,,"Cafes, Restaurants and Takeaway Food Services",451
transaction,4559d72a-9d5f-4e09-b6cc-e9033e687c67,posted,POST ESPERANCE POS ESPE,-15.75,49544383-c19c-4c97-b8d1-5322d0faa6af,796.40,debit,payment,AU00000,5453f0a3-083c-43c6-9086-adfe94df9918,,,2022-03-31T00:00:00Z,,https://au-api.basiq.io/users/11103cba-4a08-4397-84a5-22ac125ed2f6/transactions/4559d72a-9d5f-4e09-b6cc-e9033e687c67,https://au-api.basiq.io/users/11103cba-4a08-4397-84a5-22ac125ed2f6/accounts/49544383-c19c-4c97-b8d1-5322d0faa6af,https://au-api.basiq.io/institutions/AU00000,,Postal and Courier Pick-up and Delivery Services,510
transaction,581638d5-1928-40d9-be99-64f9dbd323bf,posted,CASTLETOWN SS 6329 ESPERANCE AU,-224.21,49544383-c19c-4c97-b8d1-5322d0faa6af,812.15,debit,payment,AU00000,5453f0a3-083c-43c6-9086-adfe94df9918,,,2022-03-31T00:00:00Z,,https://au-api.basiq.io/users/11103cba-4a08-4397-84a5-22ac125ed2f6/transactions/581638d5-1928-40d9-be99-64f9dbd323bf,https://au-api.basiq.io/users/11103cba-4a08-4397-84a5-22ac125ed2f6/accounts/49544383-c19c-4c97-b8d1-5322d0faa6af,https://au-api.basiq.io/institutions/AU00000,,Fuel Retailing,400
transaction,b17950b4-cc28-4312-83df-31b9bee2261e,posted,NATURALLY ESPERANCE ESPE,-61.46,49544383-c19c-4c97-b8d1-5322d0faa6af,1036.36,debit,payment,AU00000,5453f0a3-083c-43c6-9086-adfe94df9918,,,2022-03-30T00:00:00Z,,https://au-api.basiq.io/users/11103cba-4a08-4397-84a5-22ac125ed2f6/transactions/b17950b4-cc28-4312-83df-31b9bee2261e,https://au-api.basiq.io/users/11103cba-4a08-4397-84a5-22ac125ed2f6/accounts/49544383-c19c-4c97-b8d1-5322d0faa6af,https://au-api.basiq.io/institutions/AU00000,,Personal Care Services,951
transaction,6effdd45-d0a1-42f9-a999-6796aa636d8f,posted,Mail Redi/POST MELB,-27.90,49544383-c19c-4c97-b8d1-5322d0faa6af,1097.82,debit,payment,AU00000,5453f0a3-083c-43c6-9086-adfe94df9918,,,2022-03-30T00:00:00Z,,https://au-api.basiq.io/users/11103cba-4a08-4397-84a5-22ac125ed2f6/transactions/6effdd45-d0a1-42f9-a999-6796aa636d8f,https://au-api.basiq.io/users/11103cba-4a08-4397-84a5-22ac125ed2f6/accounts/49544383-c19c-4c97-b8d1-5322d0faa6af,https://au-api.basiq.io/institutions/AU00000,,Postal and Courier Pick-up and Delivery Services,510
transaction,95a3a346-211c-4ac1-adae-ec4b4d56c3e2,posted,WOOLWORTHS 4383 ESPERANCE WA AU,-534.36,49544383-c19c-4c97-b8d1-5322d0faa6af,1125.72,debit,payment,AU00000,5453f0a3-083c-43c6-9086-adfe94df9918,,,2022-03-30T00:00:00Z,,https://au-api.basiq.io/users/11103cba-4a08-4397-84a5-22ac125ed2f6/transactions/95a3a346-211c-4ac1-adae-ec4b4d56c3e2,https://au-api.basiq.io/users/11103cba-4a08-4397-84a5-22ac125ed2f6/accounts/49544383-c19c-4c97-b8d1-5322d0faa6af,https://au-api.basiq.io/institutions/AU00000,,Supermarket and Grocery Stores,411
transaction,8eaab4ab-c73b-4d1e-8da1-f01fa279c24a,posted,INNERTUBE ESPERANCE AU,-20.95,49544383-c19c-4c97-b8d1-5322d0faa6af,1660.08,debit,payment,AU00000,5453f0a3-083c-43c6-9086-adfe94df9918,,,2022-03-30T00:00:00Z,,https://au-api.basiq.io/users/11103cba-4a08-4397-84a5-22ac125ed2f6/transactions/8eaab4ab-c73b-4d1e-8da1-f01fa279c24a,https://au-api.basiq.io/users/11103cba-4a08-4397-84a5-22ac125ed2f6/accounts/49544383-c19c-4c97-b8d1-5322d0faa6af,https://au-api.basiq.io/institutions/AU00000,,"Clothing, Footwear and Personal Accessory Retailing",425
transaction,5801c368-985c-4fd7-9b00-2b4764e94abd,posted,PINK LAKE TOURIST PA ESPERANCE AU,-41.00,49544383-c19c-4c97-b8d1-5322d0faa6af,1681.03,debit,payment,AU00000,5453f0a3-083c-43c6-9086-adfe94df9918,,,2022-03-30T00:00:00Z,,https://au-api.basiq.io/users/11103cba-4a08-4397-84a5-22ac125ed2f6/transactions/5801c368-985c-4fd7-9b00-2b4764e94abd,https://au-api.basiq.io/users/11103cba-4a08-4397-84a5-22ac125ed2f6/accounts/49544383-c19c-4c97-b8d1-5322d0faa6af,https://au-api.basiq.io/institutions/AU00000,,Accommodation,440
transaction,1ffe0e38-97a1-4e5c-b19d-acd1a6160281,posted,WOOLWORTHS 4383 ESPE,-43.50,49544383-c19c-4c97-b8d1-5322d0faa6af,1722.03,debit,payment,AU00000,5453f0a3-083c-43c6-9086-adfe94df9918,,,2022-03-29T00:00:00Z,,https://au-api.basiq.io/users/11103cba-4a08-4397-84a5-22ac125ed2f6/transactions/1ffe0e38-97a1-4e5c-b19d-acd1a6160281,https://au-api.basiq.io/users/11103cba-4a08-4397-84a5-22ac125ed2f6/accounts/49544383-c19c-4c97-b8d1-5322d0faa6af,https://au-api.basiq.io/institutions/AU00000,,Supermarket and Grocery Stores,411
transaction,efb5b184-1cd8-4d9d-951b-0236436d118c,posted,BAY OF ISLES LEISURE C ESPE,-18.00,49544383-c19c-4c97-b8d1-5322d0faa6af,1765.53,debit,payment,AU00000,5453f0a3-083c-43c6-9086-adfe94df9918,,,2022-03-29T00:00:00Z,,https://au-api.basiq.io/users/11103cba-4a08-4397-84a5-22ac125ed2f6/transactions/efb5b184-1cd8-4d9d-951b-0236436d118c,https://au-api.basiq.io/users/11103cba-4a08-4397-84a5-22ac125ed2f6/accounts/49544383-c19c-4c97-b8d1-5322d0faa6af,https://au-api.basiq.io/institutions/AU00000,,Allied Health Services,853
transaction,1610dede-4ab8-4159-aa7a-dea603e76a1d,posted,ESPERANCE SUPA IGA ESPE,-14.99,49544383-c19c-4c97-b8d1-5322d0faa6af,1783.53,debit,payment,AU00000,5453f0a3-083c-43c6-9086-adfe94df9918,,,2022-03-29T00:00:00Z,,https://au-api.basiq.io/users/11103cba-4a08-4397-84a5-22ac125ed2f6/transactions/1610dede-4ab8-4159-aa7a-dea603e76a1d,https://au-api.basiq.io/users/11103cba-4a08-4397-84a5-22ac125ed2f6/accounts/49544383-c19c-4c97-b8d1-5322d0faa6af,https://au-api.basiq.io/institutions/AU00000,,Supermarket and Grocery Stores,411
transaction,7096dc77-6aa1-49f6-a4c3-ac2b95a26a5a,posted,TFR From Transaction to CC Acc 13,9286.00,49544383-c19c-4c97-b8d1-5322d0faa6af,1798.52,credit,transfer,AU00000,5453f0a3-083c-43c6-9086-adfe94df9918,,,2022-03-29T00:00:00Z,,https://au-api.basiq.io/users/11103cba-4a08-4397-84a5-22ac125ed2f6/transactions/7096dc77-6aa1-49f6-a4c3-ac2b95a26a5a,https://au-api.basiq.io/users/11103cba-4a08-4397-84a5-22ac125ed2f6/accounts/49544383-c19c-4c97-b8d1-5322d0faa6af,https://au-api.basiq.io/institutions/AU00000,,,
transaction,108e03e9-0afa-4b0e-ba0b-24e99916d23c,posted,BRADSHAWS PHARMACY ESPERANCE AU,-15.95,49544383-c19c-4c97-b8d1-5322d0faa6af,-7487.48,debit,payment,AU00000,5453f0a3-083c-43c6-9086-adfe94df9918,,,2022-03-29T00:00:00Z,,https://au-api.basiq.io/users/11103cba-4a08-4397-84a5-22ac125ed2f6/transactions/108e03e9-0afa-4b0e-ba0b-24e99916d23c,https://au-api.basiq.io/users/11103cba-4a08-4397-84a5-22ac125ed2f6/accounts/49544383-c19c-4c97-b8d1-5322d0faa6af,https://au-api.basiq.io/institutions/AU00000,,Pharmaceutical and Other Store-Based Retailing,427
transaction,eb7ae0d0-da08-48cc-98c9-680aa672f3d7,posted,BUNNINGS 721000 ESPERANCE AU,-30.48,49544383-c19c-4c97-b8d1-5322d0faa6af,-7471.53,debit,payment,AU00000,5453f0a3-083c-43c6-9086-adfe94df9918,,,2022-03-29T00:00:00Z,,https://au-api.basiq.io/users/11103cba-4a08-4397-84a5-22ac125ed2f6/transactions/eb7ae0d0-da08-48cc-98c9-680aa672f3d7,https://au-api.basiq.io/users/11103cba-4a08-4397-84a5-22ac125ed2f6/accounts/49544383-c19c-4c97-b8d1-5322d0faa6af,https://au-api.basiq.io/institutions/AU00000,,"Hardware, Building and Garden Supplies Retailing",423
transaction,05112a89-b02d-4ef6-8a99-5390479c3bc7,posted,HOPETOUN IGA HOPE,-37.56,49544383-c19c-4c97-b8d1-5322d0faa6af,-7441.05,debit,payment,AU00000,5453f0a3-083c-43c6-9086-adfe94df9918,,,2022-03-28T00:00:00Z,,https://au-api.basiq.io/users/11103cba-4a08-4397-84a5-22ac125ed2f6/transactions/05112a89-b02d-4ef6-8a99-5390479c3bc7,https://au-api.basiq.io/users/11103cba-4a08-4397-84a5-22ac125ed2f6/accounts/49544383-c19c-4c97-b8d1-5322d0faa6af,https://au-api.basiq.io/institutions/AU00000,,Supermarket and Grocery Stores,411
transaction,12d0202b-e9dd-495e-8317-340aef29eb48,posted,SHIPWRECK GOURMET DE HOPE,-30.10,49544383-c19c-4c97-b8d1-5322d0faa6af,-7403.49,debit,payment,AU00000,5453f0a3-083c-43c6-9086-adfe94df9918,,,2022-03-28T00:00:00Z,,https://au-api.basiq.io/users/11103cba-4a08-4397-84a5-22ac125ed2f6/transactions/12d0202b-e9dd-495e-8317-340aef29eb48,https://au-api.basiq.io/users/11103cba-4a08-4397-84a5-22ac125ed2f6/accounts/49544383-c19c-4c97-b8d1-5322d0faa6af,https://au-api.basiq.io/institutions/AU00000,,Bakery Product Manufacturing,117
transaction,6030cac7-2515-43c2-bf81-c6ae21e79e81,posted,SHIPWRECK GOURMET DE HOPE,-17.10,49544383-c19c-4c97-b8d1-5322d0faa6af,-7373.39,debit,payment,AU00000,5453f0a3-083c-43c6-9086-adfe94df9918,,,2022-03-28T00:00:00Z,,https://au-api.basiq.io/users/11103cba-4a08-4397-84a5-22ac125ed2f6/transactions/6030cac7-2515-43c2-bf81-c6ae21e79e81,https://au-api.basiq.io/users/11103cba-4a08-4397-84a5-22ac125ed2f6/accounts/49544383-c19c-4c97-b8d1-5322d0faa6af,https://au-api.basiq.io/institutions/AU00000,,Bakery Product Manufacturing,117
transaction,42ff2b4f-38f8-4d8e-9479-133cd3906240,posted,WOOLWORTHS 4383 ESPERANCE WA AU,-102.50,49544383-c19c-4c97-b8d1-5322d0faa6af,-7356.29,debit,payment,AU00000,5453f0a3-083c-43c6-9086-adfe94df9918,,,2022-03-28T00:00:00Z,,https://au-api.basiq.io/users/11103cba-4a08-4397-84a5-22ac125ed2f6/transactions/42ff2b4f-38f8-4d8e-9479-133cd3906240,https://au-api.basiq.io/users/11103cba-4a08-4397-84a5-22ac125ed2f6/accounts/49544383-c19c-4c97-b8d1-5322d0faa6af,https://au-api.basiq.io/institutions/AU00000,,Supermarket and Grocery Stores,411
transaction,74849040-fcb2-4329-915e-aa2759518e65,posted,ESPERANCE MOTOR GROU ESPERANCE AU,-1046.34,49544383-c19c-4c97-b8d1-5322d0faa6af,-7253.79,debit,payment,AU00000,5453f0a3-083c-43c6-9086-adfe94df9918,,,2022-03-28T00:00:00Z,,https://au-api.basiq.io/users/11103cba-4a08-4397-84a5-22ac125ed2f6/transactions/74849040-fcb2-4329-915e-aa2759518e65,https://au-api.basiq.io/users/11103cba-4a08-4397-84a5-22ac125ed2f6/accounts/49544383-c19c-4c97-b8d1-5322d0faa6af,https://au-api.basiq.io/institutions/AU00000,,Automotive Repair and Maintenance,941
transaction,d65968d6-fcdf-47a5-b361-a85bcbc9bbeb,posted,MAKARIOS PTY LTD CASTLETOWN AU,-58.20,49544383-c19c-4c97-b8d1-5322d0faa6af,-6207.45,debit,payment,AU00000,5453f0a3-083c-43c6-9086-adfe94df9918,,,2022-03-28T00:00:00Z,,https://au-api.basiq.io/users/11103cba-4a08-4397-84a5-22ac125ed2f6/transactions/d65968d6-fcdf-47a5-b361-a85bcbc9bbeb,https://au-api.basiq.io/users/11103cba-4a08-4397-84a5-22ac125ed2f6/accounts/49544383-c19c-4c97-b8d1-5322d0faa6af,https://au-api.basiq.io/institutions/AU00000,,"Cafes, Restaurants and Takeaway Food Services",451
transaction,057fd63b-4cba-44f3-b37e-b26f14464110,posted,GOURMANDISE & CO PL ALBANY,-71.00,49544383-c19c-4c97-b8d1-5322d0faa6af,-6149.25,debit,payment,AU00000,5453f0a3-083c-43c6-9086-adfe94df9918,,,2022-03-27T00:00:00Z,,https://au-api.basiq.io/users/11103cba-4a08-4397-84a5-22ac125ed2f6/transactions/057fd63b-4cba-44f3-b37e-b26f14464110,https://au-api.basiq.io/users/11103cba-4a08-4397-84a5-22ac125ed2f6/accounts/49544383-c19c-4c97-b8d1-5322d0faa6af,https://au-api.basiq.io/institutions/AU00000,,"Cafes, Restaurants and Takeaway Food Services",451
transaction,55bad033-c6f1-4f51-897a-f9698b6e088a,posted,GOURMANDISE & CO PL ALBANY,-18.70,49544383-c19c-4c97-b8d1-5322d0faa6af,-6078.25,debit,payment,AU00000,5453f0a3-083c-43c6-9086-adfe94df9918,,,2022-03-27T00:00:00Z,,https://au-api.basiq.io/users/11103cba-4a08-4397-84a5-22ac125ed2f6/transactions/55bad033-c6f1-4f51-897a-f9698b6e088a,https://au-api.basiq.io/users/11103cba-4a08-4397-84a5-22ac125ed2f6/accounts/49544383-c19c-4c97-b8d1-5322d0faa6af,https://au-api.basiq.io/institutions/AU00000,,"Cafes, Restaurants and Takeaway Food Services",451
transaction,680489a9-22eb-408d-8973-05fef5d2ad34,posted,PINK LAKE TOURIST PA ESPERANCE AU,-121.00,49544383-c19c-4c97-b8d1-5322d0faa6af,-6059.55,debit,payment,AU00000,5453f0a3-083c-43c6-9086-adfe94df9918,,,2022-03-27T00:00:00Z,,https://au-api.basiq.io/users/11103cba-4a08-4397-84a5-22ac125ed2f6/transactions/680489a9-22eb-408d-8973-05fef5d2ad34,https://au-api.basiq.io/users/11103cba-4a08-4397-84a5-22ac125ed2f6/accounts/49544383-c19c-4c97-b8d1-5322d0faa6af,https://au-api.basiq.io/institutions/AU00000,,Accommodation,440
transaction,2afb9205-3ada-4bf1-bdbb-99cdefa3f857,posted,DISCOVERY BAY TOURIS FRENCHM,-18.00,49544383-c19c-4c97-b8d1-5322d0faa6af,-5938.55,debit,payment,AU00000,5453f0a3-083c-43c6-9086-adfe94df9918,,,2022-03-24T00:00:00Z,,https://au-api.basiq.io/users/11103cba-4a08-4397-84a5-22ac125ed2f6/transactions/2afb9205-3ada-4bf1-bdbb-99cdefa3f857,https://au-api.basiq.io/users/11103cba-4a08-4397-84a5-22ac125ed2f6/accounts/49544383-c19c-4c97-b8d1-5322d0faa6af,https://au-api.basiq.io/institutions/AU00000,,Museum Operation,891
transaction,af8ab6d3-a56c-47cb-8ba0-2f4c5d8649f3,posted,GULL ALBANY HIGHWAY ALBANY AU,-321.80,49544383-c19c-4c97-b8d1-5322d0faa6af,-5920.55,debit,payment,AU00000,5453f0a3-083c-43c6-9086-adfe94df9918,,,2022-03-24T00:00:00Z,,https://au-api.basiq.io/users/11103cba-4a08-4397-84a5-22ac125ed2f6/transactions/af8ab6d3-a56c-47cb-8ba0-2f4c5d8649f3,https://au-api.basiq.io/users/11103cba-4a08-4397-84a5-22ac125ed2f6/accounts/49544383-c19c-4c97-b8d1-5322d0faa6af,https://au-api.basiq.io/institutions/AU00000,,Fuel Retailing,400
transaction,15b9e2fc-8c43-4c41-a753-5c92b7411e10,posted,COLES 0364 ALBANY AU,-131.76,49544383-c19c-4c97-b8d1-5322d0faa6af,-5598.75,debit,payment,AU00000,5453f0a3-083c-43c6-9086-adfe94df9918,,,2022-03-24T00:00:00Z,,https://au-api.basiq.io/users/11103cba-4a08-4397-84a5-22ac125ed2f6/transactions/15b9e2fc-8c43-4c41-a753-5c92b7411e10,https://au-api.basiq.io/users/11103cba-4a08-4397-84a5-22ac125ed2f6/accounts/49544383-c19c-4c97-b8d1-5322d0faa6af,https://au-api.basiq.io/institutions/AU00000,,Supermarket and Grocery Stores,411
transaction,bc1a8421-74c5-4a4e-acee-919eefdfc437,posted,DISCOVERY BAY TOURIS FRENCHM,-76.00,49544383-c19c-4c97-b8d1-5322d0faa6af,-5466.99,debit,payment,AU00000,5453f0a3-083c-43c6-9086-adfe94df9918,,,2022-03-23T00:00:00Z,,https://au-api.basiq.io/users/11103cba-4a08-4397-84a5-22ac125ed2f6/transactions/bc1a8421-74c5-4a4e-acee-919eefdfc437,https://au-api.basiq.io/users/11103cba-4a08-4397-84a5-22ac125ed2f6/accounts/49544383-c19c-4c97-b8d1-5322d0faa6af,https://au-api.basiq.io/institutions/AU00000,,Museum Operation,891
transaction,ced364bb-1c0f-4864-98f2-170379a73e68,posted,WHALERS GALLEY ALBA,-72.50,49544383-c19c-4c97-b8d1-5322d0faa6af,-5390.99,debit,payment,AU00000,5453f0a3-083c-43c6-9086-adfe94df9918,,,2022-03-23T00:00:00Z,,https://au-api.basiq.io/users/11103cba-4a08-4397-84a5-22ac125ed2f6/transactions/ced364bb-1c0f-4864-98f2-170379a73e68,https://au-api.basiq.io/users/11103cba-4a08-4397-84a5-22ac125ed2f6/accounts/49544383-c19c-4c97-b8d1-5322d0faa6af,https://au-api.basiq.io/institutions/AU00000,,"Cafes, Restaurants and Takeaway Food Services",451
transaction,b4a7f058-5d26-4140-9b36-5fc5d569d05b,posted,ALBANY IGA ALBA,-62.33,49544383-c19c-4c97-b8d1-5322d0faa6af,-5318.49,debit,payment,AU00000,5453f0a3-083c-43c6-9086-adfe94df9918,,,2022-03-23T00:00:00Z,,https://au-api.basiq.io/users/11103cba-4a08-4397-84a5-22ac125ed2f6/transactions/b4a7f058-5d26-4140-9b36-5fc5d569d05b,https://au-api.basiq.io/users/11103cba-4a08-4397-84a5-22ac125ed2f6/accounts/49544383-c19c-4c97-b8d1-5322d0faa6af,https://au-api.basiq.io/institutions/AU00000,,Supermarket and Grocery Stores,411
transaction,7453e8fc-9841-4b3b-a9b0-4cfaf8c10600,posted,COLES 0364 ALBA,-14.09,49544383-c19c-4c97-b8d1-5322d0faa6af,-5256.16,debit,payment,AU00000,5453f0a3-083c-43c6-9086-adfe94df9918,,,2022-03-23T00:00:00Z,,https://au-api.basiq.io/users/11103cba-4a08-4397-84a5-22ac125ed2f6/transactions/7453e8fc-9841-4b3b-a9b0-4cfaf8c10600,https://au-api.basiq.io/users/11103cba-4a08-4397-84a5-22ac125ed2f6/accounts/49544383-c19c-4c97-b8d1-5322d0faa6af,https://au-api.basiq.io/institutions/AU00000,,Supermarket and Grocery Stores,411
transaction,cd291b43-a547-43a5-8b28-d23878ab3f8a,posted,BCF AUSTRALIA ALBANY AU,-43.99,49544383-c19c-4c97-b8d1-5322d0faa6af,-5242.07,debit,payment,AU00000,5453f0a3-083c-43c6-9086-adfe94df9918,,,2022-03-23T00:00:00Z,,https://au-api.basiq.io/users/11103cba-4a08-4397-84a5-22ac125ed2f6/transactions/cd291b43-a547-43a5-8b28-d23878ab3f8a,https://au-api.basiq.io/users/11103cba-4a08-4397-84a5-22ac125ed2f6/accounts/49544383-c19c-4c97-b8d1-5322d0faa6af,https://au-api.basiq.io/institutions/AU00000,,Recreational Goods Retailing,424
transaction,ed3ca1e3-b37c-493a-9f1f-6a87d944a813,posted,Ironwood Estate Wines PORO,-26.00,49544383-c19c-4c97-b8d1-5322d0faa6af,-5198.08,debit,payment,AU00000,5453f0a3-083c-43c6-9086-adfe94df9918,,,2022-03-22T00:00:00Z,,https://au-api.basiq.io/users/11103cba-4a08-4397-84a5-22ac125ed2f6/transactions/ed3ca1e3-b37c-493a-9f1f-6a87d944a813,https://au-api.basiq.io/users/11103cba-4a08-4397-84a5-22ac125ed2f6/accounts/49544383-c19c-4c97-b8d1-5322d0faa6af,https://au-api.basiq.io/institutions/AU00000,,Specialised Food Retailing,412
transaction,f3ca7da4-a188-42f3-901f-cbbce6cc12e4,posted,ALBANY GARDENS HOLID AY ALBANY AU,-34.75,49544383-c19c-4c97-b8d1-5322d0faa6af,-5172.08,debit,payment,AU00000,5453f0a3-083c-43c6-9086-adfe94df9918,,,2022-03-22T00:00:00Z,,https://au-api.basiq.io/users/11103cba-4a08-4397-84a5-22ac125ed2f6/transactions/f3ca7da4-a188-42f3-901f-cbbce6cc12e4,https://au-api.basiq.io/users/11103cba-4a08-4397-84a5-22ac125ed2f6/accounts/49544383-c19c-4c97-b8d1-5322d0faa6af,https://au-api.basiq.io/institutions/AU00000,,Accommodation,440
transaction,89f52cfc-250c-49ee-842c-aed12082c0e9,posted,ALBANY IGA ALBA,-55.52,49544383-c19c-4c97-b8d1-5322d0faa6af,-5137.33,debit,payment,AU00000,5453f0a3-083c-43c6-9086-adfe94df9918,,,2022-03-21T00:00:00Z,,https://au-api.basiq.io/users/11103cba-4a08-4397-84a5-22ac125ed2f6/transactions/89f52cfc-250c-49ee-842c-aed12082c0e9,https://au-api.basiq.io/users/11103cba-4a08-4397-84a5-22ac125ed2f6/accounts/49544383-c19c-4c97-b8d1-5322d0faa6af,https://au-api.basiq.io/institutions/AU00000,,Supermarket and Grocery Stores,411
transaction,d29af917-2430-4639-a9a5-a8b786805d0b,posted,COLES 0364 ALBA,-29.79,49544383-c19c-4c97-b8d1-5322d0faa6af,-5081.81,debit,payment,AU00000,5453f0a3-083c-43c6-9086-adfe94df9918,,,2022-03-21T00:00:00Z,,https://au-api.basiq.io/users/11103cba-4a08-4397-84a5-22ac125ed2f6/transactions/d29af917-2430-4639-a9a5-a8b786805d0b,https://au-api.basiq.io/users/11103cba-4a08-4397-84a5-22ac125ed2f6/accounts/49544383-c19c-4c97-b8d1-5322d0faa6af,https://au-api.basiq.io/institutions/AU00000,,Supermarket and Grocery Stores,411
transaction,2c2e4a16-ddc5-4961-871a-77b2e67b6801,posted,DENMARK CHOCOLATE CO DENM,-18.00,49544383-c19c-4c97-b8d1-5322d0faa6af,-5052.02,debit,payment,AU00000,5453f0a3-083c-43c6-9086-adfe94df9918,,,2022-03-21T00:00:00Z,,https://au-api.basiq.io/users/11103cba-4a08-4397-84a5-22ac125ed2f6/transactions/2c2e4a16-ddc5-4961-871a-77b2e67b6801,https://au-api.basiq.io/users/11103cba-4a08-4397-84a5-22ac125ed2f6/accounts/49544383-c19c-4c97-b8d1-5322d0faa6af,https://au-api.basiq.io/institutions/AU00000,,"Cafes, Restaurants and Takeaway Food Services",451
transaction,5210c323-ac59-4b53-b65c-70a03f2c629a,posted,DENMARK FRESH FOODS PL DENM,-17.30,49544383-c19c-4c97-b8d1-5322d0faa6af,-5034.02,debit,payment,AU00000,5453f0a3-083c-43c6-9086-adfe94df9918,,,2022-03-21T00:00:00Z,,https://au-api.basiq.io/users/11103cba-4a08-4397-84a5-22ac125ed2f6/transactions/5210c323-ac59-4b53-b65c-70a03f2c629a,https://au-api.basiq.io/users/11103cba-4a08-4397-84a5-22ac125ed2f6/accounts/49544383-c19c-4c97-b8d1-5322d0faa6af,https://au-api.basiq.io/institutions/AU00000,,Specialised Food Retailing,412
transaction,349856ec-ca6f-4ffa-906e-9cf8d7253792,posted,WALPOLE VISITOR CENTRE WALP,-79.40,49544383-c19c-4c97-b8d1-5322d0faa6af,-5016.72,debit,payment,AU00000,5453f0a3-083c-43c6-9086-adfe94df9918,,,2022-03-20T00:00:00Z,,https://au-api.basiq.io/users/11103cba-4a08-4397-84a5-22ac125ed2f6/transactions/349856ec-ca6f-4ffa-906e-9cf8d7253792,https://au-api.basiq.io/users/11103cba-4a08-4397-84a5-22ac125ed2f6/accounts/49544383-c19c-4c97-b8d1-5322d0faa6af,https://au-api.basiq.io/institutions/AU00000,,Amusement and Other Recreation Activities,913
transaction,8813d0b7-4887-42b5-9810-5495e472f6fe,posted,AYR SAILEAN CAMPING CH BOW,-61.00,49544383-c19c-4c97-b8d1-5322d0faa6af,-4937.32,debit,payment,AU00000,5453f0a3-083c-43c6-9086-adfe94df9918,,,2022-03-20T00:00:00Z,,https://au-api.basiq.io/users/11103cba-4a08-4397-84a5-22ac125ed2f6/transactions/8813d0b7-4887-42b5-9810-5495e472f6fe,https://au-api.basiq.io/users/11103cba-4a08-4397-84a5-22ac125ed2f6/accounts/49544383-c19c-4c97-b8d1-5322d0faa6af,https://au-api.basiq.io/institutions/AU00000,,Accommodation,440
transaction,86e015af-5ed7-4729-b3b1-86039773a8b7,posted,NORTHCLIFFE NEWSAGENT NORT,-12.30,49544383-c19c-4c97-b8d1-5322d0faa6af,-4876.32,debit,payment,AU00000,5453f0a3-083c-43c6-9086-adfe94df9918,,,2022-03-20T00:00:00Z,,https://au-api.basiq.io/users/11103cba-4a08-4397-84a5-22ac125ed2f6/transactions/86e015af-5ed7-4729-b3b1-86039773a8b7,https://au-api.basiq.io/users/11103cba-4a08-4397-84a5-22ac125ed2f6/accounts/49544383-c19c-4c97-b8d1-5322d0faa6af,https://au-api.basiq.io/institutions/AU00000,,Recreational Goods Retailing,424
transaction,9b1be3d3-5760-49ad-828c-807c0f6f3811,posted,SYDNEY WATER,-170.68,49544383-c19c-4c97-b8d1-5322d0faa6af,-4864.02,debit,payment,AU00000,5453f0a3-083c-43c6-9086-adfe94df9918,,,2022-03-20T00:00:00Z,,https://au-api.basiq.io/users/11103cba-4a08-4397-84a5-22ac125ed2f6/transactions/9b1be3d3-5760-49ad-828c-807c0f6f3811,https://au-api.basiq.io/users/11103cba-4a08-4397-84a5-22ac125ed2f6/accounts/49544383-c19c-4c97-b8d1-5322d0faa6af,https://au-api.basiq.io/institutions/AU00000,,"Water Supply, Sewerage and Drainage Services",281
transaction,4800173d-7df0-4f3d-a1e9-dba093e19aef,posted,NORTHERN BEACHES COUNCIL - SOUTH RATES,-369.00,49544383-c19c-4c97-b8d1-5322d0faa6af,-4693.34,debit,payment,AU00000,5453f0a3-083c-43c6-9086-adfe94df9918,,,2022-03-20T00:00:00Z,,https://au-api.basiq.io/users/11103cba-4a08-4397-84a5-22ac125ed2f6/transactions/4800173d-7df0-4f3d-a1e9-dba093e19aef,https://au-api.basiq.io/users/11103cba-4a08-4397-84a5-22ac125ed2f6/accounts/49544383-c19c-4c97-b8d1-5322d0faa6af,https://au-api.basiq.io/institutions/AU00000,,Local Government Administration,753
transaction,9d87c87f-aa7a-44e0-8cee-073d29eeb195,posted,CITY OF ALBANY - NAT MT CLARENCE AU,-64.00,49544383-c19c-4c97-b8d1-5322d0faa6af,-4324.34,debit,payment,AU00000,5453f0a3-083c-43c6-9086-adfe94df9918,,,2022-03-20T00:00:00Z,,https://au-api.basiq.io/users/11103cba-4a08-4397-84a5-22ac125ed2f6/transactions/9d87c87f-aa7a-44e0-8cee-073d29eeb195,https://au-api.basiq.io/users/11103cba-4a08-4397-84a5-22ac125ed2f6/accounts/49544383-c19c-4c97-b8d1-5322d0faa6af,https://au-api.basiq.io/institutions/AU00000,,Regulatory Services,772
transaction,0c6911e5-0106-48b8-a293-b4b7454f73ff,posted,Eatcha Heart Out Cat Albany06 AU,-99.45,49544383-c19c-4c97-b8d1-5322d0faa6af,-4260.34,debit,payment,AU00000,5453f0a3-083c-43c6-9086-adfe94df9918,,,2022-03-19T00:00:00Z,,https://au-api.basiq.io/users/11103cba-4a08-4397-84a5-22ac125ed2f6/transactions/0c6911e5-0106-48b8-a293-b4b7454f73ff,https://au-api.basiq.io/users/11103cba-4a08-4397-84a5-22ac125ed2f6/accounts/49544383-c19c-4c97-b8d1-5322d0faa6af,https://au-api.basiq.io/institutions/AU00000,,"Cafes, Restaurants and Takeaway Food Services",451
transaction,dc66f828-19c8-43ed-9093-a73e6c7be433,posted,ALBANY GARDENS HOLID AY ALBANY AU,-136.00,49544383-c19c-4c97-b8d1-5322d0faa6af,-4160.89,debit,payment,AU00000,5453f0a3-083c-43c6-9086-adfe94df9918,,,2022-03-19T00:00:00Z,,https://au-api.basiq.io/users/11103cba-4a08-4397-84a5-22ac125ed2f6/transactions/dc66f828-19c8-43ed-9093-a73e6c7be433,https://au-api.basiq.io/users/11103cba-4a08-4397-84a5-22ac125ed2f6/accounts/49544383-c19c-4c97-b8d1-5322d0faa6af,https://au-api.basiq.io/institutions/AU00000,,Accommodation,440
transaction,7420e9ed-b2c7-4ad1-bb8b-c04d0e03978a,posted,JASSI LEATHER WORKS WILLIAM BAY AU,-71.00,49544383-c19c-4c97-b8d1-5322d0faa6af,-4024.89,debit,payment,AU00000,5453f0a3-083c-43c6-9086-adfe94df9918,,,2022-03-19T00:00:00Z,,https://au-api.basiq.io/users/11103cba-4a08-4397-84a5-22ac125ed2f6/transactions/7420e9ed-b2c7-4ad1-bb8b-c04d0e03978a,https://au-api.basiq.io/users/11103cba-4a08-4397-84a5-22ac125ed2f6/accounts/49544383-c19c-4c97-b8d1-5322d0faa6af,https://au-api.basiq.io/institutions/AU00000,,"Furniture, Floor Coverings, Houseware and Textile Goods Retailing",421
transaction,1c1190b7-2880-4e39-8fbe-de5d950c3b35,posted,PIONEER STORE WALPOLE AU,-116.54,49544383-c19c-4c97-b8d1-5322d0faa6af,-3953.89,debit,payment,AU00000,5453f0a3-083c-43c6-9086-adfe94df9918,,,2022-03-17T00:00:00Z,,https://au-api.basiq.io/users/11103cba-4a08-4397-84a5-22ac125ed2f6/transactions/1c1190b7-2880-4e39-8fbe-de5d950c3b35,https://au-api.basiq.io/users/11103cba-4a08-4397-84a5-22ac125ed2f6/accounts/49544383-c19c-4c97-b8d1-5322d0faa6af,https://au-api.basiq.io/institutions/AU00000,,Supermarket and Grocery Stores,411
transaction,9bb34e6a-bffe-4941-a7b2-947524856224,posted,NORTHCLIFFE NEWSAGEN T NORTHCLIFFE AU,-77.84,49544383-c19c-4c97-b8d1-5322d0faa6af,-3837.35,debit,payment,AU00000,5453f0a3-083c-43c6-9086-adfe94df9918,,,2022-03-17T00:00:00Z,,https://au-api.basiq.io/users/11103cba-4a08-4397-84a5-22ac125ed2f6/transactions/9bb34e6a-bffe-4941-a7b2-947524856224,https://au-api.basiq.io/users/11103cba-4a08-4397-84a5-22ac125ed2f6/accounts/49544383-c19c-4c97-b8d1-5322d0faa6af,https://au-api.basiq.io/institutions/AU00000,,Recreational Goods Retailing,424
transaction,1f2f86cd-32ae-4b9c-8561-20d20a87424a,posted,THE FARM HOUSE MARGARE,-26.68,49544383-c19c-4c97-b8d1-5322d0faa6af,-3759.51,debit,payment,AU00000,5453f0a3-083c-43c6-9086-adfe94df9918,,,2022-03-15T00:00:00Z,,https://au-api.basiq.io/users/11103cba-4a08-4397-84a5-22ac125ed2f6/transactions/1f2f86cd-32ae-4b9c-8561-20d20a87424a,https://au-api.basiq.io/users/11103cba-4a08-4397-84a5-22ac125ed2f6/accounts/49544383-c19c-4c97-b8d1-5322d0faa6af,https://au-api.basiq.io/institutions/AU00000,,"Cafes, Restaurants and Takeaway Food Services",451
transaction,e036485e-0a9e-4044-baec-9069e4264831,posted,DEPT OF PARKS/WILDLIFE KENS,-25.40,49544383-c19c-4c97-b8d1-5322d0faa6af,-3732.83,debit,payment,AU00000,5453f0a3-083c-43c6-9086-adfe94df9918,,,2022-03-15T00:00:00Z,,https://au-api.basiq.io/users/11103cba-4a08-4397-84a5-22ac125ed2f6/transactions/e036485e-0a9e-4044-baec-9069e4264831,https://au-api.basiq.io/users/11103cba-4a08-4397-84a5-22ac125ed2f6/accounts/49544383-c19c-4c97-b8d1-5322d0faa6af,https://au-api.basiq.io/institutions/AU00000,,Regulatory Services,772
transaction,d9525628-1b58-4da4-8e19-fc56b7d7176d,posted,RIVER FRESH IGA MARG,-24.95,49544383-c19c-4c97-b8d1-5322d0faa6af,-3707.43,debit,payment,AU00000,5453f0a3-083c-43c6-9086-adfe94df9918,,,2022-03-15T00:00:00Z,,https://au-api.basiq.io/users/11103cba-4a08-4397-84a5-22ac125ed2f6/transactions/d9525628-1b58-4da4-8e19-fc56b7d7176d,https://au-api.basiq.io/users/11103cba-4a08-4397-84a5-22ac125ed2f6/accounts/49544383-c19c-4c97-b8d1-5322d0faa6af,https://au-api.basiq.io/institutions/AU00000,,Supermarket and Grocery Stores,411
transaction,c8fcb01e-de11-4a07-9cfd-c92716efb3e9,posted,CALTEX AUGUSTA AUGUSTA AU,-14.50,49544383-c19c-4c97-b8d1-5322d0faa6af,-3682.48,debit,payment,AU00000,5453f0a3-083c-43c6-9086-adfe94df9918,,,2022-03-15T00:00:00Z,,https://au-api.basiq.io/users/11103cba-4a08-4397-84a5-22ac125ed2f6/transactions/c8fcb01e-de11-4a07-9cfd-c92716efb3e9,https://au-api.basiq.io/users/11103cba-4a08-4397-84a5-22ac125ed2f6/accounts/49544383-c19c-4c97-b8d1-5322d0faa6af,https://au-api.basiq.io/institutions/AU00000,,Fuel Retailing,400
transaction,f6b9ae04-44a4-4573-8234-3d4ff49f34e9,posted,MARGARET RIVER BREWHOUSE MARG,-97.00,49544383-c19c-4c97-b8d1-5322d0faa6af,-3667.98,debit,payment,AU00000,5453f0a3-083c-43c6-9086-adfe94df9918,,,2022-03-14T00:00:00Z,,https://au-api.basiq.io/users/11103cba-4a08-4397-84a5-22ac125ed2f6/transactions/f6b9ae04-44a4-4573-8234-3d4ff49f34e9,https://au-api.basiq.io/users/11103cba-4a08-4397-84a5-22ac125ed2f6/accounts/49544383-c19c-4c97-b8d1-5322d0faa6af,https://au-api.basiq.io/institutions/AU00000,,Specialised Food Retailing,412
transaction,c49cccff-dc0d-4e49-95a6-458391d0c13a,posted,THE GREEN ROOM MARG,-37.80,49544383-c19c-4c97-b8d1-5322d0faa6af,-3570.98,debit,payment,AU00000,5453f0a3-083c-43c6-9086-adfe94df9918,,,2022-03-14T00:00:00Z,,https://au-api.basiq.io/users/11103cba-4a08-4397-84a5-22ac125ed2f6/transactions/c49cccff-dc0d-4e49-95a6-458391d0c13a,https://au-api.basiq.io/users/11103cba-4a08-4397-84a5-22ac125ed2f6/accounts/49544383-c19c-4c97-b8d1-5322d0faa6af,https://au-api.basiq.io/institutions/AU00000,,"Cafes, Restaurants and Takeaway Food Services",451
transaction,6b053ac0-750c-4b7b-b244-799460112201,posted,NATURAL OLIVE OIL SO MARG,-34.35,49544383-c19c-4c97-b8d1-5322d0faa6af,-3533.18,debit,payment,AU00000,5453f0a3-083c-43c6-9086-adfe94df9918,,,2022-03-14T00:00:00Z,,https://au-api.basiq.io/users/11103cba-4a08-4397-84a5-22ac125ed2f6/transactions/6b053ac0-750c-4b7b-b244-799460112201,https://au-api.basiq.io/users/11103cba-4a08-4397-84a5-22ac125ed2f6/accounts/49544383-c19c-4c97-b8d1-5322d0faa6af,https://au-api.basiq.io/institutions/AU00000,,Pharmaceutical and Other Store-Based Retailing,427
transaction,d41478ec-8fee-4632-89ce-727311841b5e,posted,MARGARET RIVER BOOKS MARG,-30.98,49544383-c19c-4c97-b8d1-5322d0faa6af,-3498.83,debit,payment,AU00000,5453f0a3-083c-43c6-9086-adfe94df9918,,,2022-03-14T00:00:00Z,,https://au-api.basiq.io/users/11103cba-4a08-4397-84a5-22ac125ed2f6/transactions/d41478ec-8fee-4632-89ce-727311841b5e,https://au-api.basiq.io/users/11103cba-4a08-4397-84a5-22ac125ed2f6/accounts/49544383-c19c-4c97-b8d1-5322d0faa6af,https://au-api.basiq.io/institutions/AU00000,,"Newspaper, Periodical, Book and Directory Publishing",541
transaction,06643822-e5d9-49fc-82dd-f3e735603920,posted,MARGARET RIVER BOOKS MARG,-30.95,49544383-c19c-4c97-b8d1-5322d0faa6af,-3467.85,debit,payment,AU00000,5453f0a3-083c-43c6-9086-adfe94df9918,,,2022-03-14T00:00:00Z,,https://au-api.basiq.io/users/11103cba-4a08-4397-84a5-22ac125ed2f6/transactions/06643822-e5d9-49fc-82dd-f3e735603920,https://au-api.basiq.io/users/11103cba-4a08-4397-84a5-22ac125ed2f6/accounts/49544383-c19c-4c97-b8d1-5322d0faa6af,https://au-api.basiq.io/institutions/AU00000,,"Newspaper, Periodical, Book and Directory Publishing",541
transaction,ebc0de48-b98e-4583-8bbc-3d3d85eb0994,posted,BRIGHT EYES MARG,-20.99,49544383-c19c-4c97-b8d1-5322d0faa6af,-3436.90,debit,payment,AU00000,5453f0a3-083c-43c6-9086-adfe94df9918,,,2022-03-14T00:00:00Z,,https://au-api.basiq.io/users/11103cba-4a08-4397-84a5-22ac125ed2f6/transactions/ebc0de48-b98e-4583-8bbc-3d3d85eb0994,https://au-api.basiq.io/users/11103cba-4a08-4397-84a5-22ac125ed2f6/accounts/49544383-c19c-4c97-b8d1-5322d0faa6af,https://au-api.basiq.io/institutions/AU00000,,Allied Health Services,853
transaction,a3ea5fdd-3df4-4ed8-9255-57e537ec0c6c,posted,BLUE GINGER MARG,-17.60,49544383-c19c-4c97-b8d1-5322d0faa6af,-3415.91,debit,payment,AU00000,5453f0a3-083c-43c6-9086-adfe94df9918,,,2022-03-14T00:00:00Z,,https://au-api.basiq.io/users/11103cba-4a08-4397-84a5-22ac125ed2f6/transactions/a3ea5fdd-3df4-4ed8-9255-57e537ec0c6c,https://au-api.basiq.io/users/11103cba-4a08-4397-84a5-22ac125ed2f6/accounts/49544383-c19c-4c97-b8d1-5322d0faa6af,https://au-api.basiq.io/institutions/AU00000,,Specialised Food Retailing,412
transaction,2009ce64-3e7d-48c8-9af3-76822b0f6414,posted,SHIRE OF AUGUSTA MAR AUGUSTA AU,-55.00,49544383-c19c-4c97-b8d1-5322d0faa6af,-3398.31,debit,payment,AU00000,5453f0a3-083c-43c6-9086-adfe94df9918,,,2022-03-14T00:00:00Z,,https://au-api.basiq.io/users/11103cba-4a08-4397-84a5-22ac125ed2f6/transactions/2009ce64-3e7d-48c8-9af3-76822b0f6414,https://au-api.basiq.io/users/11103cba-4a08-4397-84a5-22ac125ed2f6/accounts/49544383-c19c-4c97-b8d1-5322d0faa6af,https://au-api.basiq.io/institutions/AU00000,,Regulatory Services,772
transaction,c046009a-98e6-4dd0-afab-2604d8a82b82,posted,HILLTOP ASSET PTY LT AUGUSTA AU,-52.87,49544383-c19c-4c97-b8d1-5322d0faa6af,-3343.31,debit,payment,AU00000,5453f0a3-083c-43c6-9086-adfe94df9918,,,2022-03-14T00:00:00Z,,https://au-api.basiq.io/users/11103cba-4a08-4397-84a5-22ac125ed2f6/transactions/c046009a-98e6-4dd0-afab-2604d8a82b82,https://au-api.basiq.io/users/11103cba-4a08-4397-84a5-22ac125ed2f6/accounts/49544383-c19c-4c97-b8d1-5322d0faa6af,https://au-api.basiq.io/institutions/AU00000,,Supermarket and Grocery Stores,411
transaction,5b6d1def-7da7-42aa-991e-617f7b2aa1f5,posted,LAKE CAVE FOREST GROVE AU,-59.00,49544383-c19c-4c97-b8d1-5322d0faa6af,-3290.44,debit,payment,AU00000,5453f0a3-083c-43c6-9086-adfe94df9918,,,2022-03-14T00:00:00Z,,https://au-api.basiq.io/users/11103cba-4a08-4397-84a5-22ac125ed2f6/transactions/5b6d1def-7da7-42aa-991e-617f7b2aa1f5,https://au-api.basiq.io/users/11103cba-4a08-4397-84a5-22ac125ed2f6/accounts/49544383-c19c-4c97-b8d1-5322d0faa6af,https://au-api.basiq.io/institutions/AU00000,,Amusement and Other Recreation Activities,913
transaction,110f5219-d582-4269-8d4b-a27c5c9494ac,posted,MARGARET RIVER BAKERY MARG,-47.00,49544383-c19c-4c97-b8d1-5322d0faa6af,-3231.44,debit,payment,AU00000,5453f0a3-083c-43c6-9086-adfe94df9918,,,2022-03-13T00:00:00Z,,https://au-api.basiq.io/users/11103cba-4a08-4397-84a5-22ac125ed2f6/transactions/110f5219-d582-4269-8d4b-a27c5c9494ac,https://au-api.basiq.io/users/11103cba-4a08-4397-84a5-22ac125ed2f6/accounts/49544383-c19c-4c97-b8d1-5322d0faa6af,https://au-api.basiq.io/institutions/AU00000,,Bakery Product Manufacturing,117
transaction,0c6e07d8-8064-4f5e-941f-566f7a45d3c9,posted,GABRIEL CHOCOLATE YALL,-29.00,49544383-c19c-4c97-b8d1-5322d0faa6af,-3184.44,debit,payment,AU00000,5453f0a3-083c-43c6-9086-adfe94df9918,,,2022-03-13T00:00:00Z,,https://au-api.basiq.io/users/11103cba-4a08-4397-84a5-22ac125ed2f6/transactions/0c6e07d8-8064-4f5e-941f-566f7a45d3c9,https://au-api.basiq.io/users/11103cba-4a08-4397-84a5-22ac125ed2f6/accounts/49544383-c19c-4c97-b8d1-5322d0faa6af,https://au-api.basiq.io/institutions/AU00000,,Specialised Food Retailing,412
transaction,1a6b9c1e-eeae-4699-9d27-27dc0a1868e5,posted,GABRIEL CHOCOLATE YALL,-23.00,49544383-c19c-4c97-b8d1-5322d0faa6af,-3155.44,debit,payment,AU00000,5453f0a3-083c-43c6-9086-adfe94df9918,,,2022-03-13T00:00:00Z,,https://au-api.basiq.io/users/11103cba-4a08-4397-84a5-22ac125ed2f6/transactions/1a6b9c1e-eeae-4699-9d27-27dc0a1868e5,https://au-api.basiq.io/users/11103cba-4a08-4397-84a5-22ac125ed2f6/accounts/49544383-c19c-4c97-b8d1-5322d0faa6af,https://au-api.basiq.io/institutions/AU00000,,Specialised Food Retailing,412
transaction,a60b6419-1d0c-4862-b4b0-4655c9f2d3fc,posted,AMAZON AUST SERVICES MELB,-20.99,49544383-c19c-4c97-b8d1-5322d0faa6af,-3132.44,debit,payment,AU00000,5453f0a3-083c-43c6-9086-adfe94df9918,,,2022-03-13T00:00:00Z,,https://au-api.basiq.io/users/11103cba-4a08-4397-84a5-22ac125ed2f6/transactions/a60b6419-1d0c-4862-b4b0-4655c9f2d3fc,https://au-api.basiq.io/users/11103cba-4a08-4397-84a5-22ac125ed2f6/accounts/49544383-c19c-4c97-b8d1-5322d0faa6af,https://au-api.basiq.io/institutions/AU00000,,Non-Store Retailing,431
transaction,272da3dc-f1b4-460b-96da-880498ee5b5f,posted,AMAZON AUST SERVICES MELB,-8.99,49544383-c19c-4c97-b8d1-5322d0faa6af,-3111.45,debit,payment,AU00000,5453f0a3-083c-43c6-9086-adfe94df9918,,,2022-03-13T00:00:00Z,,https://au-api.basiq.io/users/11103cba-4a08-4397-84a5-22ac125ed2f6/transactions/272da3dc-f1b4-460b-96da-880498ee5b5f,https://au-api.basiq.io/users/11103cba-4a08-4397-84a5-22ac125ed2f6/accounts/49544383-c19c-4c97-b8d1-5322d0faa6af,https://au-api.basiq.io/institutions/AU00000,,Non-Store Retailing,431
transaction,4bf184b1-1d4c-4e6c-af43-edb93c954679,posted,AMAZON AUST SERVICES MELB,-8.99,49544383-c19c-4c97-b8d1-5322d0faa6af,-3102.46,debit,payment,AU00000,5453f0a3-083c-43c6-9086-adfe94df9918,,,2022-03-13T00:00:00Z,,https://au-api.basiq.io/users/11103cba-4a08-4397-84a5-22ac125ed2f6/transactions/4bf184b1-1d4c-4e6c-af43-edb93c954679,https://au-api.basiq.io/users/11103cba-4a08-4397-84a5-22ac125ed2f6/accounts/49544383-c19c-4c97-b8d1-5322d0faa6af,https://au-api.basiq.io/institutions/AU00000,,Non-Store Retailing,431
transaction,279a8138-9bd3-4c8d-9b2e-0d93b4aabd5f,posted,AMAZON AUST SERVICES MELB,-8.99,49544383-c19c-4c97-b8d1-5322d0faa6af,-3093.47,debit,payment,AU00000,5453f0a3-083c-43c6-9086-adfe94df9918,,,2022-03-13T00:00:00Z,,https://au-api.basiq.io/users/11103cba-4a08-4397-84a5-22ac125ed2f6/transactions/279a8138-9bd3-4c8d-9b2e-0d93b4aabd5f,https://au-api.basiq.io/users/11103cba-4a08-4397-84a5-22ac125ed2f6/accounts/49544383-c19c-4c97-b8d1-5322d0faa6af,https://au-api.basiq.io/institutions/AU00000,,Non-Store Retailing,431
transaction,a5bc08fd-8473-481c-a12a-e69d04e8a8d4,posted,AMAZON AUST SERVICES MELB,-6.00,49544383-c19c-4c97-b8d1-5322d0faa6af,-3084.48,debit,payment,AU00000,5453f0a3-083c-43c6-9086-adfe94df9918,,,2022-03-13T00:00:00Z,,https://au-api.basiq.io/users/11103cba-4a08-4397-84a5-22ac125ed2f6/transactions/a5bc08fd-8473-481c-a12a-e69d04e8a8d4,https://au-api.basiq.io/users/11103cba-4a08-4397-84a5-22ac125ed2f6/accounts/49544383-c19c-4c97-b8d1-5322d0faa6af,https://au-api.basiq.io/institutions/AU00000,,Non-Store Retailing,431
transaction,ba010fc0-d4c3-4418-8b58-cfa49ebdbe1f,posted,MARGARET RIVER NEWS MARGARET RIVEWA AU,-11.99,49544383-c19c-4c97-b8d1-5322d0faa6af,-3078.48,debit,payment,AU00000,5453f0a3-083c-43c6-9086-adfe94df9918,,,2022-03-12T00:00:00Z,,https://au-api.basiq.io/users/11103cba-4a08-4397-84a5-22ac125ed2f6/transactions/ba010fc0-d4c3-4418-8b58-cfa49ebdbe1f,https://au-api.basiq.io/users/11103cba-4a08-4397-84a5-22ac125ed2f6/accounts/49544383-c19c-4c97-b8d1-5322d0faa6af,https://au-api.basiq.io/institutions/AU00000,,Recreational Goods Retailing,424
transaction,e253772a-a6bc-4a00-b5ba-d3c7ca62b09e,posted,RIVER FRESH IGA MARGARET RIV AU,-128.41,49544383-c19c-4c97-b8d1-5322d0faa6af,-3066.49,debit,payment,AU00000,5453f0a3-083c-43c6-9086-adfe94df9918,,,2022-03-12T00:00:00Z,,https://au-api.basiq.io/users/11103cba-4a08-4397-84a5-22ac125ed2f6/transactions/e253772a-a6bc-4a00-b5ba-d3c7ca62b09e,https://au-api.basiq.io/users/11103cba-4a08-4397-84a5-22ac125ed2f6/accounts/49544383-c19c-4c97-b8d1-5322d0faa6af,https://au-api.basiq.io/institutions/AU00000,,Supermarket and Grocery Stores,411
transaction,2eb08757-3f0b-43f2-883d-31dcfaa1a18e,posted,Cash Wdr  MARGARET RIVE,-401.00,49544383-c19c-4c97-b8d1-5322d0faa6af,-2938.08,debit,cash-withdrawal,AU00000,5453f0a3-083c-43c6-9086-adfe94df9918,,,2022-03-12T00:00:00Z,,https://au-api.basiq.io/users/11103cba-4a08-4397-84a5-22ac125ed2f6/transactions/2eb08757-3f0b-43f2-883d-31dcfaa1a18e,https://au-api.basiq.io/users/11103cba-4a08-4397-84a5-22ac125ed2f6/accounts/49544383-c19c-4c97-b8d1-5322d0faa6af,https://au-api.basiq.io/institutions/AU00000,,,
transaction,d7dafd5b-1964-4728-a5d8-2ab45c28c0c4,posted,White Elephant Cafe Gnarabup AU,-81.00,49544383-c19c-4c97-b8d1-5322d0faa6af,-2537.08,debit,payment,AU00000,5453f0a3-083c-43c6-9086-adfe94df9918,,,2022-03-11T00:00:00Z,,https://au-api.basiq.io/users/11103cba-4a08-4397-84a5-22ac125ed2f6/transactions/d7dafd5b-1964-4728-a5d8-2ab45c28c0c4,https://au-api.basiq.io/users/11103cba-4a08-4397-84a5-22ac125ed2f6/accounts/49544383-c19c-4c97-b8d1-5322d0faa6af,https://au-api.basiq.io/institutions/AU00000,,"Cafes, Restaurants and Takeaway Food Services",451
transaction,ad3032fe-9fdb-4818-9141-2c21e20df478,posted,SEA CHANGE NEWS DUNSBOR,-8.00,49544383-c19c-4c97-b8d1-5322d0faa6af,-2456.08,debit,payment,AU00000,5453f0a3-083c-43c6-9086-adfe94df9918,,,2022-03-10T00:00:00Z,,https://au-api.basiq.io/users/11103cba-4a08-4397-84a5-22ac125ed2f6/transactions/ad3032fe-9fdb-4818-9141-2c21e20df478,https://au-api.basiq.io/users/11103cba-4a08-4397-84a5-22ac125ed2f6/accounts/49544383-c19c-4c97-b8d1-5322d0faa6af,https://au-api.basiq.io/institutions/AU00000,,Recreational Goods Retailing,424
transaction,869cccc1-6e61-4b92-a1d6-bb1f3741faeb,posted,VASSE FELIX PTY LTD GRACETOWN AU,-26.00,49544383-c19c-4c97-b8d1-5322d0faa6af,-2448.08,debit,payment,AU00000,5453f0a3-083c-43c6-9086-adfe94df9918,,,2022-03-10T00:00:00Z,,https://au-api.basiq.io/users/11103cba-4a08-4397-84a5-22ac125ed2f6/transactions/869cccc1-6e61-4b92-a1d6-bb1f3741faeb,https://au-api.basiq.io/users/11103cba-4a08-4397-84a5-22ac125ed2f6/accounts/49544383-c19c-4c97-b8d1-5322d0faa6af,https://au-api.basiq.io/institutions/AU00000,,Specialised Food Retailing,412
transaction,3a20a4d1-6b47-47ec-b240-c59257eb051d,posted,TARGETC 6555 BUSS,-70.00,49544383-c19c-4c97-b8d1-5322d0faa6af,-2422.08,debit,payment,AU00000,5453f0a3-083c-43c6-9086-adfe94df9918,,,2022-03-09T00:00:00Z,,https://au-api.basiq.io/users/11103cba-4a08-4397-84a5-22ac125ed2f6/transactions/3a20a4d1-6b47-47ec-b240-c59257eb051d,https://au-api.basiq.io/users/11103cba-4a08-4397-84a5-22ac125ed2f6/accounts/49544383-c19c-4c97-b8d1-5322d0faa6af,https://au-api.basiq.io/institutions/AU00000,,Department Stores,426
transaction,8ec10e28-7c35-472b-b42d-652939f8cc68,posted,BUSSELTON FRESH IGA BUSS,-38.75,49544383-c19c-4c97-b8d1-5322d0faa6af,-2352.08,debit,payment,AU00000,5453f0a3-083c-43c6-9086-adfe94df9918,,,2022-03-09T00:00:00Z,,https://au-api.basiq.io/users/11103cba-4a08-4397-84a5-22ac125ed2f6/transactions/8ec10e28-7c35-472b-b42d-652939f8cc68,https://au-api.basiq.io/users/11103cba-4a08-4397-84a5-22ac125ed2f6/accounts/49544383-c19c-4c97-b8d1-5322d0faa6af,https://au-api.basiq.io/institutions/AU00000,,Supermarket and Grocery Stores,411
transaction,911f2681-7be1-41a1-9705-332296d9cba1,posted,PIERRO MARGARET RIVE WILYABRUP AU,-67.80,49544383-c19c-4c97-b8d1-5322d0faa6af,-2313.33,debit,payment,AU00000,5453f0a3-083c-43c6-9086-adfe94df9918,,,2022-03-09T00:00:00Z,,https://au-api.basiq.io/users/11103cba-4a08-4397-84a5-22ac125ed2f6/transactions/911f2681-7be1-41a1-9705-332296d9cba1,https://au-api.basiq.io/users/11103cba-4a08-4397-84a5-22ac125ed2f6/accounts/49544383-c19c-4c97-b8d1-5322d0faa6af,https://au-api.basiq.io/institutions/AU00000,,Specialised Food Retailing,412
transaction,ecf8ee12-a615-460e-928d-319f54ee5e3f,posted,WOOLWORTHS 4416 BUSSELTN KEN WA AU,-218.99,49544383-c19c-4c97-b8d1-5322d0faa6af,-2245.53,debit,payment,AU00000,5453f0a3-083c-43c6-9086-adfe94df9918,,,2022-03-09T00:00:00Z,,https://au-api.basiq.io/users/11103cba-4a08-4397-84a5-22ac125ed2f6/transactions/ecf8ee12-a615-460e-928d-319f54ee5e3f,https://au-api.basiq.io/users/11103cba-4a08-4397-84a5-22ac125ed2f6/accounts/49544383-c19c-4c97-b8d1-5322d0faa6af,https://au-api.basiq.io/institutions/AU00000,,Supermarket and Grocery Stores,411
transaction,425d98af-d789-4a82-a1ab-41aa07f4d9af,posted,VIVA BOOKS BUSSELTON AU,-15.99,49544383-c19c-4c97-b8d1-5322d0faa6af,-2026.54,debit,payment,AU00000,5453f0a3-083c-43c6-9086-adfe94df9918,,,2022-03-09T00:00:00Z,,https://au-api.basiq.io/users/11103cba-4a08-4397-84a5-22ac125ed2f6/transactions/425d98af-d789-4a82-a1ab-41aa07f4d9af,https://au-api.basiq.io/users/11103cba-4a08-4397-84a5-22ac125ed2f6/accounts/49544383-c19c-4c97-b8d1-5322d0faa6af,https://au-api.basiq.io/institutions/AU00000,,"Newspaper, Periodical, Book and Directory Publishing",541
transaction,a7619f59-1f7f-4a8c-9b6d-c44cb527a48b,posted,COLES 0297 DUNS,-45.60,49544383-c19c-4c97-b8d1-5322d0faa6af,-2010.55,debit,payment,AU00000,5453f0a3-083c-43c6-9086-adfe94df9918,,,2022-03-08T00:00:00Z,,https://au-api.basiq.io/users/11103cba-4a08-4397-84a5-22ac125ed2f6/transactions/a7619f59-1f7f-4a8c-9b6d-c44cb527a48b,https://au-api.basiq.io/users/11103cba-4a08-4397-84a5-22ac125ed2f6/accounts/49544383-c19c-4c97-b8d1-5322d0faa6af,https://au-api.basiq.io/institutions/AU00000,,Supermarket and Grocery Stores,411
transaction,2deea4ea-5804-4b26-9e39-5622b8407020,posted,Eagle Bay Brew Eagle Bay AU,-114.00,49544383-c19c-4c97-b8d1-5322d0faa6af,-1964.95,debit,payment,AU00000,5453f0a3-083c-43c6-9086-adfe94df9918,,,2022-03-08T00:00:00Z,,https://au-api.basiq.io/users/11103cba-4a08-4397-84a5-22ac125ed2f6/transactions/2deea4ea-5804-4b26-9e39-5622b8407020,https://au-api.basiq.io/users/11103cba-4a08-4397-84a5-22ac125ed2f6/accounts/49544383-c19c-4c97-b8d1-5322d0faa6af,https://au-api.basiq.io/institutions/AU00000,,"Cafes, Restaurants and Takeaway Food Services",451
transaction,39dfdfa5-616e-4b26-8957-a873bdac33a0,posted,Tyrepower Busselton Busselton AU,-31.00,49544383-c19c-4c97-b8d1-5322d0faa6af,-1850.95,debit,payment,AU00000,5453f0a3-083c-43c6-9086-adfe94df9918,,,2022-03-08T00:00:00Z,,https://au-api.basiq.io/users/11103cba-4a08-4397-84a5-22ac125ed2f6/transactions/39dfdfa5-616e-4b26-8957-a873bdac33a0,https://au-api.basiq.io/users/11103cba-4a08-4397-84a5-22ac125ed2f6/accounts/49544383-c19c-4c97-b8d1-5322d0faa6af,https://au-api.basiq.io/institutions/AU00000,,Motor Vehicle Parts and Tyre Retailing,392
transaction,588669fb-826d-46ef-8e37-15c5f67fd6cd,posted,AMELIA PARK HOLDINGS BUSSELTON AU,-52.00,49544383-c19c-4c97-b8d1-5322d0faa6af,-1819.95,debit,payment,AU00000,5453f0a3-083c-43c6-9086-adfe94df9918,,,2022-03-08T00:00:00Z,,https://au-api.basiq.io/users/11103cba-4a08-4397-84a5-22ac125ed2f6/transactions/588669fb-826d-46ef-8e37-15c5f67fd6cd,https://au-api.basiq.io/users/11103cba-4a08-4397-84a5-22ac125ed2f6/accounts/49544383-c19c-4c97-b8d1-5322d0faa6af,https://au-api.basiq.io/institutions/AU00000,,Accommodation,440
transaction,a2271528-c494-49cb-b585-dbeee66eba8d,posted,BUSSELTON TOYOTA BUSSELTON WA AU,-146.38,49544383-c19c-4c97-b8d1-5322d0faa6af,-1767.95,debit,payment,AU00000,5453f0a3-083c-43c6-9086-adfe94df9918,,,2022-03-08T00:00:00Z,,https://au-api.basiq.io/users/11103cba-4a08-4397-84a5-22ac125ed2f6/transactions/a2271528-c494-49cb-b585-dbeee66eba8d,https://au-api.basiq.io/users/11103cba-4a08-4397-84a5-22ac125ed2f6/accounts/49544383-c19c-4c97-b8d1-5322d0faa6af,https://au-api.basiq.io/institutions/AU00000,,Motor Vehicle Retailing,391
transaction,ebcd8365-39a1-49e9-8bc1-13f5823ba1db,posted,BERTRAM SUPA IGA BERT,-139.05,49544383-c19c-4c97-b8d1-5322d0faa6af,-1621.57,debit,payment,AU00000,5453f0a3-083c-43c6-9086-adfe94df9918,,,2022-03-07T00:00:00Z,,https://au-api.basiq.io/users/11103cba-4a08-4397-84a5-22ac125ed2f6/transactions/ebcd8365-39a1-49e9-8bc1-13f5823ba1db,https://au-api.basiq.io/users/11103cba-4a08-4397-84a5-22ac125ed2f6/accounts/49544383-c19c-4c97-b8d1-5322d0faa6af,https://au-api.basiq.io/institutions/AU00000,,Supermarket and Grocery Stores,411
transaction,30cc9321-1fd1-4ae9-9a22-d58eab8a553c,posted,WOOLWORTHS 4309 COLL,-48.05,49544383-c19c-4c97-b8d1-5322d0faa6af,-1482.52,debit,payment,AU00000,5453f0a3-083c-43c6-9086-adfe94df9918,,,2022-03-07T00:00:00Z,,https://au-api.basiq.io/users/11103cba-4a08-4397-84a5-22ac125ed2f6/transactions/30cc9321-1fd1-4ae9-9a22-d58eab8a553c,https://au-api.basiq.io/users/11103cba-4a08-4397-84a5-22ac125ed2f6/accounts/49544383-c19c-4c97-b8d1-5322d0faa6af,https://au-api.basiq.io/institutions/AU00000,,Supermarket and Grocery Stores,411
transaction,655830cb-a49f-45b2-b85a-1c616a149cc2,posted,PENANG NOODLE HOUSE BERTRAM,-33.00,49544383-c19c-4c97-b8d1-5322d0faa6af,-1434.47,debit,payment,AU00000,5453f0a3-083c-43c6-9086-adfe94df9918,,,2022-03-07T00:00:00Z,,https://au-api.basiq.io/users/11103cba-4a08-4397-84a5-22ac125ed2f6/transactions/655830cb-a49f-45b2-b85a-1c616a149cc2,https://au-api.basiq.io/users/11103cba-4a08-4397-84a5-22ac125ed2f6/accounts/49544383-c19c-4c97-b8d1-5322d0faa6af,https://au-api.basiq.io/institutions/AU00000,,"Cafes, Restaurants and Takeaway Food Services",451
transaction,30ede860-df33-4944-bc49-18b97ae2445b,posted,WILSON PARKING PER112 FREM,-14.10,49544383-c19c-4c97-b8d1-5322d0faa6af,-1401.47,debit,payment,AU00000,5453f0a3-083c-43c6-9086-adfe94df9918,,,2022-03-07T00:00:00Z,,https://au-api.basiq.io/users/11103cba-4a08-4397-84a5-22ac125ed2f6/transactions/30ede860-df33-4944-bc49-18b97ae2445b,https://au-api.basiq.io/users/11103cba-4a08-4397-84a5-22ac125ed2f6/accounts/49544383-c19c-4c97-b8d1-5322d0faa6af,https://au-api.basiq.io/institutions/AU00000,,Other Personal Services,953
transaction,3c5c2dc6-0840-4a7c-93ba-f2c02fdce76e,posted,WILSON PARKING PER112 FREM,-14.10,49544383-c19c-4c97-b8d1-5322d0faa6af,-1387.37,debit,payment,AU00000,5453f0a3-083c-43c6-9086-adfe94df9918,,,2022-03-07T00:00:00Z,,https://au-api.basiq.io/users/11103cba-4a08-4397-84a5-22ac125ed2f6/transactions/3c5c2dc6-0840-4a7c-93ba-f2c02fdce76e,https://au-api.basiq.io/users/11103cba-4a08-4397-84a5-22ac125ed2f6/accounts/49544383-c19c-4c97-b8d1-5322d0faa6af,https://au-api.basiq.io/institutions/AU00000,,Other Personal Services,953
transaction,dba4b909-7d63-4870-b24f-b37403d85036,posted,WILSON PARKING PER112 FREM,-14.10,49544383-c19c-4c97-b8d1-5322d0faa6af,-1373.27,debit,payment,AU00000,5453f0a3-083c-43c6-9086-adfe94df9918,,,2022-03-07T00:00:00Z,,https://au-api.basiq.io/users/11103cba-4a08-4397-84a5-22ac125ed2f6/transactions/dba4b909-7d63-4870-b24f-b37403d85036,https://au-api.basiq.io/users/11103cba-4a08-4397-84a5-22ac125ed2f6/accounts/49544383-c19c-4c97-b8d1-5322d0faa6af,https://au-api.basiq.io/institutions/AU00000,,Other Personal Services,953
transaction,48904da2-dac5-4eba-8f24-60b8a94cd748,posted,WILSON PARKING PER112 FREM,-11.08,49544383-c19c-4c97-b8d1-5322d0faa6af,-1359.17,debit,payment,AU00000,5453f0a3-083c-43c6-9086-adfe94df9918,,,2022-03-07T00:00:00Z,,https://au-api.basiq.io/users/11103cba-4a08-4397-84a5-22ac125ed2f6/transactions/48904da2-dac5-4eba-8f24-60b8a94cd748,https://au-api.basiq.io/users/11103cba-4a08-4397-84a5-22ac125ed2f6/accounts/49544383-c19c-4c97-b8d1-5322d0faa6af,https://au-api.basiq.io/institutions/AU00000,,Other Personal Services,953
transaction,90b9df32-1286-47b7-85eb-63196a9be70a,posted,NEWS SHELL WS BUSSELTON AU,-7.95,49544383-c19c-4c97-b8d1-5322d0faa6af,-1348.09,debit,payment,AU00000,5453f0a3-083c-43c6-9086-adfe94df9918,,,2022-03-07T00:00:00Z,,https://au-api.basiq.io/users/11103cba-4a08-4397-84a5-22ac125ed2f6/transactions/90b9df32-1286-47b7-85eb-63196a9be70a,https://au-api.basiq.io/users/11103cba-4a08-4397-84a5-22ac125ed2f6/accounts/49544383-c19c-4c97-b8d1-5322d0faa6af,https://au-api.basiq.io/institutions/AU00000,,Fuel Retailing,400
transaction,3827245c-a63d-46c7-abdd-2db2fe5cc667,posted,AMELIA PARK HOLDINGS BUSSELTON AU,-52.00,49544383-c19c-4c97-b8d1-5322d0faa6af,-1340.14,debit,payment,AU00000,5453f0a3-083c-43c6-9086-adfe94df9918,,,2022-03-07T00:00:00Z,,https://au-api.basiq.io/users/11103cba-4a08-4397-84a5-22ac125ed2f6/transactions/3827245c-a63d-46c7-abdd-2db2fe5cc667,https://au-api.basiq.io/users/11103cba-4a08-4397-84a5-22ac125ed2f6/accounts/49544383-c19c-4c97-b8d1-5322d0faa6af,https://au-api.basiq.io/institutions/AU00000,,Accommodation,440
transaction,0baed58f-628e-4ef7-83a7-a92f8d50983f,posted,WILSON PARKING PER112 FREM,-11.08,49544383-c19c-4c97-b8d1-5322d0faa6af,-1288.14,debit,payment,AU00000,5453f0a3-083c-43c6-9086-adfe94df9918,,,2022-03-06T00:00:00Z,,https://au-api.basiq.io/users/11103cba-4a08-4397-84a5-22ac125ed2f6/transactions/0baed58f-628e-4ef7-83a7-a92f8d50983f,https://au-api.basiq.io/users/11103cba-4a08-4397-84a5-22ac125ed2f6/accounts/49544383-c19c-4c97-b8d1-5322d0faa6af,https://au-api.basiq.io/institutions/AU00000,,Other Personal Services,953
transaction,79ec6e15-4931-4aa0-9fae-24b011320a1e,posted,WILSON PARKING PER112 FREM,-11.08,49544383-c19c-4c97-b8d1-5322d0faa6af,-1277.06,debit,payment,AU00000,5453f0a3-083c-43c6-9086-adfe94df9918,,,2022-03-06T00:00:00Z,,https://au-api.basiq.io/users/11103cba-4a08-4397-84a5-22ac125ed2f6/transactions/79ec6e15-4931-4aa0-9fae-24b011320a1e,https://au-api.basiq.io/users/11103cba-4a08-4397-84a5-22ac125ed2f6/accounts/49544383-c19c-4c97-b8d1-5322d0faa6af,https://au-api.basiq.io/institutions/AU00000,,Other Personal Services,953
transaction,9dcaa6fb-dfc0-4f00-be33-5bfe6f009354,posted,CALTEX COLLIE AU,-288.89,49544383-c19c-4c97-b8d1-5322d0faa6af,-1265.98,debit,payment,AU00000,5453f0a3-083c-43c6-9086-adfe94df9918,,,2022-03-06T00:00:00Z,,https://au-api.basiq.io/users/11103cba-4a08-4397-84a5-22ac125ed2f6/transactions/9dcaa6fb-dfc0-4f00-be33-5bfe6f009354,https://au-api.basiq.io/users/11103cba-4a08-4397-84a5-22ac125ed2f6/accounts/49544383-c19c-4c97-b8d1-5322d0faa6af,https://au-api.basiq.io/institutions/AU00000,,Fuel Retailing,400
transaction,a2ea0d03-a163-4ff9-ad10-e4caa119585d,posted,PIGEONHOLE PERT,-83.05,49544383-c19c-4c97-b8d1-5322d0faa6af,-977.09,debit,payment,AU00000,5453f0a3-083c-43c6-9086-adfe94df9918,,,2022-03-03T00:00:00Z,,https://au-api.basiq.io/users/11103cba-4a08-4397-84a5-22ac125ed2f6/transactions/a2ea0d03-a163-4ff9-ad10-e4caa119585d,https://au-api.basiq.io/users/11103cba-4a08-4397-84a5-22ac125ed2f6/accounts/49544383-c19c-4c97-b8d1-5322d0faa6af,https://au-api.basiq.io/institutions/AU00000,,"Clothing, Footwear and Personal Accessory Retailing",425
transaction,71052d73-3d3d-44a0-9d62-c5dfe8873607,posted,TICKETEK PTY LTD SYDN,-82.60,49544383-c19c-4c97-b8d1-5322d0faa6af,-894.04,debit,payment,AU00000,5453f0a3-083c-43c6-9086-adfe94df9918,,,2022-03-03T00:00:00Z,,https://au-api.basiq.io/users/11103cba-4a08-4397-84a5-22ac125ed2f6/transactions/71052d73-3d3d-44a0-9d62-c5dfe8873607,https://au-api.basiq.io/users/11103cba-4a08-4397-84a5-22ac125ed2f6/accounts/49544383-c19c-4c97-b8d1-5322d0faa6af,https://au-api.basiq.io/institutions/AU00000,,Creative and Performing Arts Activities,900
transaction,327d71ef-c05f-47fd-a1af-0907e0f4d27f,posted,THE CHART AND MAP SHOP FREM,-49.00,49544383-c19c-4c97-b8d1-5322d0faa6af,-811.44,debit,payment,AU00000,5453f0a3-083c-43c6-9086-adfe94df9918,,,2022-03-03T00:00:00Z,,https://au-api.basiq.io/users/11103cba-4a08-4397-84a5-22ac125ed2f6/transactions/327d71ef-c05f-47fd-a1af-0907e0f4d27f,https://au-api.basiq.io/users/11103cba-4a08-4397-84a5-22ac125ed2f6/accounts/49544383-c19c-4c97-b8d1-5322d0faa6af,https://au-api.basiq.io/institutions/AU00000,,"Newspaper, Periodical, Book and Directory Publishing",541
transaction,2e89ae49-29e5-4a28-af06-94d4ab58901e,posted,NUMBER ONE NAILS FREM,-29.00,49544383-c19c-4c97-b8d1-5322d0faa6af,-762.44,debit,payment,AU00000,5453f0a3-083c-43c6-9086-adfe94df9918,,,2022-03-03T00:00:00Z,,https://au-api.basiq.io/users/11103cba-4a08-4397-84a5-22ac125ed2f6/transactions/2e89ae49-29e5-4a28-af06-94d4ab58901e,https://au-api.basiq.io/users/11103cba-4a08-4397-84a5-22ac125ed2f6/accounts/49544383-c19c-4c97-b8d1-5322d0faa6af,https://au-api.basiq.io/institutions/AU00000,,Personal Care Services,951
transaction,233900ee-4923-472a-b04e-1f210e2b3cea,posted,YOCAL CAFE FREM,-23.50,49544383-c19c-4c97-b8d1-5322d0faa6af,-733.44,debit,payment,AU00000,5453f0a3-083c-43c6-9086-adfe94df9918,,,2022-03-03T00:00:00Z,,https://au-api.basiq.io/users/11103cba-4a08-4397-84a5-22ac125ed2f6/transactions/233900ee-4923-472a-b04e-1f210e2b3cea,https://au-api.basiq.io/users/11103cba-4a08-4397-84a5-22ac125ed2f6/accounts/49544383-c19c-4c97-b8d1-5322d0faa6af,https://au-api.basiq.io/institutions/AU00000,,"Cafes, Restaurants and Takeaway Food Services",451
transaction,b8cc18a2-dcea-49ce-9843-f41331482789,posted,CITY OF PERTH PARK1 PERT,-14.33,49544383-c19c-4c97-b8d1-5322d0faa6af,-709.94,debit,payment,AU00000,5453f0a3-083c-43c6-9086-adfe94df9918,,,2022-03-03T00:00:00Z,,https://au-api.basiq.io/users/11103cba-4a08-4397-84a5-22ac125ed2f6/transactions/b8cc18a2-dcea-49ce-9843-f41331482789,https://au-api.basiq.io/users/11103cba-4a08-4397-84a5-22ac125ed2f6/accounts/49544383-c19c-4c97-b8d1-5322d0faa6af,https://au-api.basiq.io/institutions/AU00000,,Regulatory Services,772
transaction,eebde03a-a765-4caa-b5d2-e21c730c8e53,posted,WILSON PARKING PER112 FREM,-11.08,49544383-c19c-4c97-b8d1-5322d0faa6af,-695.61,debit,payment,AU00000,5453f0a3-083c-43c6-9086-adfe94df9918,,,2022-03-03T00:00:00Z,,https://au-api.basiq.io/users/11103cba-4a08-4397-84a5-22ac125ed2f6/transactions/eebde03a-a765-4caa-b5d2-e21c730c8e53,https://au-api.basiq.io/users/11103cba-4a08-4397-84a5-22ac125ed2f6/accounts/49544383-c19c-4c97-b8d1-5322d0faa6af,https://au-api.basiq.io/institutions/AU00000,,Other Personal Services,953
transaction,eec4d2a8-5c5e-41cd-a4cb-7c9d989a2095,posted,AMAZON AUST SERVICES MELB,-8.99,49544383-c19c-4c97-b8d1-5322d0faa6af,-684.53,debit,payment,AU00000,5453f0a3-083c-43c6-9086-adfe94df9918,,,2022-03-03T00:00:00Z,,https://au-api.basiq.io/users/11103cba-4a08-4397-84a5-22ac125ed2f6/transactions/eec4d2a8-5c5e-41cd-a4cb-7c9d989a2095,https://au-api.basiq.io/users/11103cba-4a08-4397-84a5-22ac125ed2f6/accounts/49544383-c19c-4c97-b8d1-5322d0faa6af,https://au-api.basiq.io/institutions/AU00000,,Non-Store Retailing,431
transaction,a455f0c3-2906-40fe-92ff-9c5ce03a34c1,posted,AMAZON AUST SERVICES MELB,-8.99,49544383-c19c-4c97-b8d1-5322d0faa6af,-675.54,debit,payment,AU00000,5453f0a3-083c-43c6-9086-adfe94df9918,,,2022-03-03T00:00:00Z,,https://au-api.basiq.io/users/11103cba-4a08-4397-84a5-22ac125ed2f6/transactions/a455f0c3-2906-40fe-92ff-9c5ce03a34c1,https://au-api.basiq.io/users/11103cba-4a08-4397-84a5-22ac125ed2f6/accounts/49544383-c19c-4c97-b8d1-5322d0faa6af,https://au-api.basiq.io/institutions/AU00000,,Non-Store Retailing,431
transaction,eeaeda6c-0bb9-4925-8a02-0dea93eed665,posted,AMAZON AUST SERVICES MELB,-6.20,49544383-c19c-4c97-b8d1-5322d0faa6af,-666.55,debit,payment,AU00000,5453f0a3-083c-43c6-9086-adfe94df9918,,,2022-03-03T00:00:00Z,,https://au-api.basiq.io/users/11103cba-4a08-4397-84a5-22ac125ed2f6/transactions/eeaeda6c-0bb9-4925-8a02-0dea93eed665,https://au-api.basiq.io/users/11103cba-4a08-4397-84a5-22ac125ed2f6/accounts/49544383-c19c-4c97-b8d1-5322d0faa6af,https://au-api.basiq.io/institutions/AU00000,,Non-Store Retailing,431
transaction,442845c0-f2fc-445c-b1f1-0c8b53c58e19,posted,AMAZON AUST SERVICES MELB,-6.00,49544383-c19c-4c97-b8d1-5322d0faa6af,-660.35,debit,payment,AU00000,5453f0a3-083c-43c6-9086-adfe94df9918,,,2022-03-03T00:00:00Z,,https://au-api.basiq.io/users/11103cba-4a08-4397-84a5-22ac125ed2f6/transactions/442845c0-f2fc-445c-b1f1-0c8b53c58e19,https://au-api.basiq.io/users/11103cba-4a08-4397-84a5-22ac125ed2f6/accounts/49544383-c19c-4c97-b8d1-5322d0faa6af,https://au-api.basiq.io/institutions/AU00000,,Non-Store Retailing,431
transaction,f69674da-aed4-4e1b-9c95-86be735df856,posted,BERTRAM SUPA IGA BERTRAM AU,-180.24,49544383-c19c-4c97-b8d1-5322d0faa6af,-654.35,debit,payment,AU00000,5453f0a3-083c-43c6-9086-adfe94df9918,,,2022-03-03T00:00:00Z,,https://au-api.basiq.io/users/11103cba-4a08-4397-84a5-22ac125ed2f6/transactions/f69674da-aed4-4e1b-9c95-86be735df856,https://au-api.basiq.io/users/11103cba-4a08-4397-84a5-22ac125ed2f6/accounts/49544383-c19c-4c97-b8d1-5322d0faa6af,https://au-api.basiq.io/institutions/AU00000,,Supermarket and Grocery Stores,411
transaction,dc37194d-f935-48f5-a931-cf5ec4d9c264,posted,ARB WANGARA WANGARA AU,-77.65,49544383-c19c-4c97-b8d1-5322d0faa6af,-474.11,debit,payment,AU00000,5453f0a3-083c-43c6-9086-adfe94df9918,,,2022-03-03T00:00:00Z,,https://au-api.basiq.io/users/11103cba-4a08-4397-84a5-22ac125ed2f6/transactions/dc37194d-f935-48f5-a931-cf5ec4d9c264,https://au-api.basiq.io/users/11103cba-4a08-4397-84a5-22ac125ed2f6/accounts/49544383-c19c-4c97-b8d1-5322d0faa6af,https://au-api.basiq.io/institutions/AU00000,,Motor Vehicle and Motor Vehicle Parts Wholesaling,350
transaction,6dd7b8b4-59c0-4399-89b8-e2e380774645,posted,SMART CHOICE REALTY PTY LWHIT,-263.65,49544383-c19c-4c97-b8d1-5322d0faa6af,-396.46,debit,payment,AU00000,5453f0a3-083c-43c6-9086-adfe94df9918,,,2022-03-02T00:00:00Z,,https://au-api.basiq.io/users/11103cba-4a08-4397-84a5-22ac125ed2f6/transactions/6dd7b8b4-59c0-4399-89b8-e2e380774645,https://au-api.basiq.io/users/11103cba-4a08-4397-84a5-22ac125ed2f6/accounts/49544383-c19c-4c97-b8d1-5322d0faa6af,https://au-api.basiq.io/institutions/AU00000,,Real Estate Services,672
transaction,8799b728-0523-43f2-9330-bf7e6d63aa01,posted,WILSON PARKING PER112 FREM,-14.10,49544383-c19c-4c97-b8d1-5322d0faa6af,-132.81,debit,payment,AU00000,5453f0a3-083c-43c6-9086-adfe94df9918,,,2022-03-02T00:00:00Z,,https://au-api.basiq.io/users/11103cba-4a08-4397-84a5-22ac125ed2f6/transactions/8799b728-0523-43f2-9330-bf7e6d63aa01,https://au-api.basiq.io/users/11103cba-4a08-4397-84a5-22ac125ed2f6/accounts/49544383-c19c-4c97-b8d1-5322d0faa6af,https://au-api.basiq.io/institutions/AU00000,,Other Personal Services,953
transaction,47789709-b147-4bd6-b86c-5169237d9ab4,posted,WILSON PARKING PER112 FREM,-11.08,49544383-c19c-4c97-b8d1-5322d0faa6af,-118.71,debit,payment,AU00000,5453f0a3-083c-43c6-9086-adfe94df9918,,,2022-03-02T00:00:00Z,,https://au-api.basiq.io/users/11103cba-4a08-4397-84a5-22ac125ed2f6/transactions/47789709-b147-4bd6-b86c-5169237d9ab4,https://au-api.basiq.io/users/11103cba-4a08-4397-84a5-22ac125ed2f6/accounts/49544383-c19c-4c97-b8d1-5322d0faa6af,https://au-api.basiq.io/institutions/AU00000,,Other Personal Services,953
transaction,5aa1d122-e93c-4e36-80fd-72d0a331fe25,posted,CITY OF PERTH PARKING-ONSPERT,-7.67,49544383-c19c-4c97-b8d1-5322d0faa6af,-107.63,debit,payment,AU00000,5453f0a3-083c-43c6-9086-adfe94df9918,,,2022-03-02T00:00:00Z,,https://au-api.basiq.io/users/11103cba-4a08-4397-84a5-22ac125ed2f6/transactions/5aa1d122-e93c-4e36-80fd-72d0a331fe25,https://au-api.basiq.io/users/11103cba-4a08-4397-84a5-22ac125ed2f6/accounts/49544383-c19c-4c97-b8d1-5322d0faa6af,https://au-api.basiq.io/institutions/AU00000,,Regulatory Services,772
transaction,7688acbc-bc21-4416-82c6-02655993d8f1,posted,BREAD IN COMMON FREMANTLE WA AU,-136.00,49544383-c19c-4c97-b8d1-5322d0faa6af,-99.96,debit,payment,AU00000,5453f0a3-083c-43c6-9086-adfe94df9918,,,2022-03-02T00:00:00Z,,https://au-api.basiq.io/users/11103cba-4a08-4397-84a5-22ac125ed2f6/transactions/7688acbc-bc21-4416-82c6-02655993d8f1,https://au-api.basiq.io/users/11103cba-4a08-4397-84a5-22ac125ed2f6/accounts/49544383-c19c-4c97-b8d1-5322d0faa6af,https://au-api.basiq.io/institutions/AU00000,,Bakery Product Manufacturing,117
transaction,72d59d8e-f85a-485e-9c70-f58c7c50a3ae,posted,THE BEAD POST PTY LT FREMANTLE AU,-176.00,49544383-c19c-4c97-b8d1-5322d0faa6af,36.04,debit,payment,AU00000,5453f0a3-083c-43c6-9086-adfe94df9918,,,2022-03-02T00:00:00Z,,https://au-api.basiq.io/users/11103cba-4a08-4397-84a5-22ac125ed2f6/transactions/72d59d8e-f85a-485e-9c70-f58c7c50a3ae,https://au-api.basiq.io/users/11103cba-4a08-4397-84a5-22ac125ed2f6/accounts/49544383-c19c-4c97-b8d1-5322d0faa6af,https://au-api.basiq.io/institutions/AU00000,,Pharmaceutical and Other Store-Based Retailing,427
transaction,a768603e-b83b-49b1-b7c3-61812f5aafb8,posted,AUTO MASTERS FREMANT LE FREMANTLE AU,-261.00,49544383-c19c-4c97-b8d1-5322d0faa6af,212.04,debit,payment,AU00000,5453f0a3-083c-43c6-9086-adfe94df9918,,,2022-03-02T00:00:00Z,,https://au-api.basiq.io/users/11103cba-4a08-4397-84a5-22ac125ed2f6/transactions/a768603e-b83b-49b1-b7c3-61812f5aafb8,https://au-api.basiq.io/users/11103cba-4a08-4397-84a5-22ac125ed2f6/accounts/49544383-c19c-4c97-b8d1-5322d0faa6af,https://au-api.basiq.io/institutions/AU00000,,Automotive Repair and Maintenance,941
transaction,fbcf2f2a-4645-40d2-b68b-8968eba29f6d,posted,The Modern Eatery Fremantle AU,-67.00,49544383-c19c-4c97-b8d1-5322d0faa6af,473.04,debit,payment,AU00000,5453f0a3-083c-43c6-9086-adfe94df9918,,,2022-03-02T00:00:00Z,,https://au-api.basiq.io/users/11103cba-4a08-4397-84a5-22ac125ed2f6/transactions/fbcf2f2a-4645-40d2-b68b-8968eba29f6d,https://au-api.basiq.io/users/11103cba-4a08-4397-84a5-22ac125ed2f6/accounts/49544383-c19c-4c97-b8d1-5322d0faa6af,https://au-api.basiq.io/institutions/AU00000,,"Cafes, Restaurants and Takeaway Food Services",451
transaction,547fb15f-62c4-4ef8-bc85-da665b253e1f,posted,YACHT GROT FREMANTLE WA AU,-31.00,49544383-c19c-4c97-b8d1-5322d0faa6af,540.04,debit,payment,AU00000,5453f0a3-083c-43c6-9086-adfe94df9918,,,2022-03-02T00:00:00Z,,https://au-api.basiq.io/users/11103cba-4a08-4397-84a5-22ac125ed2f6/transactions/547fb15f-62c4-4ef8-bc85-da665b253e1f,https://au-api.basiq.io/users/11103cba-4a08-4397-84a5-22ac125ed2f6/accounts/49544383-c19c-4c97-b8d1-5322d0faa6af,https://au-api.basiq.io/institutions/AU00000,,Recreational Goods Retailing,424
transaction,fd9f8837-7c1f-466c-9437-0886219fb48a,posted,TARGET 5036 FREMANTLE AU,-30.00,49544383-c19c-4c97-b8d1-5322d0faa6af,571.04,debit,payment,AU00000,5453f0a3-083c-43c6-9086-adfe94df9918,,,2022-03-02T00:00:00Z,,https://au-api.basiq.io/users/11103cba-4a08-4397-84a5-22ac125ed2f6/transactions/fd9f8837-7c1f-466c-9437-0886219fb48a,https://au-api.basiq.io/users/11103cba-4a08-4397-84a5-22ac125ed2f6/accounts/49544383-c19c-4c97-b8d1-5322d0faa6af,https://au-api.basiq.io/institutions/AU00000,,Department Stores,426
transaction,e2b839bc-fb0f-49a3-9d7e-8b8b013180db,posted,TOYWORLD FREMANTLE FREMANTLE AU,-15.99,49544383-c19c-4c97-b8d1-5322d0faa6af,601.04,debit,payment,AU00000,5453f0a3-083c-43c6-9086-adfe94df9918,,,2022-03-02T00:00:00Z,,https://au-api.basiq.io/users/11103cba-4a08-4397-84a5-22ac125ed2f6/transactions/e2b839bc-fb0f-49a3-9d7e-8b8b013180db,https://au-api.basiq.io/users/11103cba-4a08-4397-84a5-22ac125ed2f6/accounts/49544383-c19c-4c97-b8d1-5322d0faa6af,https://au-api.basiq.io/institutions/AU00000,,Recreational Goods Retailing,424
transaction,40c734ed-5563-4c06-aa69-9513d37b4636,posted,DOME SCARBOROUGH SCAR,-14.45,49544383-c19c-4c97-b8d1-5322d0faa6af,617.03,debit,payment,AU00000,5453f0a3-083c-43c6-9086-adfe94df9918,,,2022-03-01T00:00:00Z,,https://au-api.basiq.io/users/11103cba-4a08-4397-84a5-22ac125ed2f6/transactions/40c734ed-5563-4c06-aa69-9513d37b4636,https://au-api.basiq.io/users/11103cba-4a08-4397-84a5-22ac125ed2f6/accounts/49544383-c19c-4c97-b8d1-5322d0faa6af,https://au-api.basiq.io/institutions/AU00000,,"Cafes, Restaurants and Takeaway Food Services",451
transaction,1643ece6-6af5-40d8-b289-7c94a2968d62,posted,WILSON PARKING PER112 FREM,-14.10,49544383-c19c-4c97-b8d1-5322d0faa6af,631.48,debit,payment,AU00000,5453f0a3-083c-43c6-9086-adfe94df9918,,,2022-03-01T00:00:00Z,,https://au-api.basiq.io/users/11103cba-4a08-4397-84a5-22ac125ed2f6/transactions/1643ece6-6af5-40d8-b289-7c94a2968d62,https://au-api.basiq.io/users/11103cba-4a08-4397-84a5-22ac125ed2f6/accounts/49544383-c19c-4c97-b8d1-5322d0faa6af,https://au-api.basiq.io/institutions/AU00000,,Other Personal Services,953
transaction,86024039-0c8e-4bb9-a776-d845eb5ea53d,posted,CITY OF PERTH PARKING-ONSPERT,-9.28,49544383-c19c-4c97-b8d1-5322d0faa6af,645.58,debit,payment,AU00000,5453f0a3-083c-43c6-9086-adfe94df9918,,,2022-03-01T00:00:00Z,,https://au-api.basiq.io/users/11103cba-4a08-4397-84a5-22ac125ed2f6/transactions/86024039-0c8e-4bb9-a776-d845eb5ea53d,https://au-api.basiq.io/users/11103cba-4a08-4397-84a5-22ac125ed2f6/accounts/49544383-c19c-4c97-b8d1-5322d0faa6af,https://au-api.basiq.io/institutions/AU00000,,Regulatory Services,772
transaction,3e3ce4c1-d9b1-451c-b123-d8bb966a08cb,posted,THE LUCKY SHAG BAR PERTH AU,-40.80,49544383-c19c-4c97-b8d1-5322d0faa6af,654.86,debit,payment,AU00000,5453f0a3-083c-43c6-9086-adfe94df9918,,,2022-03-01T00:00:00Z,,https://au-api.basiq.io/users/11103cba-4a08-4397-84a5-22ac125ed2f6/transactions/3e3ce4c1-d9b1-451c-b123-d8bb966a08cb,https://au-api.basiq.io/users/11103cba-4a08-4397-84a5-22ac125ed2f6/accounts/49544383-c19c-4c97-b8d1-5322d0faa6af,https://au-api.basiq.io/institutions/AU00000,,"Pubs, Taverns and Bars",452
transaction,c3f3c3cc-0865-4b77-82f6-f5501425f79f,posted,SMART CHOICE REALTY PTY LWHIT,-908.95,49544383-c19c-4c97-b8d1-5322d0faa6af,695.66,debit,payment,AU00000,5453f0a3-083c-43c6-9086-adfe94df9918,,,2022-02-28T00:00:00Z,,https://au-api.basiq.io/users/11103cba-4a08-4397-84a5-22ac125ed2f6/transactions/c3f3c3cc-0865-4b77-82f6-f5501425f79f,https://au-api.basiq.io/users/11103cba-4a08-4397-84a5-22ac125ed2f6/accounts/49544383-c19c-4c97-b8d1-5322d0faa6af,https://au-api.basiq.io/institutions/AU00000,,Real Estate Services,672
transaction,ecc284d0-6cf3-48ec-9d99-36f915dd30f9,posted,JURIEN IGA JURI,-25.90,49544383-c19c-4c97-b8d1-5322d0faa6af,1867.90,debit,payment,AU00000,5453f0a3-083c-43c6-9086-adfe94df9918,,,2022-02-28T00:00:00Z,,https://au-api.basiq.io/users/11103cba-4a08-4397-84a5-22ac125ed2f6/transactions/ecc284d0-6cf3-48ec-9d99-36f915dd30f9,https://au-api.basiq.io/users/11103cba-4a08-4397-84a5-22ac125ed2f6/accounts/49544383-c19c-4c97-b8d1-5322d0faa6af,https://au-api.basiq.io/institutions/AU00000,,Supermarket and Grocery Stores,411
transaction,1208f006-45af-4d6f-b070-915fd3d23df4,posted,NEW NORCIA SERVICES NEW,-38.50,49544383-c19c-4c97-b8d1-5322d0faa6af,1604.61,debit,payment,AU00000,5453f0a3-083c-43c6-9086-adfe94df9918,,,2022-02-28T00:00:00Z,,https://au-api.basiq.io/users/11103cba-4a08-4397-84a5-22ac125ed2f6/transactions/1208f006-45af-4d6f-b070-915fd3d23df4,https://au-api.basiq.io/users/11103cba-4a08-4397-84a5-22ac125ed2f6/accounts/49544383-c19c-4c97-b8d1-5322d0faa6af,https://au-api.basiq.io/institutions/AU00000,,Fuel Retailing,400
transaction,77018f56-95d9-48fc-9ce5-ce55c1786a89,posted,TAYLOR RD IGA NEDLANDS WA AU,-103.33,49544383-c19c-4c97-b8d1-5322d0faa6af,1643.11,debit,payment,AU00000,5453f0a3-083c-43c6-9086-adfe94df9918,,,2022-02-28T00:00:00Z,,https://au-api.basiq.io/users/11103cba-4a08-4397-84a5-22ac125ed2f6/transactions/77018f56-95d9-48fc-9ce5-ce55c1786a89,https://au-api.basiq.io/users/11103cba-4a08-4397-84a5-22ac125ed2f6/accounts/49544383-c19c-4c97-b8d1-5322d0faa6af,https://au-api.basiq.io/institutions/AU00000,,Supermarket and Grocery Stores,411
transaction,25738ea9-3f1f-437e-99e1-93ff5d1c990a,posted,TFR From Transaction to CC Acc 13,9278.50,49544383-c19c-4c97-b8d1-5322d0faa6af,1893.80,credit,transfer,AU00000,5453f0a3-083c-43c6-9086-adfe94df9918,,,2022-02-28T00:00:00Z,,https://au-api.basiq.io/users/11103cba-4a08-4397-84a5-22ac125ed2f6/transactions/25738ea9-3f1f-437e-99e1-93ff5d1c990a,https://au-api.basiq.io/users/11103cba-4a08-4397-84a5-22ac125ed2f6/accounts/49544383-c19c-4c97-b8d1-5322d0faa6af,https://au-api.basiq.io/institutions/AU00000,,,
transaction,137c6a3d-25ae-438e-9c36-adbf144f4795,posted,COLES 0342 FREMANTLE AU,-121.46,49544383-c19c-4c97-b8d1-5322d0faa6af,1746.44,debit,payment,AU00000,5453f0a3-083c-43c6-9086-adfe94df9918,,,2022-02-28T00:00:00Z,,https://au-api.basiq.io/users/11103cba-4a08-4397-84a5-22ac125ed2f6/transactions/137c6a3d-25ae-438e-9c36-adbf144f4795,https://au-api.basiq.io/users/11103cba-4a08-4397-84a5-22ac125ed2f6/accounts/49544383-c19c-4c97-b8d1-5322d0faa6af,https://au-api.basiq.io/institutions/AU00000,,Supermarket and Grocery Stores,411
transaction,969ced2f-606a-4d91-a504-db163eb20e54,posted,STOCCO HOLDINGS (WA) FREMANTLE AU,-170.00,49544383-c19c-4c97-b8d1-5322d0faa6af,-7384.70,debit,payment,AU00000,5453f0a3-083c-43c6-9086-adfe94df9918,,,2022-02-28T00:00:00Z,,https://au-api.basiq.io/users/11103cba-4a08-4397-84a5-22ac125ed2f6/transactions/969ced2f-606a-4d91-a504-db163eb20e54,https://au-api.basiq.io/users/11103cba-4a08-4397-84a5-22ac125ed2f6/accounts/49544383-c19c-4c97-b8d1-5322d0faa6af,https://au-api.basiq.io/institutions/AU00000,,"Cafes, Restaurants and Takeaway Food Services",451
transaction,ddb4fff8-e9f1-4af9-9e15-6288ffaa2014,posted,DOUBLEVIEW IGA DOUBLEVIEW AU,-207.55,49544383-c19c-4c97-b8d1-5322d0faa6af,-7214.70,debit,payment,AU00000,5453f0a3-083c-43c6-9086-adfe94df9918,,,2022-02-27T00:00:00Z,,https://au-api.basiq.io/users/11103cba-4a08-4397-84a5-22ac125ed2f6/transactions/ddb4fff8-e9f1-4af9-9e15-6288ffaa2014,https://au-api.basiq.io/users/11103cba-4a08-4397-84a5-22ac125ed2f6/accounts/49544383-c19c-4c97-b8d1-5322d0faa6af,https://au-api.basiq.io/institutions/AU00000,,Supermarket and Grocery Stores,411
transaction,8d816ec1-0aa2-4c74-a0ef-62ccc383f154,posted,MENCHIES SUBIACO SUBIACO WA AU,-9.27,49544383-c19c-4c97-b8d1-5322d0faa6af,-7007.15,debit,payment,AU00000,5453f0a3-083c-43c6-9086-adfe94df9918,,,2022-02-27T00:00:00Z,,https://au-api.basiq.io/users/11103cba-4a08-4397-84a5-22ac125ed2f6/transactions/8d816ec1-0aa2-4c74-a0ef-62ccc383f154,https://au-api.basiq.io/users/11103cba-4a08-4397-84a5-22ac125ed2f6/accounts/49544383-c19c-4c97-b8d1-5322d0faa6af,https://au-api.basiq.io/institutions/AU00000,,"Cafes, Restaurants and Takeaway Food Services",451
transaction,67af2548-8b3c-453b-a0cc-b8db5c47c80f,posted,REFUND  SCARBOROUGH  AU,317.00,49544383-c19c-4c97-b8d1-5322d0faa6af,-6997.88,credit,refund,AU00000,5453f0a3-083c-43c6-9086-adfe94df9918,,,2022-02-27T00:00:00Z,,https://au-api.basiq.io/users/11103cba-4a08-4397-84a5-22ac125ed2f6/transactions/67af2548-8b3c-453b-a0cc-b8db5c47c80f,https://au-api.basiq.io/users/11103cba-4a08-4397-84a5-22ac125ed2f6/accounts/49544383-c19c-4c97-b8d1-5322d0faa6af,https://au-api.basiq.io/institutions/AU00000,,,
transaction,cdaf27e5-18ea-48ec-8b80-b3e71c53048d,posted,WEST BEACH LAGOON SCARBOROUGH AU,-791.00,49544383-c19c-4c97-b8d1-5322d0faa6af,-7314.88,debit,payment,AU00000,5453f0a3-083c-43c6-9086-adfe94df9918,,,2022-02-26T00:00:00Z,,https://au-api.basiq.io/users/11103cba-4a08-4397-84a5-22ac125ed2f6/transactions/cdaf27e5-18ea-48ec-8b80-b3e71c53048d,https://au-api.basiq.io/users/11103cba-4a08-4397-84a5-22ac125ed2f6/accounts/49544383-c19c-4c97-b8d1-5322d0faa6af,https://au-api.basiq.io/institutions/AU00000,,Accommodation,440
transaction,d30197b1-9204-43d1-af33-72a62844a727,posted,QUEENS SUPA IGA GERA,-49.82,49544383-c19c-4c97-b8d1-5322d0faa6af,-6523.88,debit,payment,AU00000,5453f0a3-083c-43c6-9086-adfe94df9918,,,2022-02-25T00:00:00Z,,https://au-api.basiq.io/users/11103cba-4a08-4397-84a5-22ac125ed2f6/transactions/d30197b1-9204-43d1-af33-72a62844a727,https://au-api.basiq.io/users/11103cba-4a08-4397-84a5-22ac125ed2f6/accounts/49544383-c19c-4c97-b8d1-5322d0faa6af,https://au-api.basiq.io/institutions/AU00000,,Supermarket and Grocery Stores,411
transaction,c61284c0-fdbb-428d-bcc3-573c54a97bc0,posted,BP JURIEN BAY 6082 JURIEN BAY AU,-268.50,49544383-c19c-4c97-b8d1-5322d0faa6af,-6474.06,debit,payment,AU00000,5453f0a3-083c-43c6-9086-adfe94df9918,,,2022-02-25T00:00:00Z,,https://au-api.basiq.io/users/11103cba-4a08-4397-84a5-22ac125ed2f6/transactions/c61284c0-fdbb-428d-bcc3-573c54a97bc0,https://au-api.basiq.io/users/11103cba-4a08-4397-84a5-22ac125ed2f6/accounts/49544383-c19c-4c97-b8d1-5322d0faa6af,https://au-api.basiq.io/institutions/AU00000,,Fuel Retailing,400
transaction,6d474495-4a5d-4f35-94ad-a0e04847d78d,posted,WOOLWORTHS 4328 GERA,-79.66,49544383-c19c-4c97-b8d1-5322d0faa6af,-6205.56,debit,payment,AU00000,5453f0a3-083c-43c6-9086-adfe94df9918,,,2022-02-23T00:00:00Z,,https://au-api.basiq.io/users/11103cba-4a08-4397-84a5-22ac125ed2f6/transactions/6d474495-4a5d-4f35-94ad-a0e04847d78d,https://au-api.basiq.io/users/11103cba-4a08-4397-84a5-22ac125ed2f6/accounts/49544383-c19c-4c97-b8d1-5322d0faa6af,https://au-api.basiq.io/institutions/AU00000,,Supermarket and Grocery Stores,411
transaction,61d28961-3532-435e-9880-a69560cac7f2,posted,INSTA GATOR PTY LTD GERALDTON WA AU,-21.81,49544383-c19c-4c97-b8d1-5322d0faa6af,-6125.90,debit,payment,AU00000,5453f0a3-083c-43c6-9086-adfe94df9918,,,2022-02-23T00:00:00Z,,https://au-api.basiq.io/users/11103cba-4a08-4397-84a5-22ac125ed2f6/transactions/61d28961-3532-435e-9880-a69560cac7f2,https://au-api.basiq.io/users/11103cba-4a08-4397-84a5-22ac125ed2f6/accounts/49544383-c19c-4c97-b8d1-5322d0faa6af,https://au-api.basiq.io/institutions/AU00000,,Specialised Food Retailing,412
transaction,ae881dbb-3a24-445c-99d0-f48f30689d16,posted,Jaffle Shack Gera,-83.00,49544383-c19c-4c97-b8d1-5322d0faa6af,-6104.09,debit,payment,AU00000,5453f0a3-083c-43c6-9086-adfe94df9918,,,2022-02-22T00:00:00Z,,https://au-api.basiq.io/users/11103cba-4a08-4397-84a5-22ac125ed2f6/transactions/ae881dbb-3a24-445c-99d0-f48f30689d16,https://au-api.basiq.io/users/11103cba-4a08-4397-84a5-22ac125ed2f6/accounts/49544383-c19c-4c97-b8d1-5322d0faa6af,https://au-api.basiq.io/institutions/AU00000,,"Cafes, Restaurants and Takeaway Food Services",451
transaction,942333cb-4de8-4930-b438-8166fed239df,posted,KALBARRI IGA KALB,-34.40,49544383-c19c-4c97-b8d1-5322d0faa6af,-6021.09,debit,payment,AU00000,5453f0a3-083c-43c6-9086-adfe94df9918,,,2022-02-22T00:00:00Z,,https://au-api.basiq.io/users/11103cba-4a08-4397-84a5-22ac125ed2f6/transactions/942333cb-4de8-4930-b438-8166fed239df,https://au-api.basiq.io/users/11103cba-4a08-4397-84a5-22ac125ed2f6/accounts/49544383-c19c-4c97-b8d1-5322d0faa6af,https://au-api.basiq.io/institutions/AU00000,,Supermarket and Grocery Stores,411
transaction,bac2ee90-d978-47bf-bbd3-89b705874f0f,posted,Geraldton Toyot56549 WEST END06 AU,-15.30,49544383-c19c-4c97-b8d1-5322d0faa6af,-5986.69,debit,payment,AU00000,5453f0a3-083c-43c6-9086-adfe94df9918,,,2022-02-22T00:00:00Z,,https://au-api.basiq.io/users/11103cba-4a08-4397-84a5-22ac125ed2f6/transactions/bac2ee90-d978-47bf-bbd3-89b705874f0f,https://au-api.basiq.io/users/11103cba-4a08-4397-84a5-22ac125ed2f6/accounts/49544383-c19c-4c97-b8d1-5322d0faa6af,https://au-api.basiq.io/institutions/AU00000,,Motor Vehicle and Motor Vehicle Parts Wholesaling,350
transaction,cb3c8844-6fc6-4040-9714-7cb774aa4663,posted,Salt Dish 214045 GERALDTON6 AU,-109.00,49544383-c19c-4c97-b8d1-5322d0faa6af,-5971.39,debit,payment,AU00000,5453f0a3-083c-43c6-9086-adfe94df9918,,,2022-02-22T00:00:00Z,,https://au-api.basiq.io/users/11103cba-4a08-4397-84a5-22ac125ed2f6/transactions/cb3c8844-6fc6-4040-9714-7cb774aa4663,https://au-api.basiq.io/users/11103cba-4a08-4397-84a5-22ac125ed2f6/accounts/49544383-c19c-4c97-b8d1-5322d0faa6af,https://au-api.basiq.io/institutions/AU00000,,"Cafes, Restaurants and Takeaway Food Services",451
transaction,559c8016-75c5-4515-81c4-e6a155af4fcf,posted,BELAIR GARDENS CARAV GERALDTON AU,-46.00,49544383-c19c-4c97-b8d1-5322d0faa6af,-5862.39,debit,payment,AU00000,5453f0a3-083c-43c6-9086-adfe94df9918,,,2022-02-22T00:00:00Z,,https://au-api.basiq.io/users/11103cba-4a08-4397-84a5-22ac125ed2f6/transactions/559c8016-75c5-4515-81c4-e6a155af4fcf,https://au-api.basiq.io/users/11103cba-4a08-4397-84a5-22ac125ed2f6/accounts/49544383-c19c-4c97-b8d1-5322d0faa6af,https://au-api.basiq.io/institutions/AU00000,,Accommodation,440
transaction,a96555e3-193b-44df-820b-8482ac85278c,posted,KALBARRI IGA KALB,-50.62,49544383-c19c-4c97-b8d1-5322d0faa6af,-5816.39,debit,payment,AU00000,5453f0a3-083c-43c6-9086-adfe94df9918,,,2022-02-21T00:00:00Z,,https://au-api.basiq.io/users/11103cba-4a08-4397-84a5-22ac125ed2f6/transactions/a96555e3-193b-44df-820b-8482ac85278c,https://au-api.basiq.io/users/11103cba-4a08-4397-84a5-22ac125ed2f6/accounts/49544383-c19c-4c97-b8d1-5322d0faa6af,https://au-api.basiq.io/institutions/AU00000,,Supermarket and Grocery Stores,411
transaction,cb73a463-277e-4655-ac45-dfbc4ceaf417,posted,KALBARRI MOTOR HOTEL KALB,-45.50,49544383-c19c-4c97-b8d1-5322d0faa6af,-5765.77,debit,payment,AU00000,5453f0a3-083c-43c6-9086-adfe94df9918,,,2022-02-21T00:00:00Z,,https://au-api.basiq.io/users/11103cba-4a08-4397-84a5-22ac125ed2f6/transactions/cb73a463-277e-4655-ac45-dfbc4ceaf417,https://au-api.basiq.io/users/11103cba-4a08-4397-84a5-22ac125ed2f6/accounts/49544383-c19c-4c97-b8d1-5322d0faa6af,https://au-api.basiq.io/institutions/AU00000,,Accommodation,440
transaction,00eba329-3c10-4b47-9ed1-a45e30ea58fd,posted,BELAIR GARDENS CARAV GERALDTON AU,-91.00,49544383-c19c-4c97-b8d1-5322d0faa6af,-5720.27,debit,payment,AU00000,5453f0a3-083c-43c6-9086-adfe94df9918,,,2022-02-20T00:00:00Z,,https://au-api.basiq.io/users/11103cba-4a08-4397-84a5-22ac125ed2f6/transactions/00eba329-3c10-4b47-9ed1-a45e30ea58fd,https://au-api.basiq.io/users/11103cba-4a08-4397-84a5-22ac125ed2f6/accounts/49544383-c19c-4c97-b8d1-5322d0faa6af,https://au-api.basiq.io/institutions/AU00000,,Accommodation,440
transaction,48e24bc9-28f4-4802-a4e0-1e64e04b01ea,posted,KALBARRI IGA KALBARRI AU,-18.35,49544383-c19c-4c97-b8d1-5322d0faa6af,-5629.27,debit,payment,AU00000,5453f0a3-083c-43c6-9086-adfe94df9918,,,2022-02-18T00:00:00Z,,https://au-api.basiq.io/users/11103cba-4a08-4397-84a5-22ac125ed2f6/transactions/48e24bc9-28f4-4802-a4e0-1e64e04b01ea,https://au-api.basiq.io/users/11103cba-4a08-4397-84a5-22ac125ed2f6/accounts/49544383-c19c-4c97-b8d1-5322d0faa6af,https://au-api.basiq.io/institutions/AU00000,,Supermarket and Grocery Stores,411
transaction,e9e519e7-8b52-4284-bb14-8863b3e40719,posted,KALBARRI MOTOR HOTEL KALBARRI AU,-60.99,49544383-c19c-4c97-b8d1-5322d0faa6af,-5610.92,debit,payment,AU00000,5453f0a3-083c-43c6-9086-adfe94df9918,,,2022-02-18T00:00:00Z,,https://au-api.basiq.io/users/11103cba-4a08-4397-84a5-22ac125ed2f6/transactions/e9e519e7-8b52-4284-bb14-8863b3e40719,https://au-api.basiq.io/users/11103cba-4a08-4397-84a5-22ac125ed2f6/accounts/49544383-c19c-4c97-b8d1-5322d0faa6af,https://au-api.basiq.io/institutions/AU00000,,Accommodation,440
transaction,61cd6f61-2a3e-4989-b102-15ba3f0fd7f3,posted,KALBARRI TUDOR CARAV AN KALBARRI AU,-175.00,49544383-c19c-4c97-b8d1-5322d0faa6af,-5549.93,debit,payment,AU00000,5453f0a3-083c-43c6-9086-adfe94df9918,,,2022-02-17T00:00:00Z,,https://au-api.basiq.io/users/11103cba-4a08-4397-84a5-22ac125ed2f6/transactions/61cd6f61-2a3e-4989-b102-15ba3f0fd7f3,https://au-api.basiq.io/users/11103cba-4a08-4397-84a5-22ac125ed2f6/accounts/49544383-c19c-4c97-b8d1-5322d0faa6af,https://au-api.basiq.io/institutions/AU00000,,Accommodation,440
transaction,d78c5c81-284b-4dcc-9da8-3ee97b3f08b7,posted,BILLABONG ROADHOUSE MEADOW AU,-53.40,49544383-c19c-4c97-b8d1-5322d0faa6af,-5374.93,debit,payment,AU00000,5453f0a3-083c-43c6-9086-adfe94df9918,,,2022-02-16T00:00:00Z,,https://au-api.basiq.io/users/11103cba-4a08-4397-84a5-22ac125ed2f6/transactions/d78c5c81-284b-4dcc-9da8-3ee97b3f08b7,https://au-api.basiq.io/users/11103cba-4a08-4397-84a5-22ac125ed2f6/accounts/49544383-c19c-4c97-b8d1-5322d0faa6af,https://au-api.basiq.io/institutions/AU00000,,Fuel Retailing,400
transaction,d3efcfb3-a398-4ba8-a23a-ee9af666ff90,posted,BILLABONG HOMESTEAD MEADOW AU,-93.00,49544383-c19c-4c97-b8d1-5322d0faa6af,-5321.53,debit,payment,AU00000,5453f0a3-083c-43c6-9086-adfe94df9918,,,2022-02-16T00:00:00Z,,https://au-api.basiq.io/users/11103cba-4a08-4397-84a5-22ac125ed2f6/transactions/d3efcfb3-a398-4ba8-a23a-ee9af666ff90,https://au-api.basiq.io/users/11103cba-4a08-4397-84a5-22ac125ed2f6/accounts/49544383-c19c-4c97-b8d1-5322d0faa6af,https://au-api.basiq.io/institutions/AU00000,,Accommodation,440
transaction,6b243746-ece0-44a1-a329-73c397032695,posted,OVERLANDER RDHSE6772 HAMELIN POOL AU,-324.12,49544383-c19c-4c97-b8d1-5322d0faa6af,-5228.53,debit,payment,AU00000,5453f0a3-083c-43c6-9086-adfe94df9918,,,2022-02-16T00:00:00Z,,https://au-api.basiq.io/users/11103cba-4a08-4397-84a5-22ac125ed2f6/transactions/6b243746-ece0-44a1-a329-73c397032695,https://au-api.basiq.io/users/11103cba-4a08-4397-84a5-22ac125ed2f6/accounts/49544383-c19c-4c97-b8d1-5322d0faa6af,https://au-api.basiq.io/institutions/AU00000,,Fuel Retailing,400
transaction,8de397a9-85db-41e4-8bcd-8a28aa9827ad,posted,NOODLE SUSHI AT GALLEON CCARN,-51.50,49544383-c19c-4c97-b8d1-5322d0faa6af,-4904.41,debit,payment,AU00000,5453f0a3-083c-43c6-9086-adfe94df9918,,,2022-02-15T00:00:00Z,,https://au-api.basiq.io/users/11103cba-4a08-4397-84a5-22ac125ed2f6/transactions/8de397a9-85db-41e4-8bcd-8a28aa9827ad,https://au-api.basiq.io/users/11103cba-4a08-4397-84a5-22ac125ed2f6/accounts/49544383-c19c-4c97-b8d1-5322d0faa6af,https://au-api.basiq.io/institutions/AU00000,,"Cafes, Restaurants and Takeaway Food Services",451
transaction,0775c62b-a2e4-4c29-8389-28470711d3c6,posted,PP*WOORAMEL CARN,-35.00,49544383-c19c-4c97-b8d1-5322d0faa6af,-4852.91,debit,payment,AU00000,5453f0a3-083c-43c6-9086-adfe94df9918,,,2022-02-15T00:00:00Z,,https://au-api.basiq.io/users/11103cba-4a08-4397-84a5-22ac125ed2f6/transactions/0775c62b-a2e4-4c29-8389-28470711d3c6,https://au-api.basiq.io/users/11103cba-4a08-4397-84a5-22ac125ed2f6/accounts/49544383-c19c-4c97-b8d1-5322d0faa6af,https://au-api.basiq.io/institutions/AU00000,,Accommodation,440
transaction,a64276ed-bc9e-49b7-a507-97f546f96838,posted,AMAZON AUST SERVICES MELB,-30.99,49544383-c19c-4c97-b8d1-5322d0faa6af,-4817.91,debit,payment,AU00000,5453f0a3-083c-43c6-9086-adfe94df9918,,,2022-02-15T00:00:00Z,,https://au-api.basiq.io/users/11103cba-4a08-4397-84a5-22ac125ed2f6/transactions/a64276ed-bc9e-49b7-a507-97f546f96838,https://au-api.basiq.io/users/11103cba-4a08-4397-84a5-22ac125ed2f6/accounts/49544383-c19c-4c97-b8d1-5322d0faa6af,https://au-api.basiq.io/institutions/AU00000,,Non-Store Retailing,431
transaction,4e8b48db-8efc-4cf7-aaaa-ca26ef352afa,posted,WOOLWORTHS 4610 CARN,-22.96,49544383-c19c-4c97-b8d1-5322d0faa6af,-4786.92,debit,payment,AU00000,5453f0a3-083c-43c6-9086-adfe94df9918,,,2022-02-15T00:00:00Z,,https://au-api.basiq.io/users/11103cba-4a08-4397-84a5-22ac125ed2f6/transactions/4e8b48db-8efc-4cf7-aaaa-ca26ef352afa,https://au-api.basiq.io/users/11103cba-4a08-4397-84a5-22ac125ed2f6/accounts/49544383-c19c-4c97-b8d1-5322d0faa6af,https://au-api.basiq.io/institutions/AU00000,,Supermarket and Grocery Stores,411
transaction,aed1d31a-6458-48e6-930a-7692b439cf85,posted,WOOLWORTHS 4610 CARN,-9.50,49544383-c19c-4c97-b8d1-5322d0faa6af,-4763.96,debit,payment,AU00000,5453f0a3-083c-43c6-9086-adfe94df9918,,,2022-02-15T00:00:00Z,,https://au-api.basiq.io/users/11103cba-4a08-4397-84a5-22ac125ed2f6/transactions/aed1d31a-6458-48e6-930a-7692b439cf85,https://au-api.basiq.io/users/11103cba-4a08-4397-84a5-22ac125ed2f6/accounts/49544383-c19c-4c97-b8d1-5322d0faa6af,https://au-api.basiq.io/institutions/AU00000,,Supermarket and Grocery Stores,411
transaction,e06f3395-67dc-44c9-8ab3-00aadd70f523,posted,AMAZON AUST SERVICES MELB,-8.99,49544383-c19c-4c97-b8d1-5322d0faa6af,-4754.46,debit,payment,AU00000,5453f0a3-083c-43c6-9086-adfe94df9918,,,2022-02-15T00:00:00Z,,https://au-api.basiq.io/users/11103cba-4a08-4397-84a5-22ac125ed2f6/transactions/e06f3395-67dc-44c9-8ab3-00aadd70f523,https://au-api.basiq.io/users/11103cba-4a08-4397-84a5-22ac125ed2f6/accounts/49544383-c19c-4c97-b8d1-5322d0faa6af,https://au-api.basiq.io/institutions/AU00000,,Non-Store Retailing,431
transaction,045b7e0b-8b9f-4832-ae30-9127ee2d2db9,posted,AMAZON AUST SERVICES MELB,-8.99,49544383-c19c-4c97-b8d1-5322d0faa6af,-4745.47,debit,payment,AU00000,5453f0a3-083c-43c6-9086-adfe94df9918,,,2022-02-15T00:00:00Z,,https://au-api.basiq.io/users/11103cba-4a08-4397-84a5-22ac125ed2f6/transactions/045b7e0b-8b9f-4832-ae30-9127ee2d2db9,https://au-api.basiq.io/users/11103cba-4a08-4397-84a5-22ac125ed2f6/accounts/49544383-c19c-4c97-b8d1-5322d0faa6af,https://au-api.basiq.io/institutions/AU00000,,Non-Store Retailing,431
transaction,6692ebaa-bae8-4fb4-b52c-2906a988afbf,posted,AMAZON AUST SERVICES MELB,-8.99,49544383-c19c-4c97-b8d1-5322d0faa6af,-4736.48,debit,payment,AU00000,5453f0a3-083c-43c6-9086-adfe94df9918,,,2022-02-15T00:00:00Z,,https://au-api.basiq.io/users/11103cba-4a08-4397-84a5-22ac125ed2f6/transactions/6692ebaa-bae8-4fb4-b52c-2906a988afbf,https://au-api.basiq.io/users/11103cba-4a08-4397-84a5-22ac125ed2f6/accounts/49544383-c19c-4c97-b8d1-5322d0faa6af,https://au-api.basiq.io/institutions/AU00000,,Non-Store Retailing,431
transaction,4cf5363c-d662-4630-b565-3b41b661faa9,posted,AMAZON AUST SERVICES MELB,-6.00,49544383-c19c-4c97-b8d1-5322d0faa6af,-4727.49,debit,payment,AU00000,5453f0a3-083c-43c6-9086-adfe94df9918,,,2022-02-15T00:00:00Z,,https://au-api.basiq.io/users/11103cba-4a08-4397-84a5-22ac125ed2f6/transactions/4cf5363c-d662-4630-b565-3b41b661faa9,https://au-api.basiq.io/users/11103cba-4a08-4397-84a5-22ac125ed2f6/accounts/49544383-c19c-4c97-b8d1-5322d0faa6af,https://au-api.basiq.io/institutions/AU00000,,Non-Store Retailing,431
transaction,7c15b034-0fa8-4ab0-b2b1-f85c26c8b55c,posted,SYDNEY WATER,-170.60,49544383-c19c-4c97-b8d1-5322d0faa6af,-4721.49,debit,payment,AU00000,5453f0a3-083c-43c6-9086-adfe94df9918,,,2022-02-14T00:00:00Z,,https://au-api.basiq.io/users/11103cba-4a08-4397-84a5-22ac125ed2f6/transactions/7c15b034-0fa8-4ab0-b2b1-f85c26c8b55c,https://au-api.basiq.io/users/11103cba-4a08-4397-84a5-22ac125ed2f6/accounts/49544383-c19c-4c97-b8d1-5322d0faa6af,https://au-api.basiq.io/institutions/AU00000,,"Water Supply, Sewerage and Drainage Services",281
transaction,2cf31f01-bb77-4fd7-a898-da1de0e80353,posted,MENAH PTY LTD CARNARVON AU,-33.50,49544383-c19c-4c97-b8d1-5322d0faa6af,-4550.89,debit,payment,AU00000,5453f0a3-083c-43c6-9086-adfe94df9918,,,2022-02-13T00:00:00Z,,https://au-api.basiq.io/users/11103cba-4a08-4397-84a5-22ac125ed2f6/transactions/2cf31f01-bb77-4fd7-a898-da1de0e80353,https://au-api.basiq.io/users/11103cba-4a08-4397-84a5-22ac125ed2f6/accounts/49544383-c19c-4c97-b8d1-5322d0faa6af,https://au-api.basiq.io/institutions/AU00000,,Accommodation,440
transaction,59e14fd8-fb70-4f4b-979a-cd4c3cb429c8,posted,WOOLWORTHS 4610 CARNARVON AU,-275.15,49544383-c19c-4c97-b8d1-5322d0faa6af,-4517.39,debit,payment,AU00000,5453f0a3-083c-43c6-9086-adfe94df9918,,,2022-02-13T00:00:00Z,,https://au-api.basiq.io/users/11103cba-4a08-4397-84a5-22ac125ed2f6/transactions/59e14fd8-fb70-4f4b-979a-cd4c3cb429c8,https://au-api.basiq.io/users/11103cba-4a08-4397-84a5-22ac125ed2f6/accounts/49544383-c19c-4c97-b8d1-5322d0faa6af,https://au-api.basiq.io/institutions/AU00000,,Supermarket and Grocery Stores,411
transaction,97514160-84bd-4a72-b48b-e3bfbf59b646,posted,TROPICS HARDWARE SUP CARNARVON AU,-249.25,49544383-c19c-4c97-b8d1-5322d0faa6af,-4242.24,debit,payment,AU00000,5453f0a3-083c-43c6-9086-adfe94df9918,,,2022-02-12T00:00:00Z,,https://au-api.basiq.io/users/11103cba-4a08-4397-84a5-22ac125ed2f6/transactions/97514160-84bd-4a72-b48b-e3bfbf59b646,https://au-api.basiq.io/users/11103cba-4a08-4397-84a5-22ac125ed2f6/accounts/49544383-c19c-4c97-b8d1-5322d0faa6af,https://au-api.basiq.io/institutions/AU00000,,"Furniture, Floor Coverings, Houseware and Textile Goods Retailing",421
transaction,9a5beafa-7a67-454c-b0b7-98b9266d0fae,posted,OUTBACK OASIS CARAV CARNARVON AU,-38.00,49544383-c19c-4c97-b8d1-5322d0faa6af,-3992.99,debit,payment,AU00000,5453f0a3-083c-43c6-9086-adfe94df9918,,,2022-02-12T00:00:00Z,,https://au-api.basiq.io/users/11103cba-4a08-4397-84a5-22ac125ed2f6/transactions/9a5beafa-7a67-454c-b0b7-98b9266d0fae,https://au-api.basiq.io/users/11103cba-4a08-4397-84a5-22ac125ed2f6/accounts/49544383-c19c-4c97-b8d1-5322d0faa6af,https://au-api.basiq.io/institutions/AU00000,,Accommodation,440
transaction,44c895e7-c133-4294-826e-a07f7a6bf67d,posted,TICKET SOLUTIONS-OZTIX WOOL,-83.70,49544383-c19c-4c97-b8d1-5322d0faa6af,-3954.99,debit,payment,AU00000,5453f0a3-083c-43c6-9086-adfe94df9918,,,2022-02-10T00:00:00Z,,https://au-api.basiq.io/users/11103cba-4a08-4397-84a5-22ac125ed2f6/transactions/44c895e7-c133-4294-826e-a07f7a6bf67d,https://au-api.basiq.io/users/11103cba-4a08-4397-84a5-22ac125ed2f6/accounts/49544383-c19c-4c97-b8d1-5322d0faa6af,https://au-api.basiq.io/institutions/AU00000,,Unknown,0
transaction,1c67beb1-aaa8-4abd-922d-d7fcc7a4da5c,posted,KI SeaLink *2KK6NC seal,-522.71,49544383-c19c-4c97-b8d1-5322d0faa6af,-3871.29,debit,payment,AU00000,5453f0a3-083c-43c6-9086-adfe94df9918,,,2022-02-09T00:00:00Z,,https://au-api.basiq.io/users/11103cba-4a08-4397-84a5-22ac125ed2f6/transactions/1c67beb1-aaa8-4abd-922d-d7fcc7a4da5c,https://au-api.basiq.io/users/11103cba-4a08-4397-84a5-22ac125ed2f6/accounts/49544383-c19c-4c97-b8d1-5322d0faa6af,https://au-api.basiq.io/institutions/AU00000,,Road Passenger Transport,462
transaction,7a389d8c-b5b5-4996-a37c-3c82ab5530c1,posted,WOOLWORTHS 4610 CARN,-300.89,49544383-c19c-4c97-b8d1-5322d0faa6af,-3348.58,debit,payment,AU00000,5453f0a3-083c-43c6-9086-adfe94df9918,,,2022-02-09T00:00:00Z,,https://au-api.basiq.io/users/11103cba-4a08-4397-84a5-22ac125ed2f6/transactions/7a389d8c-b5b5-4996-a37c-3c82ab5530c1,https://au-api.basiq.io/users/11103cba-4a08-4397-84a5-22ac125ed2f6/accounts/49544383-c19c-4c97-b8d1-5322d0faa6af,https://au-api.basiq.io/institutions/AU00000,,Supermarket and Grocery Stores,411
transaction,f427fa75-efe7-4d52-9f4a-f82711510ee8,posted,CVAN PARK BODD,-71.00,49544383-c19c-4c97-b8d1-5322d0faa6af,-3047.69,debit,payment,AU00000,5453f0a3-083c-43c6-9086-adfe94df9918,,,2022-02-09T00:00:00Z,,https://au-api.basiq.io/users/11103cba-4a08-4397-84a5-22ac125ed2f6/transactions/f427fa75-efe7-4d52-9f4a-f82711510ee8,https://au-api.basiq.io/users/11103cba-4a08-4397-84a5-22ac125ed2f6/accounts/49544383-c19c-4c97-b8d1-5322d0faa6af,https://au-api.basiq.io/institutions/AU00000,,Accommodation,440
transaction,fb8dc461-7430-4f17-8343-571c2712648f,posted,QUOBBA STATION CARNARVON AU,-71.00,49544383-c19c-4c97-b8d1-5322d0faa6af,-2976.69,debit,payment,AU00000,5453f0a3-083c-43c6-9086-adfe94df9918,,,2022-02-09T00:00:00Z,,https://au-api.basiq.io/users/11103cba-4a08-4397-84a5-22ac125ed2f6/transactions/fb8dc461-7430-4f17-8343-571c2712648f,https://au-api.basiq.io/users/11103cba-4a08-4397-84a5-22ac125ed2f6/accounts/49544383-c19c-4c97-b8d1-5322d0faa6af,https://au-api.basiq.io/institutions/AU00000,,Accommodation,440
transaction,55942986-758e-4119-a3ed-aedfe9da5d2a,posted,Cash Wdr  CARNARVON    WA,-303.00,49544383-c19c-4c97-b8d1-5322d0faa6af,-2905.69,debit,cash-withdrawal,AU00000,5453f0a3-083c-43c6-9086-adfe94df9918,,,2022-02-09T00:00:00Z,,https://au-api.basiq.io/users/11103cba-4a08-4397-84a5-22ac125ed2f6/transactions/55942986-758e-4119-a3ed-aedfe9da5d2a,https://au-api.basiq.io/users/11103cba-4a08-4397-84a5-22ac125ed2f6/accounts/49544383-c19c-4c97-b8d1-5322d0faa6af,https://au-api.basiq.io/institutions/AU00000,,,
transaction,12c94509-292e-450e-abe9-5d964830a7f8,posted,CALTEX STAR MART CAR CARNARVON AU,-206.14,49544383-c19c-4c97-b8d1-5322d0faa6af,-2602.69,debit,payment,AU00000,5453f0a3-083c-43c6-9086-adfe94df9918,,,2022-02-09T00:00:00Z,,https://au-api.basiq.io/users/11103cba-4a08-4397-84a5-22ac125ed2f6/transactions/12c94509-292e-450e-abe9-5d964830a7f8,https://au-api.basiq.io/users/11103cba-4a08-4397-84a5-22ac125ed2f6/accounts/49544383-c19c-4c97-b8d1-5322d0faa6af,https://au-api.basiq.io/institutions/AU00000,,Fuel Retailing,400
transaction,20a95637-ba89-4cdf-bfec-4efc86b4b19a,posted,WOOLWORTHS 4610 CARNARVON AU,-63.00,49544383-c19c-4c97-b8d1-5322d0faa6af,-2396.55,debit,payment,AU00000,5453f0a3-083c-43c6-9086-adfe94df9918,,,2022-02-08T00:00:00Z,,https://au-api.basiq.io/users/11103cba-4a08-4397-84a5-22ac125ed2f6/transactions/20a95637-ba89-4cdf-bfec-4efc86b4b19a,https://au-api.basiq.io/users/11103cba-4a08-4397-84a5-22ac125ed2f6/accounts/49544383-c19c-4c97-b8d1-5322d0faa6af,https://au-api.basiq.io/institutions/AU00000,,Supermarket and Grocery Stores,411
transaction,1c3502ca-d379-4d2f-85f3-6539df8c3866,posted,WOOLWORTHS 4610 CARNARVON AU,-63.00,49544383-c19c-4c97-b8d1-5322d0faa6af,-2333.55,debit,payment,AU00000,5453f0a3-083c-43c6-9086-adfe94df9918,,,2022-02-08T00:00:00Z,,https://au-api.basiq.io/users/11103cba-4a08-4397-84a5-22ac125ed2f6/transactions/1c3502ca-d379-4d2f-85f3-6539df8c3866,https://au-api.basiq.io/users/11103cba-4a08-4397-84a5-22ac125ed2f6/accounts/49544383-c19c-4c97-b8d1-5322d0faa6af,https://au-api.basiq.io/institutions/AU00000,,Supermarket and Grocery Stores,411
transaction,966bfc43-7e87-491a-a277-5c36af08263b,posted,WOOLWORTHS 4610 CARNARVON AU,-63.00,49544383-c19c-4c97-b8d1-5322d0faa6af,-2270.55,debit,payment,AU00000,5453f0a3-083c-43c6-9086-adfe94df9918,,,2022-02-08T00:00:00Z,,https://au-api.basiq.io/users/11103cba-4a08-4397-84a5-22ac125ed2f6/transactions/966bfc43-7e87-491a-a277-5c36af08263b,https://au-api.basiq.io/users/11103cba-4a08-4397-84a5-22ac125ed2f6/accounts/49544383-c19c-4c97-b8d1-5322d0faa6af,https://au-api.basiq.io/institutions/AU00000,,Supermarket and Grocery Stores,411
transaction,12dc149b-16c3-4f04-b9a3-499e40f04cd3,posted,WOOLWORTHS 4610 CARNARVON AU,-63.00,49544383-c19c-4c97-b8d1-5322d0faa6af,-2207.55,debit,payment,AU00000,5453f0a3-083c-43c6-9086-adfe94df9918,,,2022-02-08T00:00:00Z,,https://au-api.basiq.io/users/11103cba-4a08-4397-84a5-22ac125ed2f6/transactions/12dc149b-16c3-4f04-b9a3-499e40f04cd3,https://au-api.basiq.io/users/11103cba-4a08-4397-84a5-22ac125ed2f6/accounts/49544383-c19c-4c97-b8d1-5322d0faa6af,https://au-api.basiq.io/institutions/AU00000,,Supermarket and Grocery Stores,411
transaction,58c5aff6-0da0-43f8-bd6a-00a37269f4e6,posted,OUTBACK OASIS CARAV CARNARVON AU,-38.00,49544383-c19c-4c97-b8d1-5322d0faa6af,-2144.55,debit,payment,AU00000,5453f0a3-083c-43c6-9086-adfe94df9918,,,2022-02-08T00:00:00Z,,https://au-api.basiq.io/users/11103cba-4a08-4397-84a5-22ac125ed2f6/transactions/58c5aff6-0da0-43f8-bd6a-00a37269f4e6,https://au-api.basiq.io/users/11103cba-4a08-4397-84a5-22ac125ed2f6/accounts/49544383-c19c-4c97-b8d1-5322d0faa6af,https://au-api.basiq.io/institutions/AU00000,,Accommodation,440
transaction,662e2221-4754-4fc6-bc80-66867a2cc244,posted,NOR WEST SURF STORE CARNARVON WA AU,-21.00,49544383-c19c-4c97-b8d1-5322d0faa6af,-2106.55,debit,payment,AU00000,5453f0a3-083c-43c6-9086-adfe94df9918,,,2022-02-08T00:00:00Z,,https://au-api.basiq.io/users/11103cba-4a08-4397-84a5-22ac125ed2f6/transactions/662e2221-4754-4fc6-bc80-66867a2cc244,https://au-api.basiq.io/users/11103cba-4a08-4397-84a5-22ac125ed2f6/accounts/49544383-c19c-4c97-b8d1-5322d0faa6af,https://au-api.basiq.io/institutions/AU00000,,Recreational Goods Retailing,424
transaction,84c2d97b-3edd-4851-b698-8aabdfea1bbb,posted,OUTBACK OASIS CARAV CARNARVON AU,-46.00,49544383-c19c-4c97-b8d1-5322d0faa6af,-2085.55,debit,payment,AU00000,5453f0a3-083c-43c6-9086-adfe94df9918,,,2022-02-07T00:00:00Z,,https://au-api.basiq.io/users/11103cba-4a08-4397-84a5-22ac125ed2f6/transactions/84c2d97b-3edd-4851-b698-8aabdfea1bbb,https://au-api.basiq.io/users/11103cba-4a08-4397-84a5-22ac125ed2f6/accounts/49544383-c19c-4c97-b8d1-5322d0faa6af,https://au-api.basiq.io/institutions/AU00000,,Accommodation,440
transaction,1e408303-654b-4e71-9743-cfd0c55ab45e,posted,CORAL BAY INVESTMENT CORAL BAY WA AU,-59.00,49544383-c19c-4c97-b8d1-5322d0faa6af,-2039.55,debit,payment,AU00000,5453f0a3-083c-43c6-9086-adfe94df9918,,,2022-02-06T00:00:00Z,,https://au-api.basiq.io/users/11103cba-4a08-4397-84a5-22ac125ed2f6/transactions/1e408303-654b-4e71-9743-cfd0c55ab45e,https://au-api.basiq.io/users/11103cba-4a08-4397-84a5-22ac125ed2f6/accounts/49544383-c19c-4c97-b8d1-5322d0faa6af,https://au-api.basiq.io/institutions/AU00000,,Accommodation,440
transaction,aada3114-0b37-4984-b19f-8ceb598422bf,posted,FINS CAFE CORAL BAY WA AU,-143.00,49544383-c19c-4c97-b8d1-5322d0faa6af,-1980.55,debit,payment,AU00000,5453f0a3-083c-43c6-9086-adfe94df9918,,,2022-02-05T00:00:00Z,,https://au-api.basiq.io/users/11103cba-4a08-4397-84a5-22ac125ed2f6/transactions/aada3114-0b37-4984-b19f-8ceb598422bf,https://au-api.basiq.io/users/11103cba-4a08-4397-84a5-22ac125ed2f6/accounts/49544383-c19c-4c97-b8d1-5322d0faa6af,https://au-api.basiq.io/institutions/AU00000,,"Cafes, Restaurants and Takeaway Food Services",451
transaction,7cdaffe8-8489-4311-a320-ae93a5d9cd9e,posted,CORAL BAY INVESTMENT CORAL BAY WA AU,-59.00,49544383-c19c-4c97-b8d1-5322d0faa6af,-1837.55,debit,payment,AU00000,5453f0a3-083c-43c6-9086-adfe94df9918,,,2022-02-05T00:00:00Z,,https://au-api.basiq.io/users/11103cba-4a08-4397-84a5-22ac125ed2f6/transactions/7cdaffe8-8489-4311-a320-ae93a5d9cd9e,https://au-api.basiq.io/users/11103cba-4a08-4397-84a5-22ac125ed2f6/accounts/49544383-c19c-4c97-b8d1-5322d0faa6af,https://au-api.basiq.io/institutions/AU00000,,Accommodation,440
transaction,d0b2f3b6-ae2c-4a30-8f14-6b4fdecb3340,posted,ROBAL PTY LTD EXMO,-65.90,49544383-c19c-4c97-b8d1-5322d0faa6af,-1778.55,debit,payment,AU00000,5453f0a3-083c-43c6-9086-adfe94df9918,,,2022-02-04T00:00:00Z,,https://au-api.basiq.io/users/11103cba-4a08-4397-84a5-22ac125ed2f6/transactions/d0b2f3b6-ae2c-4a30-8f14-6b4fdecb3340,https://au-api.basiq.io/users/11103cba-4a08-4397-84a5-22ac125ed2f6/accounts/49544383-c19c-4c97-b8d1-5322d0faa6af,https://au-api.basiq.io/institutions/AU00000,,Recreational Goods Retailing,424
transaction,4ff84e27-3445-45af-aaa9-a40d3a6318fc,posted,EXMOUTH IGA EXMO,-43.05,49544383-c19c-4c97-b8d1-5322d0faa6af,-1712.65,debit,payment,AU00000,5453f0a3-083c-43c6-9086-adfe94df9918,,,2022-02-04T00:00:00Z,,https://au-api.basiq.io/users/11103cba-4a08-4397-84a5-22ac125ed2f6/transactions/4ff84e27-3445-45af-aaa9-a40d3a6318fc,https://au-api.basiq.io/users/11103cba-4a08-4397-84a5-22ac125ed2f6/accounts/49544383-c19c-4c97-b8d1-5322d0faa6af,https://au-api.basiq.io/institutions/AU00000,,Supermarket and Grocery Stores,411
transaction,b824d081-6063-4cd1-b7b4-b4883239a4f6,posted,POST EXMOUTH LPO EXMO,-21.45,49544383-c19c-4c97-b8d1-5322d0faa6af,-1669.60,debit,payment,AU00000,5453f0a3-083c-43c6-9086-adfe94df9918,,,2022-02-04T00:00:00Z,,https://au-api.basiq.io/users/11103cba-4a08-4397-84a5-22ac125ed2f6/transactions/b824d081-6063-4cd1-b7b4-b4883239a4f6,https://au-api.basiq.io/users/11103cba-4a08-4397-84a5-22ac125ed2f6/accounts/49544383-c19c-4c97-b8d1-5322d0faa6af,https://au-api.basiq.io/institutions/AU00000,,Postal and Courier Pick-up and Delivery Services,510
transaction,d1d39df8-fc87-4754-afa3-027d1a3ec0a1,posted,NINGALOO IGA X PRESS EXMO,-8.06,49544383-c19c-4c97-b8d1-5322d0faa6af,-1648.15,debit,payment,AU00000,5453f0a3-083c-43c6-9086-adfe94df9918,,,2022-02-04T00:00:00Z,,https://au-api.basiq.io/users/11103cba-4a08-4397-84a5-22ac125ed2f6/transactions/d1d39df8-fc87-4754-afa3-027d1a3ec0a1,https://au-api.basiq.io/users/11103cba-4a08-4397-84a5-22ac125ed2f6/accounts/49544383-c19c-4c97-b8d1-5322d0faa6af,https://au-api.basiq.io/institutions/AU00000,,Supermarket and Grocery Stores,411
transaction,98783fca-ecba-4d70-896a-194b6c583ab3,posted,WESTCOAST VENTURES CORAL BAY AU,-211.00,49544383-c19c-4c97-b8d1-5322d0faa6af,-1640.09,debit,payment,AU00000,5453f0a3-083c-43c6-9086-adfe94df9918,,,2022-02-04T00:00:00Z,,https://au-api.basiq.io/users/11103cba-4a08-4397-84a5-22ac125ed2f6/transactions/98783fca-ecba-4d70-896a-194b6c583ab3,https://au-api.basiq.io/users/11103cba-4a08-4397-84a5-22ac125ed2f6/accounts/49544383-c19c-4c97-b8d1-5322d0faa6af,https://au-api.basiq.io/institutions/AU00000,,Amusement and Other Recreation Activities,913
transaction,479ae913-5bce-44ef-9981-d109e6b42245,posted,POST EXMOUTH LPO EXMO,-27.50,49544383-c19c-4c97-b8d1-5322d0faa6af,-1429.09,debit,payment,AU00000,5453f0a3-083c-43c6-9086-adfe94df9918,,,2022-02-03T00:00:00Z,,https://au-api.basiq.io/users/11103cba-4a08-4397-84a5-22ac125ed2f6/transactions/479ae913-5bce-44ef-9981-d109e6b42245,https://au-api.basiq.io/users/11103cba-4a08-4397-84a5-22ac125ed2f6/accounts/49544383-c19c-4c97-b8d1-5322d0faa6af,https://au-api.basiq.io/institutions/AU00000,,Postal and Courier Pick-up and Delivery Services,510
transaction,3261cfbb-b2ab-44cf-8a89-ef8f77e363d3,posted,CORAL BAY CHARTER CORAL BAY WA AU,-151.00,49544383-c19c-4c97-b8d1-5322d0faa6af,-1401.59,debit,payment,AU00000,5453f0a3-083c-43c6-9086-adfe94df9918,,,2022-02-03T00:00:00Z,,https://au-api.basiq.io/users/11103cba-4a08-4397-84a5-22ac125ed2f6/transactions/3261cfbb-b2ab-44cf-8a89-ef8f77e363d3,https://au-api.basiq.io/users/11103cba-4a08-4397-84a5-22ac125ed2f6/accounts/49544383-c19c-4c97-b8d1-5322d0faa6af,https://au-api.basiq.io/institutions/AU00000,,Museum Operation,891
transaction,3a16ebde-5983-4357-b96b-a52ca5412dfc,posted,CORAL BAY INVESTMENT CORAL BAY WA AU,-117.00,49544383-c19c-4c97-b8d1-5322d0faa6af,-1250.59,debit,payment,AU00000,5453f0a3-083c-43c6-9086-adfe94df9918,,,2022-02-03T00:00:00Z,,https://au-api.basiq.io/users/11103cba-4a08-4397-84a5-22ac125ed2f6/transactions/3a16ebde-5983-4357-b96b-a52ca5412dfc,https://au-api.basiq.io/users/11103cba-4a08-4397-84a5-22ac125ed2f6/accounts/49544383-c19c-4c97-b8d1-5322d0faa6af,https://au-api.basiq.io/institutions/AU00000,,Accommodation,440
transaction,14ff5df2-6589-4bee-9f62-f9b42875bddd,posted,DIVE NINGALOO EXMO,-201.00,49544383-c19c-4c97-b8d1-5322d0faa6af,-1133.59,debit,payment,AU00000,5453f0a3-083c-43c6-9086-adfe94df9918,,,2022-02-02T00:00:00Z,,https://au-api.basiq.io/users/11103cba-4a08-4397-84a5-22ac125ed2f6/transactions/14ff5df2-6589-4bee-9f62-f9b42875bddd,https://au-api.basiq.io/users/11103cba-4a08-4397-84a5-22ac125ed2f6/accounts/49544383-c19c-4c97-b8d1-5322d0faa6af,https://au-api.basiq.io/institutions/AU00000,,Amusement and Other Recreation Activities,913
transaction,1f18ca07-1833-4157-8451-9fb360c114f1,posted,BREZEWITHEZ GIFTWRE EXMOUTH,-92.00,49544383-c19c-4c97-b8d1-5322d0faa6af,-932.59,debit,payment,AU00000,5453f0a3-083c-43c6-9086-adfe94df9918,,,2022-02-02T00:00:00Z,,https://au-api.basiq.io/users/11103cba-4a08-4397-84a5-22ac125ed2f6/transactions/1f18ca07-1833-4157-8451-9fb360c114f1,https://au-api.basiq.io/users/11103cba-4a08-4397-84a5-22ac125ed2f6/accounts/49544383-c19c-4c97-b8d1-5322d0faa6af,https://au-api.basiq.io/institutions/AU00000,,Pharmaceutical and Other Store-Based Retailing,427
transaction,42395956-4a9e-4a86-86c7-5ee78f3f1266,posted,NINGALOO IGA X PRESS EXMO,-71.91,49544383-c19c-4c97-b8d1-5322d0faa6af,-840.59,debit,payment,AU00000,5453f0a3-083c-43c6-9086-adfe94df9918,,,2022-02-02T00:00:00Z,,https://au-api.basiq.io/users/11103cba-4a08-4397-84a5-22ac125ed2f6/transactions/42395956-4a9e-4a86-86c7-5ee78f3f1266,https://au-api.basiq.io/users/11103cba-4a08-4397-84a5-22ac125ed2f6/accounts/49544383-c19c-4c97-b8d1-5322d0faa6af,https://au-api.basiq.io/institutions/AU00000,,Supermarket and Grocery Stores,411
transaction,db6fd53e-4849-4745-bb15-d2e3136dc754,posted,REFUND  02/10,201.00,49544383-c19c-4c97-b8d1-5322d0faa6af,-768.68,credit,refund,AU00000,5453f0a3-083c-43c6-9086-adfe94df9918,,,2022-02-02T00:00:00Z,,https://au-api.basiq.io/users/11103cba-4a08-4397-84a5-22ac125ed2f6/transactions/db6fd53e-4849-4745-bb15-d2e3136dc754,https://au-api.basiq.io/users/11103cba-4a08-4397-84a5-22ac125ed2f6/accounts/49544383-c19c-4c97-b8d1-5322d0faa6af,https://au-api.basiq.io/institutions/AU00000,,,
transaction,ee3d981d-cbfb-4a0f-a6cd-f63409dd581b,posted,THE BBQ FATHER EXMOUTH WA AU,-154.00,49544383-c19c-4c97-b8d1-5322d0faa6af,-969.68,debit,payment,AU00000,5453f0a3-083c-43c6-9086-adfe94df9918,,,2022-02-02T00:00:00Z,,https://au-api.basiq.io/users/11103cba-4a08-4397-84a5-22ac125ed2f6/transactions/ee3d981d-cbfb-4a0f-a6cd-f63409dd581b,https://au-api.basiq.io/users/11103cba-4a08-4397-84a5-22ac125ed2f6/accounts/49544383-c19c-4c97-b8d1-5322d0faa6af,https://au-api.basiq.io/institutions/AU00000,,"Cafes, Restaurants and Takeaway Food Services",451
transaction,c3ae1876-4bcd-43d3-8194-3bea8736f48b,posted,BRUMBYS EXMOUTH EXMOUTH WA AU,-50.60,49544383-c19c-4c97-b8d1-5322d0faa6af,-815.68,debit,payment,AU00000,5453f0a3-083c-43c6-9086-adfe94df9918,,,2022-02-02T00:00:00Z,,https://au-api.basiq.io/users/11103cba-4a08-4397-84a5-22ac125ed2f6/transactions/c3ae1876-4bcd-43d3-8194-3bea8736f48b,https://au-api.basiq.io/users/11103cba-4a08-4397-84a5-22ac125ed2f6/accounts/49544383-c19c-4c97-b8d1-5322d0faa6af,https://au-api.basiq.io/institutions/AU00000,,Bakery Product Manufacturing,117
transaction,34f6e2aa-da12-49c3-b385-6573c2830e1a,posted,NINGALOO CVAN & RSRT EXMOUTH WA AU,-61.00,49544383-c19c-4c97-b8d1-5322d0faa6af,-765.08,debit,payment,AU00000,5453f0a3-083c-43c6-9086-adfe94df9918,,,2022-02-02T00:00:00Z,,https://au-api.basiq.io/users/11103cba-4a08-4397-84a5-22ac125ed2f6/transactions/34f6e2aa-da12-49c3-b385-6573c2830e1a,https://au-api.basiq.io/users/11103cba-4a08-4397-84a5-22ac125ed2f6/accounts/49544383-c19c-4c97-b8d1-5322d0faa6af,https://au-api.basiq.io/institutions/AU00000,,Accommodation,440
transaction,187a8e82-4fbf-4840-a139-b86aff6db6b4,posted,AAMI BRIS,-555.18,49544383-c19c-4c97-b8d1-5322d0faa6af,-704.08,debit,payment,AU00000,5453f0a3-083c-43c6-9086-adfe94df9918,,,2022-02-01T00:00:00Z,,https://au-api.basiq.io/users/11103cba-4a08-4397-84a5-22ac125ed2f6/transactions/187a8e82-4fbf-4840-a139-b86aff6db6b4,https://au-api.basiq.io/users/11103cba-4a08-4397-84a5-22ac125ed2f6/accounts/49544383-c19c-4c97-b8d1-5322d0faa6af,https://au-api.basiq.io/institutions/AU00000,,Health and General Insurance,632
transaction,a0419abe-fbf2-41ec-8318-10b8fd797961,posted,AAMI BRIS,-473.88,49544383-c19c-4c97-b8d1-5322d0faa6af,-148.90,debit,payment,AU00000,5453f0a3-083c-43c6-9086-adfe94df9918,,,2022-02-01T00:00:00Z,,https://au-api.basiq.io/users/11103cba-4a08-4397-84a5-22ac125ed2f6/transactions/a0419abe-fbf2-41ec-8318-10b8fd797961,https://au-api.basiq.io/users/11103cba-4a08-4397-84a5-22ac125ed2f6/accounts/49544383-c19c-4c97-b8d1-5322d0faa6af,https://au-api.basiq.io/institutions/AU00000,,Health and General Insurance,632
transaction,248c7b24-44b9-45ff-ab2c-9796a9c693cd,posted,EXMOUTH HOLIDAY PARK EXMOUTH,-53.20,49544383-c19c-4c97-b8d1-5322d0faa6af,324.98,debit,payment,AU00000,5453f0a3-083c-43c6-9086-adfe94df9918,,,2022-02-01T00:00:00Z,,https://au-api.basiq.io/users/11103cba-4a08-4397-84a5-22ac125ed2f6/transactions/248c7b24-44b9-45ff-ab2c-9796a9c693cd,https://au-api.basiq.io/users/11103cba-4a08-4397-84a5-22ac125ed2f6/accounts/49544383-c19c-4c97-b8d1-5322d0faa6af,https://au-api.basiq.io/institutions/AU00000,,Accommodation,440
transaction,394b6bc6-e248-44bd-85d1-432a2523bffe,posted,DEPT OF PARKS/WILDLIFE KENS,-49.80,49544383-c19c-4c97-b8d1-5322d0faa6af,378.18,debit,payment,AU00000,5453f0a3-083c-43c6-9086-adfe94df9918,,,2022-02-01T00:00:00Z,,https://au-api.basiq.io/users/11103cba-4a08-4397-84a5-22ac125ed2f6/transactions/394b6bc6-e248-44bd-85d1-432a2523bffe,https://au-api.basiq.io/users/11103cba-4a08-4397-84a5-22ac125ed2f6/accounts/49544383-c19c-4c97-b8d1-5322d0faa6af,https://au-api.basiq.io/institutions/AU00000,,Regulatory Services,772
transaction,07f52197-b0ef-4297-ad94-0c0a3e5b3c15,posted,NINGALOO IGA X PRESS EXMO,-43.20,49544383-c19c-4c97-b8d1-5322d0faa6af,427.98,debit,payment,AU00000,5453f0a3-083c-43c6-9086-adfe94df9918,,,2022-02-01T00:00:00Z,,https://au-api.basiq.io/users/11103cba-4a08-4397-84a5-22ac125ed2f6/transactions/07f52197-b0ef-4297-ad94-0c0a3e5b3c15,https://au-api.basiq.io/users/11103cba-4a08-4397-84a5-22ac125ed2f6/accounts/49544383-c19c-4c97-b8d1-5322d0faa6af,https://au-api.basiq.io/institutions/AU00000,,Supermarket and Grocery Stores,411
transaction,c5c9985f-28e0-4c86-a264-4740d321a6be,posted,BRUMBYS EXMOUTH EXMO,-29.90,49544383-c19c-4c97-b8d1-5322d0faa6af,471.18,debit,payment,AU00000,5453f0a3-083c-43c6-9086-adfe94df9918,,,2022-02-01T00:00:00Z,,https://au-api.basiq.io/users/11103cba-4a08-4397-84a5-22ac125ed2f6/transactions/c5c9985f-28e0-4c86-a264-4740d321a6be,https://au-api.basiq.io/users/11103cba-4a08-4397-84a5-22ac125ed2f6/accounts/49544383-c19c-4c97-b8d1-5322d0faa6af,https://au-api.basiq.io/institutions/AU00000,,Bakery Product Manufacturing,117
transaction,426dc690-c5b9-4d67-a3b2-27f913c764be,posted,EXMOUTH IGA EXMO,-18.19,49544383-c19c-4c97-b8d1-5322d0faa6af,501.08,debit,payment,AU00000,5453f0a3-083c-43c6-9086-adfe94df9918,,,2022-02-01T00:00:00Z,,https://au-api.basiq.io/users/11103cba-4a08-4397-84a5-22ac125ed2f6/transactions/426dc690-c5b9-4d67-a3b2-27f913c764be,https://au-api.basiq.io/users/11103cba-4a08-4397-84a5-22ac125ed2f6/accounts/49544383-c19c-4c97-b8d1-5322d0faa6af,https://au-api.basiq.io/institutions/AU00000,,Supermarket and Grocery Stores,411
transaction,de393588-811e-41a5-9bbb-789707020b49,posted,EXMOUTH MEAT SUPPLY EXMO,-18.15,49544383-c19c-4c97-b8d1-5322d0faa6af,519.27,debit,payment,AU00000,5453f0a3-083c-43c6-9086-adfe94df9918,,,2022-02-01T00:00:00Z,,https://au-api.basiq.io/users/11103cba-4a08-4397-84a5-22ac125ed2f6/transactions/de393588-811e-41a5-9bbb-789707020b49,https://au-api.basiq.io/users/11103cba-4a08-4397-84a5-22ac125ed2f6/accounts/49544383-c19c-4c97-b8d1-5322d0faa6af,https://au-api.basiq.io/institutions/AU00000,,Specialised Food Retailing,412
transaction,be48ba9d-79f9-49a1-a068-c740d5c674ee,posted,BRUMBYS EXMOUTH EXMO,-17.40,49544383-c19c-4c97-b8d1-5322d0faa6af,537.42,debit,payment,AU00000,5453f0a3-083c-43c6-9086-adfe94df9918,,,2022-02-01T00:00:00Z,,https://au-api.basiq.io/users/11103cba-4a08-4397-84a5-22ac125ed2f6/transactions/be48ba9d-79f9-49a1-a068-c740d5c674ee,https://au-api.basiq.io/users/11103cba-4a08-4397-84a5-22ac125ed2f6/accounts/49544383-c19c-4c97-b8d1-5322d0faa6af,https://au-api.basiq.io/institutions/AU00000,,Bakery Product Manufacturing,117
transaction,48cb38fd-b031-4e9e-9e57-48dc0201ebf7,posted,BRUMBYS EXMOUTH EXMO,-16.40,49544383-c19c-4c97-b8d1-5322d0faa6af,554.82,debit,payment,AU00000,5453f0a3-083c-43c6-9086-adfe94df9918,,,2022-02-01T00:00:00Z,,https://au-api.basiq.io/users/11103cba-4a08-4397-84a5-22ac125ed2f6/transactions/48cb38fd-b031-4e9e-9e57-48dc0201ebf7,https://au-api.basiq.io/users/11103cba-4a08-4397-84a5-22ac125ed2f6/accounts/49544383-c19c-4c97-b8d1-5322d0faa6af,https://au-api.basiq.io/institutions/AU00000,,Bakery Product Manufacturing,117
transaction,5fe715ec-efb7-442e-9b98-810aade1b980,posted,EXMOUTH HOLIDAY PARK EXMOUTH,-105.40,49544383-c19c-4c97-b8d1-5322d0faa6af,571.22,debit,payment,AU00000,5453f0a3-083c-43c6-9086-adfe94df9918,,,2022-01-31T00:00:00Z,,https://au-api.basiq.io/users/11103cba-4a08-4397-84a5-22ac125ed2f6/transactions/5fe715ec-efb7-442e-9b98-810aade1b980,https://au-api.basiq.io/users/11103cba-4a08-4397-84a5-22ac125ed2f6/accounts/49544383-c19c-4c97-b8d1-5322d0faa6af,https://au-api.basiq.io/institutions/AU00000,,Accommodation,440
transaction,dc783623-d001-4f3d-ac16-693c360606c9,posted,STAR MART EXMOUTH AU,-225.23,49544383-c19c-4c97-b8d1-5322d0faa6af,676.62,debit,payment,AU00000,5453f0a3-083c-43c6-9086-adfe94df9918,,,2022-01-31T00:00:00Z,,https://au-api.basiq.io/users/11103cba-4a08-4397-84a5-22ac125ed2f6/transactions/dc783623-d001-4f3d-ac16-693c360606c9,https://au-api.basiq.io/users/11103cba-4a08-4397-84a5-22ac125ed2f6/accounts/49544383-c19c-4c97-b8d1-5322d0faa6af,https://au-api.basiq.io/institutions/AU00000,,Fuel Retailing,400
transaction,f0267d49-1e2c-4d96-930c-51169360d197,posted,Cash Wdr  ExExmouth      06AU,-203.90,49544383-c19c-4c97-b8d1-5322d0faa6af,901.85,debit,cash-withdrawal,AU00000,5453f0a3-083c-43c6-9086-adfe94df9918,,,2022-01-31T00:00:00Z,,https://au-api.basiq.io/users/11103cba-4a08-4397-84a5-22ac125ed2f6/transactions/f0267d49-1e2c-4d96-930c-51169360d197,https://au-api.basiq.io/users/11103cba-4a08-4397-84a5-22ac125ed2f6/accounts/49544383-c19c-4c97-b8d1-5322d0faa6af,https://au-api.basiq.io/institutions/AU00000,,,
transaction,4bce0c65-cb5f-45ae-8329-d257147c53c9,posted,NINGALOO WHALESHARK EXMOUTH AU,-30.95,49544383-c19c-4c97-b8d1-5322d0faa6af,1105.75,debit,payment,AU00000,5453f0a3-083c-43c6-9086-adfe94df9918,,,2022-01-31T00:00:00Z,,https://au-api.basiq.io/users/11103cba-4a08-4397-84a5-22ac125ed2f6/transactions/4bce0c65-cb5f-45ae-8329-d257147c53c9,https://au-api.basiq.io/users/11103cba-4a08-4397-84a5-22ac125ed2f6/accounts/49544383-c19c-4c97-b8d1-5322d0faa6af,https://au-api.basiq.io/institutions/AU00000,,Travel Agency and Tour Arrangement Services,722
transaction,b26ca5b3-c3f8-40d0-8657-e5add771b503,posted,R & M MANNING PL 0001 EXMOUTH,-21.99,49544383-c19c-4c97-b8d1-5322d0faa6af,1136.70,debit,payment,AU00000,5453f0a3-083c-43c6-9086-adfe94df9918,,,2022-01-30T00:00:00Z,,https://au-api.basiq.io/users/11103cba-4a08-4397-84a5-22ac125ed2f6/transactions/b26ca5b3-c3f8-40d0-8657-e5add771b503,https://au-api.basiq.io/users/11103cba-4a08-4397-84a5-22ac125ed2f6/accounts/49544383-c19c-4c97-b8d1-5322d0faa6af,https://au-api.basiq.io/institutions/AU00000,,Specialised Food Retailing,412
transaction,d1255962-04fa-4ed8-a3f8-f37452498e34,posted,EXMOUTH TACKLE/CAMP EXMOUTH WA AU,-100.90,49544383-c19c-4c97-b8d1-5322d0faa6af,1158.69,debit,payment,AU00000,5453f0a3-083c-43c6-9086-adfe94df9918,,,2022-01-30T00:00:00Z,,https://au-api.basiq.io/users/11103cba-4a08-4397-84a5-22ac125ed2f6/transactions/d1255962-04fa-4ed8-a3f8-f37452498e34,https://au-api.basiq.io/users/11103cba-4a08-4397-84a5-22ac125ed2f6/accounts/49544383-c19c-4c97-b8d1-5322d0faa6af,https://au-api.basiq.io/institutions/AU00000,,"Furniture, Floor Coverings, Houseware and Textile Goods Retailing",421
transaction,e7c5f4cd-1bf7-4a85-9d04-80ea75fa3437,posted,NINGALOO IGA X-PRESS EXMOUTH AU,-568.39,49544383-c19c-4c97-b8d1-5322d0faa6af,1259.59,debit,payment,AU00000,5453f0a3-083c-43c6-9086-adfe94df9918,,,2022-01-30T00:00:00Z,,https://au-api.basiq.io/users/11103cba-4a08-4397-84a5-22ac125ed2f6/transactions/e7c5f4cd-1bf7-4a85-9d04-80ea75fa3437,https://au-api.basiq.io/users/11103cba-4a08-4397-84a5-22ac125ed2f6/accounts/49544383-c19c-4c97-b8d1-5322d0faa6af,https://au-api.basiq.io/institutions/AU00000,,Supermarket and Grocery Stores,411
transaction,89834e04-b37d-445d-9591-920552d26c14,posted,WHALERS RESTAURANT EXMOUTH AU,-197.00,49544383-c19c-4c97-b8d1-5322d0faa6af,1827.98,debit,payment,AU00000,5453f0a3-083c-43c6-9086-adfe94df9918,,,2022-01-29T00:00:00Z,,https://au-api.basiq.io/users/11103cba-4a08-4397-84a5-22ac125ed2f6/transactions/89834e04-b37d-445d-9591-920552d26c14,https://au-api.basiq.io/users/11103cba-4a08-4397-84a5-22ac125ed2f6/accounts/49544383-c19c-4c97-b8d1-5322d0faa6af,https://au-api.basiq.io/institutions/AU00000,,"Cafes, Restaurants and Takeaway Food Services",451
transaction,da0a5fce-d5b1-480d-919c-bffe4d117104,posted,C.L HANN & S.C RAYNE EXMOUTH WA AU,-296.00,49544383-c19c-4c97-b8d1-5322d0faa6af,2024.98,debit,payment,AU00000,5453f0a3-083c-43c6-9086-adfe94df9918,,,2022-01-29T00:00:00Z,,https://au-api.basiq.io/users/11103cba-4a08-4397-84a5-22ac125ed2f6/transactions/da0a5fce-d5b1-480d-919c-bffe4d117104,https://au-api.basiq.io/users/11103cba-4a08-4397-84a5-22ac125ed2f6/accounts/49544383-c19c-4c97-b8d1-5322d0faa6af,https://au-api.basiq.io/institutions/AU00000,,Amusement and Other Recreation Activities,913
transaction,4310950a-dbe8-4c29-8591-1c3524b94fc5,posted,TFR From Transaction to CC Acc 13,9271.00,49544383-c19c-4c97-b8d1-5322d0faa6af,2320.98,credit,transfer,AU00000,5453f0a3-083c-43c6-9086-adfe94df9918,,,2022-01-28T00:00:00Z,,https://au-api.basiq.io/users/11103cba-4a08-4397-84a5-22ac125ed2f6/transactions/4310950a-dbe8-4c29-8591-1c3524b94fc5,https://au-api.basiq.io/users/11103cba-4a08-4397-84a5-22ac125ed2f6/accounts/49544383-c19c-4c97-b8d1-5322d0faa6af,https://au-api.basiq.io/institutions/AU00000,,,
transaction,e5415ad0-96fd-46bd-a50f-e8051cfdab31,posted,BLUE LIPS FISHANDCHI EXMOUTH WA AU,-77.00,49544383-c19c-4c97-b8d1-5322d0faa6af,-6950.02,debit,payment,AU00000,5453f0a3-083c-43c6-9086-adfe94df9918,,,2022-01-28T00:00:00Z,,https://au-api.basiq.io/users/11103cba-4a08-4397-84a5-22ac125ed2f6/transactions/e5415ad0-96fd-46bd-a50f-e8051cfdab31,https://au-api.basiq.io/users/11103cba-4a08-4397-84a5-22ac125ed2f6/accounts/49544383-c19c-4c97-b8d1-5322d0faa6af,https://au-api.basiq.io/institutions/AU00000,,"Cafes, Restaurants and Takeaway Food Services",451
transaction,3c2bd89c-bc1f-41a7-ab01-36c1c7e6b9ed,posted,TOM PRICE TOURIST PA TOMPRIC,-45.00,49544383-c19c-4c97-b8d1-5322d0faa6af,-6873.02,debit,payment,AU00000,5453f0a3-083c-43c6-9086-adfe94df9918,,,2022-01-26T00:00:00Z,,https://au-api.basiq.io/users/11103cba-4a08-4397-84a5-22ac125ed2f6/transactions/3c2bd89c-bc1f-41a7-ab01-36c1c7e6b9ed,https://au-api.basiq.io/users/11103cba-4a08-4397-84a5-22ac125ed2f6/accounts/49544383-c19c-4c97-b8d1-5322d0faa6af,https://au-api.basiq.io/institutions/AU00000,,Amusement and Other Recreation Activities,913
transaction,98d0795a-4c56-432d-a99f-7712b3471b26,posted,TOM PRICE TOURIST PA TOMPRIC,-45.00,49544383-c19c-4c97-b8d1-5322d0faa6af,-6828.02,debit,payment,AU00000,5453f0a3-083c-43c6-9086-adfe94df9918,,,2022-01-26T00:00:00Z,,https://au-api.basiq.io/users/11103cba-4a08-4397-84a5-22ac125ed2f6/transactions/98d0795a-4c56-432d-a99f-7712b3471b26,https://au-api.basiq.io/users/11103cba-4a08-4397-84a5-22ac125ed2f6/accounts/49544383-c19c-4c97-b8d1-5322d0faa6af,https://au-api.basiq.io/institutions/AU00000,,Amusement and Other Recreation Activities,913
transaction,b907e2eb-4b4a-447b-940a-79c4db9d0ecc,posted,COLES 0328 TOM,-15.90,49544383-c19c-4c97-b8d1-5322d0faa6af,-6783.02,debit,payment,AU00000,5453f0a3-083c-43c6-9086-adfe94df9918,,,2022-01-25T00:00:00Z,,https://au-api.basiq.io/users/11103cba-4a08-4397-84a5-22ac125ed2f6/transactions/b907e2eb-4b4a-447b-940a-79c4db9d0ecc,https://au-api.basiq.io/users/11103cba-4a08-4397-84a5-22ac125ed2f6/accounts/49544383-c19c-4c97-b8d1-5322d0faa6af,https://au-api.basiq.io/institutions/AU00000,,Supermarket and Grocery Stores,411
transaction,4302685a-0790-4dc5-9292-f13b515b6548,posted,COLES 0328 TOM,-11.07,49544383-c19c-4c97-b8d1-5322d0faa6af,-6767.12,debit,payment,AU00000,5453f0a3-083c-43c6-9086-adfe94df9918,,,2022-01-25T00:00:00Z,,https://au-api.basiq.io/users/11103cba-4a08-4397-84a5-22ac125ed2f6/transactions/4302685a-0790-4dc5-9292-f13b515b6548,https://au-api.basiq.io/users/11103cba-4a08-4397-84a5-22ac125ed2f6/accounts/49544383-c19c-4c97-b8d1-5322d0faa6af,https://au-api.basiq.io/institutions/AU00000,,Supermarket and Grocery Stores,411
transaction,387b094d-e114-4ae0-990d-ecd9a77b5ef7,posted,COLES EXPRESS 6942 TOM PRICE AU,-227.24,49544383-c19c-4c97-b8d1-5322d0faa6af,-6756.05,debit,payment,AU00000,5453f0a3-083c-43c6-9086-adfe94df9918,,,2022-01-25T00:00:00Z,,https://au-api.basiq.io/users/11103cba-4a08-4397-84a5-22ac125ed2f6/transactions/387b094d-e114-4ae0-990d-ecd9a77b5ef7,https://au-api.basiq.io/users/11103cba-4a08-4397-84a5-22ac125ed2f6/accounts/49544383-c19c-4c97-b8d1-5322d0faa6af,https://au-api.basiq.io/institutions/AU00000,,Fuel Retailing,400
transaction,1046a7af-c8b6-436d-9586-8ba1688f7bd4,posted,TOM PRICE MECHANICAL TOMPRIC,-208.50,49544383-c19c-4c97-b8d1-5322d0faa6af,-6528.81,debit,payment,AU00000,5453f0a3-083c-43c6-9086-adfe94df9918,,,2022-01-24T00:00:00Z,,https://au-api.basiq.io/users/11103cba-4a08-4397-84a5-22ac125ed2f6/transactions/1046a7af-c8b6-436d-9586-8ba1688f7bd4,https://au-api.basiq.io/users/11103cba-4a08-4397-84a5-22ac125ed2f6/accounts/49544383-c19c-4c97-b8d1-5322d0faa6af,https://au-api.basiq.io/institutions/AU00000,,Automotive Repair and Maintenance,941
transaction,b9542217-5147-4ede-a9fe-f760ea79a88b,posted,THE PICKLED BEAN TOMPRIC,-50.50,49544383-c19c-4c97-b8d1-5322d0faa6af,-6320.31,debit,payment,AU00000,5453f0a3-083c-43c6-9086-adfe94df9918,,,2022-01-24T00:00:00Z,,https://au-api.basiq.io/users/11103cba-4a08-4397-84a5-22ac125ed2f6/transactions/b9542217-5147-4ede-a9fe-f760ea79a88b,https://au-api.basiq.io/users/11103cba-4a08-4397-84a5-22ac125ed2f6/accounts/49544383-c19c-4c97-b8d1-5322d0faa6af,https://au-api.basiq.io/institutions/AU00000,,"Cafes, Restaurants and Takeaway Food Services",451
transaction,7b8f1d7f-f6c2-4bb5-9158-2eb771d4b1b3,posted,THE PICKLED BEAN TOMPRIC,-21.50,49544383-c19c-4c97-b8d1-5322d0faa6af,-6269.81,debit,payment,AU00000,5453f0a3-083c-43c6-9086-adfe94df9918,,,2022-01-24T00:00:00Z,,https://au-api.basiq.io/users/11103cba-4a08-4397-84a5-22ac125ed2f6/transactions/7b8f1d7f-f6c2-4bb5-9158-2eb771d4b1b3,https://au-api.basiq.io/users/11103cba-4a08-4397-84a5-22ac125ed2f6/accounts/49544383-c19c-4c97-b8d1-5322d0faa6af,https://au-api.basiq.io/institutions/AU00000,,"Cafes, Restaurants and Takeaway Food Services",451
transaction,524d54b2-9149-4e43-a584-bf66c7922185,posted,THE PICKLED BEAN TOMPRIC,-14.50,49544383-c19c-4c97-b8d1-5322d0faa6af,-6248.31,debit,payment,AU00000,5453f0a3-083c-43c6-9086-adfe94df9918,,,2022-01-24T00:00:00Z,,https://au-api.basiq.io/users/11103cba-4a08-4397-84a5-22ac125ed2f6/transactions/524d54b2-9149-4e43-a584-bf66c7922185,https://au-api.basiq.io/users/11103cba-4a08-4397-84a5-22ac125ed2f6/accounts/49544383-c19c-4c97-b8d1-5322d0faa6af,https://au-api.basiq.io/institutions/AU00000,,"Cafes, Restaurants and Takeaway Food Services",451
transaction,bc8cee08-0052-4cc3-9dff-2aabe2984e7c,posted,TOM PRICE TOUR BUREA 0001 TOM PRICE,-100.00,49544383-c19c-4c97-b8d1-5322d0faa6af,-6233.81,debit,payment,AU00000,5453f0a3-083c-43c6-9086-adfe94df9918,,,2022-01-24T00:00:00Z,,https://au-api.basiq.io/users/11103cba-4a08-4397-84a5-22ac125ed2f6/transactions/bc8cee08-0052-4cc3-9dff-2aabe2984e7c,https://au-api.basiq.io/users/11103cba-4a08-4397-84a5-22ac125ed2f6/accounts/49544383-c19c-4c97-b8d1-5322d0faa6af,https://au-api.basiq.io/institutions/AU00000,,Regulatory Services,772
transaction,c2ede7b3-470a-4e2d-889c-e3c2802ad3a2,posted,DEPT OF PARKS/WILDLI FE TOM PRICE AU,-17.00,49544383-c19c-4c97-b8d1-5322d0faa6af,-6133.81,debit,payment,AU00000,5453f0a3-083c-43c6-9086-adfe94df9918,,,2022-01-22T00:00:00Z,,https://au-api.basiq.io/users/11103cba-4a08-4397-84a5-22ac125ed2f6/transactions/c2ede7b3-470a-4e2d-889c-e3c2802ad3a2,https://au-api.basiq.io/users/11103cba-4a08-4397-84a5-22ac125ed2f6/accounts/49544383-c19c-4c97-b8d1-5322d0faa6af,https://au-api.basiq.io/institutions/AU00000,,Regulatory Services,772
transaction,189d47b4-95ff-49c2-8dae-1198db138c63,posted,COLES EXPRESS 6942 TOM PRICE AU,-16.00,49544383-c19c-4c97-b8d1-5322d0faa6af,-6116.81,debit,payment,AU00000,5453f0a3-083c-43c6-9086-adfe94df9918,,,2022-01-21T00:00:00Z,,https://au-api.basiq.io/users/11103cba-4a08-4397-84a5-22ac125ed2f6/transactions/189d47b4-95ff-49c2-8dae-1198db138c63,https://au-api.basiq.io/users/11103cba-4a08-4397-84a5-22ac125ed2f6/accounts/49544383-c19c-4c97-b8d1-5322d0faa6af,https://au-api.basiq.io/institutions/AU00000,,Fuel Retailing,400
transaction,82f529f4-711b-416f-8fd8-7aa09744c3ac,posted,COLES EXPRESS 6942 TOM PRICE AU,-16.00,49544383-c19c-4c97-b8d1-5322d0faa6af,-6100.81,debit,payment,AU00000,5453f0a3-083c-43c6-9086-adfe94df9918,,,2022-01-21T00:00:00Z,,https://au-api.basiq.io/users/11103cba-4a08-4397-84a5-22ac125ed2f6/transactions/82f529f4-711b-416f-8fd8-7aa09744c3ac,https://au-api.basiq.io/users/11103cba-4a08-4397-84a5-22ac125ed2f6/accounts/49544383-c19c-4c97-b8d1-5322d0faa6af,https://au-api.basiq.io/institutions/AU00000,,Fuel Retailing,400
transaction,f164747e-ec90-4571-b80e-903a83d3dee6,posted,COLES EXPRESS 6942 TOM PRICE AU,-16.00,49544383-c19c-4c97-b8d1-5322d0faa6af,-6084.81,debit,payment,AU00000,5453f0a3-083c-43c6-9086-adfe94df9918,,,2022-01-21T00:00:00Z,,https://au-api.basiq.io/users/11103cba-4a08-4397-84a5-22ac125ed2f6/transactions/f164747e-ec90-4571-b80e-903a83d3dee6,https://au-api.basiq.io/users/11103cba-4a08-4397-84a5-22ac125ed2f6/accounts/49544383-c19c-4c97-b8d1-5322d0faa6af,https://au-api.basiq.io/institutions/AU00000,,Fuel Retailing,400
transaction,cb2264e4-949a-4bd0-b03a-ba0e54f4a7ed,posted,Cash Wdr  TOM PRICE 6  AU,-253.00,49544383-c19c-4c97-b8d1-5322d0faa6af,-6068.81,debit,cash-withdrawal,AU00000,5453f0a3-083c-43c6-9086-adfe94df9918,,,2022-01-21T00:00:00Z,,https://au-api.basiq.io/users/11103cba-4a08-4397-84a5-22ac125ed2f6/transactions/cb2264e4-949a-4bd0-b03a-ba0e54f4a7ed,https://au-api.basiq.io/users/11103cba-4a08-4397-84a5-22ac125ed2f6/accounts/49544383-c19c-4c97-b8d1-5322d0faa6af,https://au-api.basiq.io/institutions/AU00000,,,
transaction,bf665b50-c001-44af-847d-af83c8a4e8b2,posted,COLES 0328 TOM PRICE AU,-92.39,49544383-c19c-4c97-b8d1-5322d0faa6af,-5815.81,debit,payment,AU00000,5453f0a3-083c-43c6-9086-adfe94df9918,,,2022-01-21T00:00:00Z,,https://au-api.basiq.io/users/11103cba-4a08-4397-84a5-22ac125ed2f6/transactions/bf665b50-c001-44af-847d-af83c8a4e8b2,https://au-api.basiq.io/users/11103cba-4a08-4397-84a5-22ac125ed2f6/accounts/49544383-c19c-4c97-b8d1-5322d0faa6af,https://au-api.basiq.io/institutions/AU00000,,Supermarket and Grocery Stores,411
transaction,83b82e6a-c2ae-4ece-accb-47c6adf7a219,posted,TOM PRICE TOUR BUREA 0001 TOM PRICE,-33.50,49544383-c19c-4c97-b8d1-5322d0faa6af,-5723.42,debit,payment,AU00000,5453f0a3-083c-43c6-9086-adfe94df9918,,,2022-01-21T00:00:00Z,,https://au-api.basiq.io/users/11103cba-4a08-4397-84a5-22ac125ed2f6/transactions/83b82e6a-c2ae-4ece-accb-47c6adf7a219,https://au-api.basiq.io/users/11103cba-4a08-4397-84a5-22ac125ed2f6/accounts/49544383-c19c-4c97-b8d1-5322d0faa6af,https://au-api.basiq.io/institutions/AU00000,,Regulatory Services,772
transaction,b9334afc-87e6-4814-9262-76b3fe09ff69,posted,TOM PRICE TOURIST PA TOM PRICE WA AU,-45.00,49544383-c19c-4c97-b8d1-5322d0faa6af,-5689.92,debit,payment,AU00000,5453f0a3-083c-43c6-9086-adfe94df9918,,,2022-01-20T00:00:00Z,,https://au-api.basiq.io/users/11103cba-4a08-4397-84a5-22ac125ed2f6/transactions/b9334afc-87e6-4814-9262-76b3fe09ff69,https://au-api.basiq.io/users/11103cba-4a08-4397-84a5-22ac125ed2f6/accounts/49544383-c19c-4c97-b8d1-5322d0faa6af,https://au-api.basiq.io/institutions/AU00000,,Amusement and Other Recreation Activities,913
transaction,901b243d-9945-49c0-9d8b-8c71811a8717,posted,COOKE POINT HOLIDAY PORT HE,-73.00,49544383-c19c-4c97-b8d1-5322d0faa6af,-5644.92,debit,payment,AU00000,5453f0a3-083c-43c6-9086-adfe94df9918,,,2022-01-19T00:00:00Z,,https://au-api.basiq.io/users/11103cba-4a08-4397-84a5-22ac125ed2f6/transactions/901b243d-9945-49c0-9d8b-8c71811a8717,https://au-api.basiq.io/users/11103cba-4a08-4397-84a5-22ac125ed2f6/accounts/49544383-c19c-4c97-b8d1-5322d0faa6af,https://au-api.basiq.io/institutions/AU00000,,Accommodation,440
transaction,5ff2f25e-dd9c-4861-8f35-e50e36fdcd7f,posted,ONYX (AUST) PTY LTD KARRATHA AU,-74.40,49544383-c19c-4c97-b8d1-5322d0faa6af,-5571.92,debit,payment,AU00000,5453f0a3-083c-43c6-9086-adfe94df9918,,,2022-01-19T00:00:00Z,,https://au-api.basiq.io/users/11103cba-4a08-4397-84a5-22ac125ed2f6/transactions/5ff2f25e-dd9c-4861-8f35-e50e36fdcd7f,https://au-api.basiq.io/users/11103cba-4a08-4397-84a5-22ac125ed2f6/accounts/49544383-c19c-4c97-b8d1-5322d0faa6af,https://au-api.basiq.io/institutions/AU00000,,"Cafes, Restaurants and Takeaway Food Services",451
transaction,3efb3ac8-951c-4354-8012-572044da8575,posted,KARRATHA LEISUREPLEX 0016 KARRATHA,-16.80,49544383-c19c-4c97-b8d1-5322d0faa6af,-5497.52,debit,payment,AU00000,5453f0a3-083c-43c6-9086-adfe94df9918,,,2022-01-19T00:00:00Z,,https://au-api.basiq.io/users/11103cba-4a08-4397-84a5-22ac125ed2f6/transactions/3efb3ac8-951c-4354-8012-572044da8575,https://au-api.basiq.io/users/11103cba-4a08-4397-84a5-22ac125ed2f6/accounts/49544383-c19c-4c97-b8d1-5322d0faa6af,https://au-api.basiq.io/institutions/AU00000,,Amusement and Other Recreation Activities,913
transaction,6ab293a9-79c2-430d-ad07-31a3d6b36a2a,posted,KARRATHA INT HOTEL KARRATHA AU,-62.98,49544383-c19c-4c97-b8d1-5322d0faa6af,-5480.72,debit,payment,AU00000,5453f0a3-083c-43c6-9086-adfe94df9918,,,2022-01-19T00:00:00Z,,https://au-api.basiq.io/users/11103cba-4a08-4397-84a5-22ac125ed2f6/transactions/6ab293a9-79c2-430d-ad07-31a3d6b36a2a,https://au-api.basiq.io/users/11103cba-4a08-4397-84a5-22ac125ed2f6/accounts/49544383-c19c-4c97-b8d1-5322d0faa6af,https://au-api.basiq.io/institutions/AU00000,,Accommodation,440
transaction,c52fd0df-185d-45e2-acc9-91170a411c85,posted,COLES 0313 KARRATHA AU,-192.35,49544383-c19c-4c97-b8d1-5322d0faa6af,-5417.74,debit,payment,AU00000,5453f0a3-083c-43c6-9086-adfe94df9918,,,2022-01-19T00:00:00Z,,https://au-api.basiq.io/users/11103cba-4a08-4397-84a5-22ac125ed2f6/transactions/c52fd0df-185d-45e2-acc9-91170a411c85,https://au-api.basiq.io/users/11103cba-4a08-4397-84a5-22ac125ed2f6/accounts/49544383-c19c-4c97-b8d1-5322d0faa6af,https://au-api.basiq.io/institutions/AU00000,,Supermarket and Grocery Stores,411
transaction,ae70d060-2ea1-4821-9db8-b9f5c736836c,posted,CALTEX STAR MART KAR RA KARRATHA AU,-332.84,49544383-c19c-4c97-b8d1-5322d0faa6af,-5225.39,debit,payment,AU00000,5453f0a3-083c-43c6-9086-adfe94df9918,,,2022-01-18T00:00:00Z,,https://au-api.basiq.io/users/11103cba-4a08-4397-84a5-22ac125ed2f6/transactions/ae70d060-2ea1-4821-9db8-b9f5c736836c,https://au-api.basiq.io/users/11103cba-4a08-4397-84a5-22ac125ed2f6/accounts/49544383-c19c-4c97-b8d1-5322d0faa6af,https://au-api.basiq.io/institutions/AU00000,,Fuel Retailing,400
transaction,4f929ee9-71ed-4400-b161-875b7eb1528c,posted,Jamaica Blue Karratha Karr,-62.80,49544383-c19c-4c97-b8d1-5322d0faa6af,-4892.55,debit,payment,AU00000,5453f0a3-083c-43c6-9086-adfe94df9918,,,2022-01-18T00:00:00Z,,https://au-api.basiq.io/users/11103cba-4a08-4397-84a5-22ac125ed2f6/transactions/4f929ee9-71ed-4400-b161-875b7eb1528c,https://au-api.basiq.io/users/11103cba-4a08-4397-84a5-22ac125ed2f6/accounts/49544383-c19c-4c97-b8d1-5322d0faa6af,https://au-api.basiq.io/institutions/AU00000,,"Cafes, Restaurants and Takeaway Food Services",451
transaction,8997c371-d07c-4984-96bb-a61973e7fe7d,posted,80 MILE BEACH C/VAN PORT,-46.00,49544383-c19c-4c97-b8d1-5322d0faa6af,-4829.75,debit,payment,AU00000,5453f0a3-083c-43c6-9086-adfe94df9918,,,2022-01-18T00:00:00Z,,https://au-api.basiq.io/users/11103cba-4a08-4397-84a5-22ac125ed2f6/transactions/8997c371-d07c-4984-96bb-a61973e7fe7d,https://au-api.basiq.io/users/11103cba-4a08-4397-84a5-22ac125ed2f6/accounts/49544383-c19c-4c97-b8d1-5322d0faa6af,https://au-api.basiq.io/institutions/AU00000,,Accommodation,440
transaction,587606cd-1aef-436d-b802-97a3ab03dedc,posted,COLES 0313 KARR,-45.10,49544383-c19c-4c97-b8d1-5322d0faa6af,-4783.75,debit,payment,AU00000,5453f0a3-083c-43c6-9086-adfe94df9918,,,2022-01-18T00:00:00Z,,https://au-api.basiq.io/users/11103cba-4a08-4397-84a5-22ac125ed2f6/transactions/587606cd-1aef-436d-b802-97a3ab03dedc,https://au-api.basiq.io/users/11103cba-4a08-4397-84a5-22ac125ed2f6/accounts/49544383-c19c-4c97-b8d1-5322d0faa6af,https://au-api.basiq.io/institutions/AU00000,,Supermarket and Grocery Stores,411
transaction,7998e4c1-d0e5-4409-bd89-b793d9b519e6,posted,ABUNDANCE HEALTH AUS KARRATHA AU,-91.00,49544383-c19c-4c97-b8d1-5322d0faa6af,-4738.65,debit,payment,AU00000,5453f0a3-083c-43c6-9086-adfe94df9918,,,2022-01-18T00:00:00Z,,https://au-api.basiq.io/users/11103cba-4a08-4397-84a5-22ac125ed2f6/transactions/7998e4c1-d0e5-4409-bd89-b793d9b519e6,https://au-api.basiq.io/users/11103cba-4a08-4397-84a5-22ac125ed2f6/accounts/49544383-c19c-4c97-b8d1-5322d0faa6af,https://au-api.basiq.io/institutions/AU00000,,Medical Services,851
transaction,f2e9513e-3a4e-4f5c-9678-1766038b00b1,posted,BARN HILL LIVESTOCK PTY LBROO,-42.00,49544383-c19c-4c97-b8d1-5322d0faa6af,-4647.65,debit,payment,AU00000,5453f0a3-083c-43c6-9086-adfe94df9918,,,2022-01-17T00:00:00Z,,https://au-api.basiq.io/users/11103cba-4a08-4397-84a5-22ac125ed2f6/transactions/f2e9513e-3a4e-4f5c-9678-1766038b00b1,https://au-api.basiq.io/users/11103cba-4a08-4397-84a5-22ac125ed2f6/accounts/49544383-c19c-4c97-b8d1-5322d0faa6af,https://au-api.basiq.io/institutions/AU00000,,Specialised Food Retailing,412
transaction,5cf48065-aab0-4637-b6dd-26b7f03629bc,posted,POST BROOME POST S BROO,-21.24,49544383-c19c-4c97-b8d1-5322d0faa6af,-4605.65,debit,payment,AU00000,5453f0a3-083c-43c6-9086-adfe94df9918,,,2022-01-17T00:00:00Z,,https://au-api.basiq.io/users/11103cba-4a08-4397-84a5-22ac125ed2f6/transactions/5cf48065-aab0-4637-b6dd-26b7f03629bc,https://au-api.basiq.io/users/11103cba-4a08-4397-84a5-22ac125ed2f6/accounts/49544383-c19c-4c97-b8d1-5322d0faa6af,https://au-api.basiq.io/institutions/AU00000,,Postal and Courier Pick-up and Delivery Services,510
transaction,b9470c04-87f5-4b31-8de7-c3330ea17e95,posted,PORT HEDLAND PEACE M PORT HEDLAND WA AU,-151.00,49544383-c19c-4c97-b8d1-5322d0faa6af,-4584.41,debit,payment,AU00000,5453f0a3-083c-43c6-9086-adfe94df9918,,,2022-01-17T00:00:00Z,,https://au-api.basiq.io/users/11103cba-4a08-4397-84a5-22ac125ed2f6/transactions/b9470c04-87f5-4b31-8de7-c3330ea17e95,https://au-api.basiq.io/users/11103cba-4a08-4397-84a5-22ac125ed2f6/accounts/49544383-c19c-4c97-b8d1-5322d0faa6af,https://au-api.basiq.io/institutions/AU00000,,Other Social Assistance Services,879
transaction,62e8e30c-d27e-4870-b1e5-68a72b11c5a8,posted,FORM CY CT N DN INC PORT HEDLAND WA AU,-120.00,49544383-c19c-4c97-b8d1-5322d0faa6af,-4433.41,debit,payment,AU00000,5453f0a3-083c-43c6-9086-adfe94df9918,,,2022-01-16T00:00:00Z,,https://au-api.basiq.io/users/11103cba-4a08-4397-84a5-22ac125ed2f6/transactions/62e8e30c-d27e-4870-b1e5-68a72b11c5a8,https://au-api.basiq.io/users/11103cba-4a08-4397-84a5-22ac125ed2f6/accounts/49544383-c19c-4c97-b8d1-5322d0faa6af,https://au-api.basiq.io/institutions/AU00000,,Other Social Assistance Services,879
transaction,0e2750c9-d6dd-4893-8fd6-961697023f91,posted,DOME PORT HEDLAND 0079 PORT HEDLAND,-22.95,49544383-c19c-4c97-b8d1-5322d0faa6af,-4313.41,debit,payment,AU00000,5453f0a3-083c-43c6-9086-adfe94df9918,,,2022-01-16T00:00:00Z,,https://au-api.basiq.io/users/11103cba-4a08-4397-84a5-22ac125ed2f6/transactions/0e2750c9-d6dd-4893-8fd6-961697023f91,https://au-api.basiq.io/users/11103cba-4a08-4397-84a5-22ac125ed2f6/accounts/49544383-c19c-4c97-b8d1-5322d0faa6af,https://au-api.basiq.io/institutions/AU00000,,"Cafes, Restaurants and Takeaway Food Services",451
transaction,7c64a5e8-d5c4-4588-ad29-8492b4c0f3f4,posted,DOME PORT HEDLAND 0079 PORT HEDLAND,-68.15,49544383-c19c-4c97-b8d1-5322d0faa6af,-4290.46,debit,payment,AU00000,5453f0a3-083c-43c6-9086-adfe94df9918,,,2022-01-16T00:00:00Z,,https://au-api.basiq.io/users/11103cba-4a08-4397-84a5-22ac125ed2f6/transactions/7c64a5e8-d5c4-4588-ad29-8492b4c0f3f4,https://au-api.basiq.io/users/11103cba-4a08-4397-84a5-22ac125ed2f6/accounts/49544383-c19c-4c97-b8d1-5322d0faa6af,https://au-api.basiq.io/institutions/AU00000,,"Cafes, Restaurants and Takeaway Food Services",451
transaction,815a98da-fe58-45ff-b2e7-1a35b6e8f7f8,posted,CABLE BEACH CARAVAN CABL,-61.00,49544383-c19c-4c97-b8d1-5322d0faa6af,-4222.31,debit,payment,AU00000,5453f0a3-083c-43c6-9086-adfe94df9918,,,2022-01-14T00:00:00Z,,https://au-api.basiq.io/users/11103cba-4a08-4397-84a5-22ac125ed2f6/transactions/815a98da-fe58-45ff-b2e7-1a35b6e8f7f8,https://au-api.basiq.io/users/11103cba-4a08-4397-84a5-22ac125ed2f6/accounts/49544383-c19c-4c97-b8d1-5322d0faa6af,https://au-api.basiq.io/institutions/AU00000,,Accommodation,440
transaction,7b020772-6abe-44dc-9a5b-8ca92d9614af,posted,KANAGAE ESTATE BROOME AU,-88.00,49544383-c19c-4c97-b8d1-5322d0faa6af,-4161.31,debit,payment,AU00000,5453f0a3-083c-43c6-9086-adfe94df9918,,,2022-01-14T00:00:00Z,,https://au-api.basiq.io/users/11103cba-4a08-4397-84a5-22ac125ed2f6/transactions/7b020772-6abe-44dc-9a5b-8ca92d9614af,https://au-api.basiq.io/users/11103cba-4a08-4397-84a5-22ac125ed2f6/accounts/49544383-c19c-4c97-b8d1-5322d0faa6af,https://au-api.basiq.io/institutions/AU00000,,Amusement and Other Recreation Activities,913
transaction,36f74ffb-cd7b-4f8e-983d-a7326253bb17,posted,STREETER & MALE HARD BROOME AU,-68.47,49544383-c19c-4c97-b8d1-5322d0faa6af,-4073.31,debit,payment,AU00000,5453f0a3-083c-43c6-9086-adfe94df9918,,,2022-01-14T00:00:00Z,,https://au-api.basiq.io/users/11103cba-4a08-4397-84a5-22ac125ed2f6/transactions/36f74ffb-cd7b-4f8e-983d-a7326253bb17,https://au-api.basiq.io/users/11103cba-4a08-4397-84a5-22ac125ed2f6/accounts/49544383-c19c-4c97-b8d1-5322d0faa6af,https://au-api.basiq.io/institutions/AU00000,,Commission-Based Wholesaling,380
transaction,d47624f6-f2ba-4510-b187-14e4dcff9541,posted,YUEN WING STORE BROOME AU,-40.00,49544383-c19c-4c97-b8d1-5322d0faa6af,-4004.84,debit,payment,AU00000,5453f0a3-083c-43c6-9086-adfe94df9918,,,2022-01-14T00:00:00Z,,https://au-api.basiq.io/users/11103cba-4a08-4397-84a5-22ac125ed2f6/transactions/d47624f6-f2ba-4510-b187-14e4dcff9541,https://au-api.basiq.io/users/11103cba-4a08-4397-84a5-22ac125ed2f6/accounts/49544383-c19c-4c97-b8d1-5322d0faa6af,https://au-api.basiq.io/institutions/AU00000,,Supermarket and Grocery Stores,411
transaction,0dc9f524-04fb-457e-9c10-8f24ce077438,posted,COLES 0324 BROOME AU,-14.80,49544383-c19c-4c97-b8d1-5322d0faa6af,-3964.84,debit,payment,AU00000,5453f0a3-083c-43c6-9086-adfe94df9918,,,2022-01-14T00:00:00Z,,https://au-api.basiq.io/users/11103cba-4a08-4397-84a5-22ac125ed2f6/transactions/0dc9f524-04fb-457e-9c10-8f24ce077438,https://au-api.basiq.io/users/11103cba-4a08-4397-84a5-22ac125ed2f6/accounts/49544383-c19c-4c97-b8d1-5322d0faa6af,https://au-api.basiq.io/institutions/AU00000,,Supermarket and Grocery Stores,411
transaction,65a78f5b-c090-408c-8ed9-eb33be681a8d,posted,COLES EXPRESS 6948 BROOME AU,-193.68,49544383-c19c-4c97-b8d1-5322d0faa6af,-3950.04,debit,payment,AU00000,5453f0a3-083c-43c6-9086-adfe94df9918,,,2022-01-14T00:00:00Z,,https://au-api.basiq.io/users/11103cba-4a08-4397-84a5-22ac125ed2f6/transactions/65a78f5b-c090-408c-8ed9-eb33be681a8d,https://au-api.basiq.io/users/11103cba-4a08-4397-84a5-22ac125ed2f6/accounts/49544383-c19c-4c97-b8d1-5322d0faa6af,https://au-api.basiq.io/institutions/AU00000,,Fuel Retailing,400
transaction,825c6988-b93a-450b-bf3f-5de7ea6456ba,posted,BARRELLS SURF N FITNESS PBROO,-40.97,49544383-c19c-4c97-b8d1-5322d0faa6af,-3756.36,debit,payment,AU00000,5453f0a3-083c-43c6-9086-adfe94df9918,,,2022-01-13T00:00:00Z,,https://au-api.basiq.io/users/11103cba-4a08-4397-84a5-22ac125ed2f6/transactions/825c6988-b93a-450b-bf3f-5de7ea6456ba,https://au-api.basiq.io/users/11103cba-4a08-4397-84a5-22ac125ed2f6/accounts/49544383-c19c-4c97-b8d1-5322d0faa6af,https://au-api.basiq.io/institutions/AU00000,,"Clothing, Footwear and Personal Accessory Retailing",425
transaction,aea03164-b30a-44c5-b741-752f1a5f1ab4,posted,BARRELLS SURF N FITNESS PBROO,-25.99,49544383-c19c-4c97-b8d1-5322d0faa6af,-3715.39,debit,payment,AU00000,5453f0a3-083c-43c6-9086-adfe94df9918,,,2022-01-13T00:00:00Z,,https://au-api.basiq.io/users/11103cba-4a08-4397-84a5-22ac125ed2f6/transactions/aea03164-b30a-44c5-b741-752f1a5f1ab4,https://au-api.basiq.io/users/11103cba-4a08-4397-84a5-22ac125ed2f6/accounts/49544383-c19c-4c97-b8d1-5322d0faa6af,https://au-api.basiq.io/institutions/AU00000,,"Clothing, Footwear and Personal Accessory Retailing",425
transaction,4782736e-c356-4604-9b0f-e4841ce10121,posted,WOOLWORTHS 4304 BROOME AU,-28.64,49544383-c19c-4c97-b8d1-5322d0faa6af,-3689.40,debit,payment,AU00000,5453f0a3-083c-43c6-9086-adfe94df9918,,,2022-01-13T00:00:00Z,,https://au-api.basiq.io/users/11103cba-4a08-4397-84a5-22ac125ed2f6/transactions/4782736e-c356-4604-9b0f-e4841ce10121,https://au-api.basiq.io/users/11103cba-4a08-4397-84a5-22ac125ed2f6/accounts/49544383-c19c-4c97-b8d1-5322d0faa6af,https://au-api.basiq.io/institutions/AU00000,,Supermarket and Grocery Stores,411
transaction,ada92ea7-9eaa-4228-8e21-f164dfb5a48a,posted,BROOME NATURAL WELLN DJUGUN AU,-77.00,49544383-c19c-4c97-b8d1-5322d0faa6af,-3660.76,debit,payment,AU00000,5453f0a3-083c-43c6-9086-adfe94df9918,,,2022-01-13T00:00:00Z,,https://au-api.basiq.io/users/11103cba-4a08-4397-84a5-22ac125ed2f6/transactions/ada92ea7-9eaa-4228-8e21-f164dfb5a48a,https://au-api.basiq.io/users/11103cba-4a08-4397-84a5-22ac125ed2f6/accounts/49544383-c19c-4c97-b8d1-5322d0faa6af,https://au-api.basiq.io/institutions/AU00000,,Specialised Food Retailing,412
transaction,321469d6-7fbb-474b-9592-353e4c7254f6,posted,WOOLWORTHS 4304 BROOME AU,-380.29,49544383-c19c-4c97-b8d1-5322d0faa6af,-3583.76,debit,payment,AU00000,5453f0a3-083c-43c6-9086-adfe94df9918,,,2022-01-13T00:00:00Z,,https://au-api.basiq.io/users/11103cba-4a08-4397-84a5-22ac125ed2f6/transactions/321469d6-7fbb-474b-9592-353e4c7254f6,https://au-api.basiq.io/users/11103cba-4a08-4397-84a5-22ac125ed2f6/accounts/49544383-c19c-4c97-b8d1-5322d0faa6af,https://au-api.basiq.io/institutions/AU00000,,Supermarket and Grocery Stores,411
transaction,602bc186-b5f3-4cb8-ab6d-e80c6ad98b0c,posted,GREEN MANGO CAFE BROOME,-30.80,49544383-c19c-4c97-b8d1-5322d0faa6af,-3203.47,debit,payment,AU00000,5453f0a3-083c-43c6-9086-adfe94df9918,,,2022-01-12T00:00:00Z,,https://au-api.basiq.io/users/11103cba-4a08-4397-84a5-22ac125ed2f6/transactions/602bc186-b5f3-4cb8-ab6d-e80c6ad98b0c,https://au-api.basiq.io/users/11103cba-4a08-4397-84a5-22ac125ed2f6/accounts/49544383-c19c-4c97-b8d1-5322d0faa6af,https://au-api.basiq.io/institutions/AU00000,,"Cafes, Restaurants and Takeaway Food Services",451
transaction,5142040b-be01-4c95-84ee-108bcbcd5a9b,posted,BROOME NATURAL WELLNESS DJUG,-25.00,49544383-c19c-4c97-b8d1-5322d0faa6af,-3172.67,debit,payment,AU00000,5453f0a3-083c-43c6-9086-adfe94df9918,,,2022-01-12T00:00:00Z,,https://au-api.basiq.io/users/11103cba-4a08-4397-84a5-22ac125ed2f6/transactions/5142040b-be01-4c95-84ee-108bcbcd5a9b,https://au-api.basiq.io/users/11103cba-4a08-4397-84a5-22ac125ed2f6/accounts/49544383-c19c-4c97-b8d1-5322d0faa6af,https://au-api.basiq.io/institutions/AU00000,,Specialised Food Retailing,412
transaction,409b7d7d-c47e-47cd-b40e-74a2c1511c4c,posted,BROOME NATURAL WELLNESS DJUG,-19.00,49544383-c19c-4c97-b8d1-5322d0faa6af,-3147.67,debit,payment,AU00000,5453f0a3-083c-43c6-9086-adfe94df9918,,,2022-01-12T00:00:00Z,,https://au-api.basiq.io/users/11103cba-4a08-4397-84a5-22ac125ed2f6/transactions/409b7d7d-c47e-47cd-b40e-74a2c1511c4c,https://au-api.basiq.io/users/11103cba-4a08-4397-84a5-22ac125ed2f6/accounts/49544383-c19c-4c97-b8d1-5322d0faa6af,https://au-api.basiq.io/institutions/AU00000,,Specialised Food Retailing,412
transaction,1c863aad-bb60-4caf-b2bc-38a9d40bd10e,posted,BROOME PHARMACY BROO,-12.75,49544383-c19c-4c97-b8d1-5322d0faa6af,-3128.67,debit,payment,AU00000,5453f0a3-083c-43c6-9086-adfe94df9918,,,2022-01-12T00:00:00Z,,https://au-api.basiq.io/users/11103cba-4a08-4397-84a5-22ac125ed2f6/transactions/1c863aad-bb60-4caf-b2bc-38a9d40bd10e,https://au-api.basiq.io/users/11103cba-4a08-4397-84a5-22ac125ed2f6/accounts/49544383-c19c-4c97-b8d1-5322d0faa6af,https://au-api.basiq.io/institutions/AU00000,,Pharmaceutical and Other Store-Based Retailing,427
transaction,89b6e580-9b2b-40a9-84cc-256b9b9ae342,posted,COLES 0324 BROOME AU,-110.31,49544383-c19c-4c97-b8d1-5322d0faa6af,-3115.92,debit,payment,AU00000,5453f0a3-083c-43c6-9086-adfe94df9918,,,2022-01-12T00:00:00Z,,https://au-api.basiq.io/users/11103cba-4a08-4397-84a5-22ac125ed2f6/transactions/89b6e580-9b2b-40a9-84cc-256b9b9ae342,https://au-api.basiq.io/users/11103cba-4a08-4397-84a5-22ac125ed2f6/accounts/49544383-c19c-4c97-b8d1-5322d0faa6af,https://au-api.basiq.io/institutions/AU00000,,Supermarket and Grocery Stores,411
transaction,2974b0e9-fa2e-45d8-9c76-8a4cb4795237,posted,GREEN MANGO CAFE BROOME WA AU,-76.00,49544383-c19c-4c97-b8d1-5322d0faa6af,-3005.61,debit,payment,AU00000,5453f0a3-083c-43c6-9086-adfe94df9918,,,2022-01-12T00:00:00Z,,https://au-api.basiq.io/users/11103cba-4a08-4397-84a5-22ac125ed2f6/transactions/2974b0e9-fa2e-45d8-9c76-8a4cb4795237,https://au-api.basiq.io/users/11103cba-4a08-4397-84a5-22ac125ed2f6/accounts/49544383-c19c-4c97-b8d1-5322d0faa6af,https://au-api.basiq.io/institutions/AU00000,,"Cafes, Restaurants and Takeaway Food Services",451
transaction,37de820f-9245-4d87-87f0-ee4f1674897f,posted,TARGET 5291 BROO,-31.00,49544383-c19c-4c97-b8d1-5322d0faa6af,-2929.61,debit,payment,AU00000,5453f0a3-083c-43c6-9086-adfe94df9918,,,2022-01-11T00:00:00Z,,https://au-api.basiq.io/users/11103cba-4a08-4397-84a5-22ac125ed2f6/transactions/37de820f-9245-4d87-87f0-ee4f1674897f,https://au-api.basiq.io/users/11103cba-4a08-4397-84a5-22ac125ed2f6/accounts/49544383-c19c-4c97-b8d1-5322d0faa6af,https://au-api.basiq.io/institutions/AU00000,,Department Stores,426
transaction,8f58a5ec-cff1-4aec-8515-2d66b0fb57ad,posted,BRIGHT EYES SUNGLASS BROO,-20.99,49544383-c19c-4c97-b8d1-5322d0faa6af,-2898.61,debit,payment,AU00000,5453f0a3-083c-43c6-9086-adfe94df9918,,,2022-01-11T00:00:00Z,,https://au-api.basiq.io/users/11103cba-4a08-4397-84a5-22ac125ed2f6/transactions/8f58a5ec-cff1-4aec-8515-2d66b0fb57ad,https://au-api.basiq.io/users/11103cba-4a08-4397-84a5-22ac125ed2f6/accounts/49544383-c19c-4c97-b8d1-5322d0faa6af,https://au-api.basiq.io/institutions/AU00000,,Allied Health Services,853
transaction,c47443b6-40cd-4a50-aca4-0c086d2efa06,posted,Diver's Tavern Broome AU,-77.99,49544383-c19c-4c97-b8d1-5322d0faa6af,-2877.62,debit,payment,AU00000,5453f0a3-083c-43c6-9086-adfe94df9918,,,2022-01-11T00:00:00Z,,https://au-api.basiq.io/users/11103cba-4a08-4397-84a5-22ac125ed2f6/transactions/c47443b6-40cd-4a50-aca4-0c086d2efa06,https://au-api.basiq.io/users/11103cba-4a08-4397-84a5-22ac125ed2f6/accounts/49544383-c19c-4c97-b8d1-5322d0faa6af,https://au-api.basiq.io/institutions/AU00000,,"Pubs, Taverns and Bars",452
transaction,3eafa0ea-3382-4555-98bb-a97a5fb586b7,posted,WOOLWORTHS 4304 BROOME AU,-210.02,49544383-c19c-4c97-b8d1-5322d0faa6af,-2799.63,debit,payment,AU00000,5453f0a3-083c-43c6-9086-adfe94df9918,,,2022-01-11T00:00:00Z,,https://au-api.basiq.io/users/11103cba-4a08-4397-84a5-22ac125ed2f6/transactions/3eafa0ea-3382-4555-98bb-a97a5fb586b7,https://au-api.basiq.io/users/11103cba-4a08-4397-84a5-22ac125ed2f6/accounts/49544383-c19c-4c97-b8d1-5322d0faa6af,https://au-api.basiq.io/institutions/AU00000,,Supermarket and Grocery Stores,411
transaction,cbff5271-04bf-4d48-a7f2-a41ebcbcbd84,posted,THE ZOOKEEPERS STORE BROOME AU,-100.00,49544383-c19c-4c97-b8d1-5322d0faa6af,-2589.61,debit,payment,AU00000,5453f0a3-083c-43c6-9086-adfe94df9918,,,2022-01-10T00:00:00Z,,https://au-api.basiq.io/users/11103cba-4a08-4397-84a5-22ac125ed2f6/transactions/cbff5271-04bf-4d48-a7f2-a41ebcbcbd84,https://au-api.basiq.io/users/11103cba-4a08-4397-84a5-22ac125ed2f6/accounts/49544383-c19c-4c97-b8d1-5322d0faa6af,https://au-api.basiq.io/institutions/AU00000,,"Cafes, Restaurants and Takeaway Food Services",451
transaction,84b4962e-c5b6-42f6-a3ca-a8c1244c79c4,posted,CABLE BEACH CARAVAN CABLE BEACH AU,-201.00,49544383-c19c-4c97-b8d1-5322d0faa6af,-2489.61,debit,payment,AU00000,5453f0a3-083c-43c6-9086-adfe94df9918,,,2022-01-10T00:00:00Z,,https://au-api.basiq.io/users/11103cba-4a08-4397-84a5-22ac125ed2f6/transactions/84b4962e-c5b6-42f6-a3ca-a8c1244c79c4,https://au-api.basiq.io/users/11103cba-4a08-4397-84a5-22ac125ed2f6/accounts/49544383-c19c-4c97-b8d1-5322d0faa6af,https://au-api.basiq.io/institutions/AU00000,,Accommodation,440
transaction,7774c0b7-6063-4d6d-81bf-b0bac3edc19e,posted,CYGNET BAY PEARLS BROOME AU,-20.00,49544383-c19c-4c97-b8d1-5322d0faa6af,-2288.61,debit,payment,AU00000,5453f0a3-083c-43c6-9086-adfe94df9918,,,2022-01-06T00:00:00Z,,https://au-api.basiq.io/users/11103cba-4a08-4397-84a5-22ac125ed2f6/transactions/7774c0b7-6063-4d6d-81bf-b0bac3edc19e,https://au-api.basiq.io/users/11103cba-4a08-4397-84a5-22ac125ed2f6/accounts/49544383-c19c-4c97-b8d1-5322d0faa6af,https://au-api.basiq.io/institutions/AU00000,,"Clothing, Footwear and Personal Accessory Retailing",425
transaction,df6753a6-c8c9-4ccb-be07-00289e3be6a9,posted,CYGNET BAY PEARLS BROOME AU,-91.00,49544383-c19c-4c97-b8d1-5322d0faa6af,-2268.61,debit,payment,AU00000,5453f0a3-083c-43c6-9086-adfe94df9918,,,2022-01-06T00:00:00Z,,https://au-api.basiq.io/users/11103cba-4a08-4397-84a5-22ac125ed2f6/transactions/df6753a6-c8c9-4ccb-be07-00289e3be6a9,https://au-api.basiq.io/users/11103cba-4a08-4397-84a5-22ac125ed2f6/accounts/49544383-c19c-4c97-b8d1-5322d0faa6af,https://au-api.basiq.io/institutions/AU00000,,"Clothing, Footwear and Personal Accessory Retailing",425
transaction,4bd7b515-dfa1-4136-a316-d451534fd50e,posted,GREEN MANGO CAFE BROOME,-59.50,49544383-c19c-4c97-b8d1-5322d0faa6af,-2177.61,debit,payment,AU00000,5453f0a3-083c-43c6-9086-adfe94df9918,,,2022-01-05T00:00:00Z,,https://au-api.basiq.io/users/11103cba-4a08-4397-84a5-22ac125ed2f6/transactions/4bd7b515-dfa1-4136-a316-d451534fd50e,https://au-api.basiq.io/users/11103cba-4a08-4397-84a5-22ac125ed2f6/accounts/49544383-c19c-4c97-b8d1-5322d0faa6af,https://au-api.basiq.io/institutions/AU00000,,"Cafes, Restaurants and Takeaway Food Services",451
transaction,97a95c15-c5c0-4498-acf8-4450eafa8dae,posted,POST BROOME POST S BROO,-42.25,49544383-c19c-4c97-b8d1-5322d0faa6af,-2118.11,debit,payment,AU00000,5453f0a3-083c-43c6-9086-adfe94df9918,,,2022-01-05T00:00:00Z,,https://au-api.basiq.io/users/11103cba-4a08-4397-84a5-22ac125ed2f6/transactions/97a95c15-c5c0-4498-acf8-4450eafa8dae,https://au-api.basiq.io/users/11103cba-4a08-4397-84a5-22ac125ed2f6/accounts/49544383-c19c-4c97-b8d1-5322d0faa6af,https://au-api.basiq.io/institutions/AU00000,,Postal and Courier Pick-up and Delivery Services,510
transaction,d6718bc6-7fa7-4ad7-bd38-d5578a1e6eb3,posted,GREEN MANGO CAFE BROOME,-37.60,49544383-c19c-4c97-b8d1-5322d0faa6af,-2075.86,debit,payment,AU00000,5453f0a3-083c-43c6-9086-adfe94df9918,,,2022-01-05T00:00:00Z,,https://au-api.basiq.io/users/11103cba-4a08-4397-84a5-22ac125ed2f6/transactions/d6718bc6-7fa7-4ad7-bd38-d5578a1e6eb3,https://au-api.basiq.io/users/11103cba-4a08-4397-84a5-22ac125ed2f6/accounts/49544383-c19c-4c97-b8d1-5322d0faa6af,https://au-api.basiq.io/institutions/AU00000,,"Cafes, Restaurants and Takeaway Food Services",451
transaction,e2aad5a4-5939-4261-8339-1ec53c06fd42,posted,BROOME BOULEVARD CAF BROO,-81.80,49544383-c19c-4c97-b8d1-5322d0faa6af,-2038.26,debit,payment,AU00000,5453f0a3-083c-43c6-9086-adfe94df9918,,,2022-01-04T00:00:00Z,,https://au-api.basiq.io/users/11103cba-4a08-4397-84a5-22ac125ed2f6/transactions/e2aad5a4-5939-4261-8339-1ec53c06fd42,https://au-api.basiq.io/users/11103cba-4a08-4397-84a5-22ac125ed2f6/accounts/49544383-c19c-4c97-b8d1-5322d0faa6af,https://au-api.basiq.io/institutions/AU00000,,"Cafes, Restaurants and Takeaway Food Services",451
transaction,701e55c5-5059-4ca5-9ecf-461ff2f54c93,posted,BROOME NATURAL WELLNESS DJUG,-28.45,49544383-c19c-4c97-b8d1-5322d0faa6af,-1956.46,debit,payment,AU00000,5453f0a3-083c-43c6-9086-adfe94df9918,,,2022-01-04T00:00:00Z,,https://au-api.basiq.io/users/11103cba-4a08-4397-84a5-22ac125ed2f6/transactions/701e55c5-5059-4ca5-9ecf-461ff2f54c93,https://au-api.basiq.io/users/11103cba-4a08-4397-84a5-22ac125ed2f6/accounts/49544383-c19c-4c97-b8d1-5322d0faa6af,https://au-api.basiq.io/institutions/AU00000,,Specialised Food Retailing,412
transaction,b9c36aeb-6d08-45d7-98a5-ac4a619ef34e,posted,BROOME PHARMACY BROO,-23.75,49544383-c19c-4c97-b8d1-5322d0faa6af,-1928.01,debit,payment,AU00000,5453f0a3-083c-43c6-9086-adfe94df9918,,,2022-01-04T00:00:00Z,,https://au-api.basiq.io/users/11103cba-4a08-4397-84a5-22ac125ed2f6/transactions/b9c36aeb-6d08-45d7-98a5-ac4a619ef34e,https://au-api.basiq.io/users/11103cba-4a08-4397-84a5-22ac125ed2f6/accounts/49544383-c19c-4c97-b8d1-5322d0faa6af,https://au-api.basiq.io/institutions/AU00000,,Pharmaceutical and Other Store-Based Retailing,427
transaction,fe443423-2f09-40c0-9737-f5fa5dc385cd,posted,COLES 0324 BROO,-6.80,49544383-c19c-4c97-b8d1-5322d0faa6af,-1904.26,debit,payment,AU00000,5453f0a3-083c-43c6-9086-adfe94df9918,,,2022-01-04T00:00:00Z,,https://au-api.basiq.io/users/11103cba-4a08-4397-84a5-22ac125ed2f6/transactions/fe443423-2f09-40c0-9737-f5fa5dc385cd,https://au-api.basiq.io/users/11103cba-4a08-4397-84a5-22ac125ed2f6/accounts/49544383-c19c-4c97-b8d1-5322d0faa6af,https://au-api.basiq.io/institutions/AU00000,,Supermarket and Grocery Stores,411
transaction,87faa4cf-afc1-493a-bcba-4aecb3433686,posted,COLES EXPRESS 6948 BROOME AU,-235.01,49544383-c19c-4c97-b8d1-5322d0faa6af,-1897.46,debit,payment,AU00000,5453f0a3-083c-43c6-9086-adfe94df9918,,,2022-01-04T00:00:00Z,,https://au-api.basiq.io/users/11103cba-4a08-4397-84a5-22ac125ed2f6/transactions/87faa4cf-afc1-493a-bcba-4aecb3433686,https://au-api.basiq.io/users/11103cba-4a08-4397-84a5-22ac125ed2f6/accounts/49544383-c19c-4c97-b8d1-5322d0faa6af,https://au-api.basiq.io/institutions/AU00000,,Fuel Retailing,400
transaction,7ce508bb-1051-4c78-a475-65a0f1ffff80,posted,KIMBERLEY CAMP/OUTBC BROOME WA AU,-335.80,49544383-c19c-4c97-b8d1-5322d0faa6af,-1662.45,debit,payment,AU00000,5453f0a3-083c-43c6-9086-adfe94df9918,,,2022-01-04T00:00:00Z,,https://au-api.basiq.io/users/11103cba-4a08-4397-84a5-22ac125ed2f6/transactions/7ce508bb-1051-4c78-a475-65a0f1ffff80,https://au-api.basiq.io/users/11103cba-4a08-4397-84a5-22ac125ed2f6/accounts/49544383-c19c-4c97-b8d1-5322d0faa6af,https://au-api.basiq.io/institutions/AU00000,,Recreational Goods Retailing,424
transaction,ec96d394-ed56-4739-8f7a-194c962ce497,posted,LITTLE INDIAN RESTAU BROOME AU,-121.00,49544383-c19c-4c97-b8d1-5322d0faa6af,-1326.65,debit,payment,AU00000,5453f0a3-083c-43c6-9086-adfe94df9918,,,2022-01-03T00:00:00Z,,https://au-api.basiq.io/users/11103cba-4a08-4397-84a5-22ac125ed2f6/transactions/ec96d394-ed56-4739-8f7a-194c962ce497,https://au-api.basiq.io/users/11103cba-4a08-4397-84a5-22ac125ed2f6/accounts/49544383-c19c-4c97-b8d1-5322d0faa6af,https://au-api.basiq.io/institutions/AU00000,,"Cafes, Restaurants and Takeaway Food Services",451
transaction,a2b85e58-61c6-400f-bea7-73c6e39c6902,posted,Cash Wdr  B1 WA  650559   AUS,-303.50,49544383-c19c-4c97-b8d1-5322d0faa6af,-1205.65,debit,cash-withdrawal,AU00000,5453f0a3-083c-43c6-9086-adfe94df9918,,,2022-01-03T00:00:00Z,,https://au-api.basiq.io/users/11103cba-4a08-4397-84a5-22ac125ed2f6/transactions/a2b85e58-61c6-400f-bea7-73c6e39c6902,https://au-api.basiq.io/users/11103cba-4a08-4397-84a5-22ac125ed2f6/accounts/49544383-c19c-4c97-b8d1-5322d0faa6af,https://au-api.basiq.io/institutions/AU00000,,,
transaction,861311f6-1be8-40f8-906b-46295c76c756,posted,WOOLWORTHS 4304 BROOME AU,-257.51,49544383-c19c-4c97-b8d1-5322d0faa6af,-902.15,debit,payment,AU00000,5453f0a3-083c-43c6-9086-adfe94df9918,,,2022-01-03T00:00:00Z,,https://au-api.basiq.io/users/11103cba-4a08-4397-84a5-22ac125ed2f6/transactions/861311f6-1be8-40f8-906b-46295c76c756,https://au-api.basiq.io/users/11103cba-4a08-4397-84a5-22ac125ed2f6/accounts/49544383-c19c-4c97-b8d1-5322d0faa6af,https://au-api.basiq.io/institutions/AU00000,,Supermarket and Grocery Stores,411
transaction,5803b270-a42b-4e12-a365-b39bfe0dd3c8,posted,BROOME LOTTERY CENTR E BROOME AU,-13.00,49544383-c19c-4c97-b8d1-5322d0faa6af,-644.64,debit,payment,AU00000,5453f0a3-083c-43c6-9086-adfe94df9918,,,2022-01-03T00:00:00Z,,https://au-api.basiq.io/users/11103cba-4a08-4397-84a5-22ac125ed2f6/transactions/5803b270-a42b-4e12-a365-b39bfe0dd3c8,https://au-api.basiq.io/users/11103cba-4a08-4397-84a5-22ac125ed2f6/accounts/49544383-c19c-4c97-b8d1-5322d0faa6af,https://au-api.basiq.io/institutions/AU00000,,Recreational Goods Retailing,424
transaction,8162464f-aba5-4b41-a6fe-4f3df04a14e8,posted,THE ZOOKEEPERS STORE BROOME AU,-8.50,49544383-c19c-4c97-b8d1-5322d0faa6af,-631.64,debit,payment,AU00000,5453f0a3-083c-43c6-9086-adfe94df9918,,,2022-01-02T00:00:00Z,,https://au-api.basiq.io/users/11103cba-4a08-4397-84a5-22ac125ed2f6/transactions/8162464f-aba5-4b41-a6fe-4f3df04a14e8,https://au-api.basiq.io/users/11103cba-4a08-4397-84a5-22ac125ed2f6/accounts/49544383-c19c-4c97-b8d1-5322d0faa6af,https://au-api.basiq.io/institutions/AU00000,,"Cafes, Restaurants and Takeaway Food Services",451
transaction,6f700e7b-7c7c-4b04-a891-80195a2a25d5,posted,Diver's Tavern Broome AU,-47.99,49544383-c19c-4c97-b8d1-5322d0faa6af,-623.14,debit,payment,AU00000,5453f0a3-083c-43c6-9086-adfe94df9918,,,2022-01-02T00:00:00Z,,https://au-api.basiq.io/users/11103cba-4a08-4397-84a5-22ac125ed2f6/transactions/6f700e7b-7c7c-4b04-a891-80195a2a25d5,https://au-api.basiq.io/users/11103cba-4a08-4397-84a5-22ac125ed2f6/accounts/49544383-c19c-4c97-b8d1-5322d0faa6af,https://au-api.basiq.io/institutions/AU00000,,"Pubs, Taverns and Bars",452
transaction,6f8f5796-7121-49c2-8977-ba17b862595c,posted,CAFE DAMORE PTY LTD BROOME AU,-70.00,49544383-c19c-4c97-b8d1-5322d0faa6af,-575.15,debit,payment,AU00000,5453f0a3-083c-43c6-9086-adfe94df9918,,,2022-01-02T00:00:00Z,,https://au-api.basiq.io/users/11103cba-4a08-4397-84a5-22ac125ed2f6/transactions/6f8f5796-7121-49c2-8977-ba17b862595c,https://au-api.basiq.io/users/11103cba-4a08-4397-84a5-22ac125ed2f6/accounts/49544383-c19c-4c97-b8d1-5322d0faa6af,https://au-api.basiq.io/institutions/AU00000,,"Cafes, Restaurants and Takeaway Food Services",451
transaction,0b713af7-6aa0-4945-ae8f-4218b27f14eb,posted,CABLE BEACH CARAVAN CABLE BEACH AU,-131.00,49544383-c19c-4c97-b8d1-5322d0faa6af,-505.15,debit,payment,AU00000,5453f0a3-083c-43c6-9086-adfe94df9918,,,2022-01-02T00:00:00Z,,https://au-api.basiq.io/users/11103cba-4a08-4397-84a5-22ac125ed2f6/transactions/0b713af7-6aa0-4945-ae8f-4218b27f14eb,https://au-api.basiq.io/users/11103cba-4a08-4397-84a5-22ac125ed2f6/accounts/49544383-c19c-4c97-b8d1-5322d0faa6af,https://au-api.basiq.io/institutions/AU00000,,Accommodation,440
transaction,d0d696f2-21b7-4b41-9972-af5b557383e4,posted,TARUNDA SUPERMARKET FITZROY CROS AU,-10.04,49544383-c19c-4c97-b8d1-5322d0faa6af,-374.15,debit,payment,AU00000,5453f0a3-083c-43c6-9086-adfe94df9918,,,2022-01-01T00:00:00Z,,https://au-api.basiq.io/users/11103cba-4a08-4397-84a5-22ac125ed2f6/transactions/d0d696f2-21b7-4b41-9972-af5b557383e4,https://au-api.basiq.io/users/11103cba-4a08-4397-84a5-22ac125ed2f6/accounts/49544383-c19c-4c97-b8d1-5322d0faa6af,https://au-api.basiq.io/institutions/AU00000,,Supermarket and Grocery Stores,411
transaction,5a6171f6-6d33-4fb7-87ec-05e58dabc853,posted,COLES EXPRESS 6952 HALLS CREEK AU,-326.01,49544383-c19c-4c97-b8d1-5322d0faa6af,-364.11,debit,payment,AU00000,5453f0a3-083c-43c6-9086-adfe94df9918,,,2022-01-01T00:00:00Z,,https://au-api.basiq.io/users/11103cba-4a08-4397-84a5-22ac125ed2f6/transactions/5a6171f6-6d33-4fb7-87ec-05e58dabc853,https://au-api.basiq.io/users/11103cba-4a08-4397-84a5-22ac125ed2f6/accounts/49544383-c19c-4c97-b8d1-5322d0faa6af,https://au-api.basiq.io/institutions/AU00000,,Fuel Retailing,400
transaction,11a6f99b-3448-41ec-8514-436ed7f7d78e,posted,WARMUN ROADHOUSE EAST ARM AU,-114.40,49544383-c19c-4c97-b8d1-5322d0faa6af,-38.10,debit,payment,AU00000,5453f0a3-083c-43c6-9086-adfe94df9918,,,2022-01-01T00:00:00Z,,https://au-api.basiq.io/users/11103cba-4a08-4397-84a5-22ac125ed2f6/transactions/11a6f99b-3448-41ec-8514-436ed7f7d78e,https://au-api.basiq.io/users/11103cba-4a08-4397-84a5-22ac125ed2f6/accounts/49544383-c19c-4c97-b8d1-5322d0faa6af,https://au-api.basiq.io/institutions/AU00000,,Supermarket and Grocery Stores,411
transaction,4bc545cf-ad5b-4ede-9246-b5f7a52b4ddf,posted,Savings Interest CR Bal @0%%,100.51,b2360b69-e3f3-49f3-bbc4-65d04865db02,21567.33,credit,interest,AU00000,5453f0a3-083c-43c6-9086-adfe94df9918,,,2022-03-30T00:00:00Z,,https://au-api.basiq.io/users/11103cba-4a08-4397-84a5-22ac125ed2f6/transactions/4bc545cf-ad5b-4ede-9246-b5f7a52b4ddf,https://au-api.basiq.io/users/11103cba-4a08-4397-84a5-22ac125ed2f6/accounts/b2360b69-e3f3-49f3-bbc4-65d04865db02,https://au-api.basiq.io/institutions/AU00000,,,
transaction,3277930c-9b37-4ca9-86c7-8704774b3755,posted,TFR Acc14000 TO 12389,500.00,b2360b69-e3f3-49f3-bbc4-65d04865db02,21466.82,credit,transfer,AU00000,5453f0a3-083c-43c6-9086-adfe94df9918,,,2022-03-14T00:00:00Z,,https://au-api.basiq.io/users/11103cba-4a08-4397-84a5-22ac125ed2f6/transactions/3277930c-9b37-4ca9-86c7-8704774b3755,https://au-api.basiq.io/users/11103cba-4a08-4397-84a5-22ac125ed2f6/accounts/b2360b69-e3f3-49f3-bbc4-65d04865db02,https://au-api.basiq.io/institutions/AU00000,,,
transaction,73054f61-dcbb-4a4b-a783-4c7dc09434cf,posted,Savings Interest CR Bal @0%%,98.63,b2360b69-e3f3-49f3-bbc4-65d04865db02,20966.82,credit,interest,AU00000,5453f0a3-083c-43c6-9086-adfe94df9918,,,2022-02-28T00:00:00Z,,https://au-api.basiq.io/users/11103cba-4a08-4397-84a5-22ac125ed2f6/transactions/73054f61-dcbb-4a4b-a783-4c7dc09434cf,https://au-api.basiq.io/users/11103cba-4a08-4397-84a5-22ac125ed2f6/accounts/b2360b69-e3f3-49f3-bbc4-65d04865db02,https://au-api.basiq.io/institutions/AU00000,,,
transaction,caf2d88b-64ec-4bcb-ae76-d66b893431bb,posted,TFR Acc14000 TO 12389,500.00,b2360b69-e3f3-49f3-bbc4-65d04865db02,20868.19,credit,transfer,AU00000,5453f0a3-083c-43c6-9086-adfe94df9918,,,2022-02-12T00:00:00Z,,https://au-api.basiq.io/users/11103cba-4a08-4397-84a5-22ac125ed2f6/transactions/caf2d88b-64ec-4bcb-ae76-d66b893431bb,https://au-api.basiq.io/users/11103cba-4a08-4397-84a5-22ac125ed2f6/accounts/b2360b69-e3f3-49f3-bbc4-65d04865db02,https://au-api.basiq.io/institutions/AU00000,,,
transaction,08aa82cb-d2ba-43f5-872e-999b46e92206,posted,Savings Interest CR Bal @0%%,89.63,b2360b69-e3f3-49f3-bbc4-65d04865db02,20368.19,credit,interest,AU00000,5453f0a3-083c-43c6-9086-adfe94df9918,,,2022-01-29T00:00:00Z,,https://au-api.basiq.io/users/11103cba-4a08-4397-84a5-22ac125ed2f6/transactions/08aa82cb-d2ba-43f5-872e-999b46e92206,https://au-api.basiq.io/users/11103cba-4a08-4397-84a5-22ac125ed2f6/accounts/b2360b69-e3f3-49f3-bbc4-65d04865db02,https://au-api.basiq.io/institutions/AU00000,,,
transaction,8f07d97f-91fb-458d-a59d-5871479cacb2,posted,TFR Acc14000 TO 12389,500.00,b2360b69-e3f3-49f3-bbc4-65d04865db02,20278.56,credit,transfer,AU00000,5453f0a3-083c-43c6-9086-adfe94df9918,,,2022-01-13T00:00:00Z,,https://au-api.basiq.io/users/11103cba-4a08-4397-84a5-22ac125ed2f6/transactions/8f07d97f-91fb-458d-a59d-5871479cacb2,https://au-api.basiq.io/users/11103cba-4a08-4397-84a5-22ac125ed2f6/accounts/b2360b69-e3f3-49f3-bbc4-65d04865db02,https://au-api.basiq.io/institutions/AU00000,,,
