type,id,status,description,amount,account,balance,direction,class,institution,connection,enrich,transactionDate,postDate,subClass,links.self,links.account,links.institution,links.connection,subClass.title,subClass.code
transaction,5dc1cce7-a89d-45df-a069-0fb8ef4f9c8b,posted,Transfer Platnm Homeloan 346454,-3927.50,0b107c33-e858-4bbd-abba-f757ae4da1fc,6631.56,debit,transfer,AU00000,5453f0a3-083c-43c6-9086-adfe94df9918,,,2022-09-28T00:00:00Z,,https://au-api.basiq.io/users/11103cba-4a08-4397-84a5-22ac125ed2f6/transactions/5dc1cce7-a89d-45df-a069-0fb8ef4f9c8b,https://au-api.basiq.io/users/11103cba-4a08-4397-84a5-22ac125ed2f6/accounts/0b107c33-e858-4bbd-abba-f757ae4da1fc,https://au-api.basiq.io/institutions/AU00000,,,
transaction,a0a4a39f-62e0-4d7d-b0cc-f395601cb247,posted,TFR From Transaction to CC Acc 13,-9331.00,0b107c33-e858-4bbd-abba-f757ae4da1fc,10559.06,debit,transfer,AU00000,5453f0a3-083c-43c6-9086-adfe94df9918,,,2022-09-27T00:00:00Z,,https://au-api.basiq.io/users/11103cba-4a08-4397-84a5-22ac125ed2f6/transactions/a0a4a39f-62e0-4d7d-b0cc-f395601cb247,https://au-api.basiq.io/users/11103cba-4a08-4397-84a5-22ac125ed2f6/accounts/0b107c33-e858-4bbd-abba-f757ae4da1fc,https://au-api.basiq.io/institutions/AU00000,,,
transaction,95644266-e12a-4b9d-a40f-d0d0673ddad0,posted,Payroll WFRMS 15439393,15985.00,0b107c33-e858-4bbd-abba-f757ae4da1fc,19890.06,credit,transfer,AU00000,5453f0a3-083c-43c6-9086-adfe94df9918,,,2022-09-27T00:00:00Z,,https://au-api.basiq.io/users/11103cba-4a08-4397-84a5-22ac125ed2f6/transactions/95644266-e12a-4b9d-a40f-d0d0673ddad0,https://au-api.basiq.io/users/11103cba-4a08-4397-84a5-22ac125ed2f6/accounts/0b107c33-e858-4bbd-abba-f757ae4da1fc,https://au-api.basiq.io/institutions/AU00000,,,
transaction,6f39334c-988b-4d91-ad20-d7251a6b8ce7,posted,Wdl ATM BOQ BP Connect BalgowlaBalgowlahNS    AU,-900.00,0b107c33-e858-4bbd-abba-f757ae4da1fc,3905.06,debit,cash-withdrawal,AU00000,5453f0a3-083c-43c6-9086-adfe94df9918,,,2022-09-25T00:00:00Z,,https://au-api.basiq.io/users/11103cba-4a08-4397-84a5-22ac125ed2f6/transactions/6f39334c-988b-4d91-ad20-d7251a6b8ce7,https://au-api.basiq.io/users/11103cba-4a08-4397-84a5-22ac125ed2f6/accounts/0b107c33-e858-4bbd-abba-f757ae4da1fc,https://au-api.basiq.io/institutions/AU00000,,,
transaction,57ee3775-5aa8-42fc-9264-911a7b53b3d4,posted,Non Hooli ATM Withdrawal Fee,-2.50,0b107c33-e858-4bbd-abba-f757ae4da1fc,4805.06,debit,bank-fee,AU00000,5453f0a3-083c-43c6-9086-adfe94df9918,,,2022-09-25T00:00:00Z,,https://au-api.basiq.io/users/11103cba-4a08-4397-84a5-22ac125ed2f6/transactions/57ee3775-5aa8-42fc-9264-911a7b53b3d4,https://au-api.basiq.io/users/11103cba-4a08-4397-84a5-22ac125ed2f6/accounts/0b107c33-e858-4bbd-abba-f757ae4da1fc,https://au-api.basiq.io/institutions/AU00000,,,
transaction,61ad6f85-9fb5-4efd-b362-75177996d366,posted,MANLY WEST SCHOOL,-31.00,0b107c33-e858-4bbd-abba-f757ae4da1fc,4807.56,debit,payment,AU00000,5453f0a3-083c-43c6-9086-adfe94df9918,,,2022-09-25T00:00:00Z,,https://au-api.basiq.io/users/11103cba-4a08-4397-84a5-22ac125ed2f6/transactions/61ad6f85-9fb5-4efd-b362-75177996d366,https://au-api.basiq.io/users/11103cba-4a08-4397-84a5-22ac125ed2f6/accounts/0b107c33-e858-4bbd-abba-f757ae4da1fc,https://au-api.basiq.io/institutions/AU00000,,School Education,802
transaction,19dfa19d-bd08-4fa3-b30c-81f9fbc7a2f2,posted,Manly Maths Tutor Wages,201.00,0b107c33-e858-4bbd-abba-f757ae4da1fc,4838.56,credit,transfer,AU00000,5453f0a3-083c-43c6-9086-adfe94df9918,,,2022-09-14T00:00:00Z,,https://au-api.basiq.io/users/11103cba-4a08-4397-84a5-22ac125ed2f6/transactions/19dfa19d-bd08-4fa3-b30c-81f9fbc7a2f2,https://au-api.basiq.io/users/11103cba-4a08-4397-84a5-22ac125ed2f6/accounts/0b107c33-e858-4bbd-abba-f757ae4da1fc,https://au-api.basiq.io/institutions/AU00000,,,
transaction,f445abef-fe5a-4e74-b9d6-7d7700c61f91,posted,MANLY WEST SCHOOL,-2530.81,0b107c33-e858-4bbd-abba-f757ae4da1fc,4637.56,debit,payment,AU00000,5453f0a3-083c-43c6-9086-adfe94df9918,,,2022-09-14T00:00:00Z,,https://au-api.basiq.io/users/11103cba-4a08-4397-84a5-22ac125ed2f6/transactions/f445abef-fe5a-4e74-b9d6-7d7700c61f91,https://au-api.basiq.io/users/11103cba-4a08-4397-84a5-22ac125ed2f6/accounts/0b107c33-e858-4bbd-abba-f757ae4da1fc,https://au-api.basiq.io/institutions/AU00000,,School Education,802
transaction,736947b0-eec4-4396-8fd9-af6131e803a9,posted,MANLY WEST SCHOOL,-101.00,0b107c33-e858-4bbd-abba-f757ae4da1fc,7168.37,debit,payment,AU00000,5453f0a3-083c-43c6-9086-adfe94df9918,,,2022-09-14T00:00:00Z,,https://au-api.basiq.io/users/11103cba-4a08-4397-84a5-22ac125ed2f6/transactions/736947b0-eec4-4396-8fd9-af6131e803a9,https://au-api.basiq.io/users/11103cba-4a08-4397-84a5-22ac125ed2f6/accounts/0b107c33-e858-4bbd-abba-f757ae4da1fc,https://au-api.basiq.io/institutions/AU00000,,School Education,802
transaction,abb93981-4017-4abb-823b-46f1d7e63ec3,posted,MANLY WEST SCHOOL,-70.69,0b107c33-e858-4bbd-abba-f757ae4da1fc,7269.37,debit,payment,AU00000,5453f0a3-083c-43c6-9086-adfe94df9918,,,2022-09-12T00:00:00Z,,https://au-api.basiq.io/users/11103cba-4a08-4397-84a5-22ac125ed2f6/transactions/abb93981-4017-4abb-823b-46f1d7e63ec3,https://au-api.basiq.io/users/11103cba-4a08-4397-84a5-22ac125ed2f6/accounts/0b107c33-e858-4bbd-abba-f757ae4da1fc,https://au-api.basiq.io/institutions/AU00000,,School Education,802
transaction,40b3f0b5-5643-4753-8e79-700982db9d14,posted,Wdl ATM WES IGA BALGOWLAH HGT  BALGOWL        AU,-500.00,0b107c33-e858-4bbd-abba-f757ae4da1fc,7340.06,debit,cash-withdrawal,AU00000,5453f0a3-083c-43c6-9086-adfe94df9918,,,2022-09-12T00:00:00Z,,https://au-api.basiq.io/users/11103cba-4a08-4397-84a5-22ac125ed2f6/transactions/40b3f0b5-5643-4753-8e79-700982db9d14,https://au-api.basiq.io/users/11103cba-4a08-4397-84a5-22ac125ed2f6/accounts/0b107c33-e858-4bbd-abba-f757ae4da1fc,https://au-api.basiq.io/institutions/AU00000,,,
transaction,63825beb-af72-472e-b046-81737dc1c7a6,posted,Non Hooli ATM Withdrawal Fee,-2.50,0b107c33-e858-4bbd-abba-f757ae4da1fc,7840.06,debit,bank-fee,AU00000,5453f0a3-083c-43c6-9086-adfe94df9918,,,2022-09-12T00:00:00Z,,https://au-api.basiq.io/users/11103cba-4a08-4397-84a5-22ac125ed2f6/transactions/63825beb-af72-472e-b046-81737dc1c7a6,https://au-api.basiq.io/users/11103cba-4a08-4397-84a5-22ac125ed2f6/accounts/0b107c33-e858-4bbd-abba-f757ae4da1fc,https://au-api.basiq.io/institutions/AU00000,,,
transaction,fae280d4-7756-4769-95bf-221473021b2b,posted,Manly Maths Tutor Wages,201.00,0b107c33-e858-4bbd-abba-f757ae4da1fc,7842.56,credit,transfer,AU00000,5453f0a3-083c-43c6-9086-adfe94df9918,,,2022-09-12T00:00:00Z,,https://au-api.basiq.io/users/11103cba-4a08-4397-84a5-22ac125ed2f6/transactions/fae280d4-7756-4769-95bf-221473021b2b,https://au-api.basiq.io/users/11103cba-4a08-4397-84a5-22ac125ed2f6/accounts/0b107c33-e858-4bbd-abba-f757ae4da1fc,https://au-api.basiq.io/institutions/AU00000,,,
transaction,acb4fde7-9917-406f-afea-aa6eb5f52e58,posted,TFR Acc14000 TO 12389,-500.00,0b107c33-e858-4bbd-abba-f757ae4da1fc,7641.56,debit,transfer,AU00000,5453f0a3-083c-43c6-9086-adfe94df9918,,,2022-09-11T00:00:00Z,,https://au-api.basiq.io/users/11103cba-4a08-4397-84a5-22ac125ed2f6/transactions/acb4fde7-9917-406f-afea-aa6eb5f52e58,https://au-api.basiq.io/users/11103cba-4a08-4397-84a5-22ac125ed2f6/accounts/0b107c33-e858-4bbd-abba-f757ae4da1fc,https://au-api.basiq.io/institutions/AU00000,,,
transaction,763ebd58-f029-4138-9c05-ed55e632b2f1,posted,AGL RETAIL ENERGY LTD (GAS),-95.00,0b107c33-e858-4bbd-abba-f757ae4da1fc,8141.56,debit,payment,AU00000,5453f0a3-083c-43c6-9086-adfe94df9918,,,2022-09-08T00:00:00Z,,https://au-api.basiq.io/users/11103cba-4a08-4397-84a5-22ac125ed2f6/transactions/763ebd58-f029-4138-9c05-ed55e632b2f1,https://au-api.basiq.io/users/11103cba-4a08-4397-84a5-22ac125ed2f6/accounts/0b107c33-e858-4bbd-abba-f757ae4da1fc,https://au-api.basiq.io/institutions/AU00000,,Electricity Distribution,263
transaction,f674365c-471d-4f0c-bee6-c355677115fe,posted,AGL RETAIL ENERGY LTD (GAS),-69.00,0b107c33-e858-4bbd-abba-f757ae4da1fc,8236.56,debit,payment,AU00000,5453f0a3-083c-43c6-9086-adfe94df9918,,,2022-09-08T00:00:00Z,,https://au-api.basiq.io/users/11103cba-4a08-4397-84a5-22ac125ed2f6/transactions/f674365c-471d-4f0c-bee6-c355677115fe,https://au-api.basiq.io/users/11103cba-4a08-4397-84a5-22ac125ed2f6/accounts/0b107c33-e858-4bbd-abba-f757ae4da1fc,https://au-api.basiq.io/institutions/AU00000,,Electricity Distribution,263
transaction,de8cfa43-c854-49e5-adae-0540f8377262,posted,Wdl ATM WES IGA BALGOWLAH HGT  BALGOWL        AU,-200.00,0b107c33-e858-4bbd-abba-f757ae4da1fc,8305.56,debit,cash-withdrawal,AU00000,5453f0a3-083c-43c6-9086-adfe94df9918,,,2022-09-07T00:00:00Z,,https://au-api.basiq.io/users/11103cba-4a08-4397-84a5-22ac125ed2f6/transactions/de8cfa43-c854-49e5-adae-0540f8377262,https://au-api.basiq.io/users/11103cba-4a08-4397-84a5-22ac125ed2f6/accounts/0b107c33-e858-4bbd-abba-f757ae4da1fc,https://au-api.basiq.io/institutions/AU00000,,,
transaction,ed34a710-3058-4b28-9079-91ef90940e21,posted,Non Hooli ATM Withdrawal Fee,-2.50,0b107c33-e858-4bbd-abba-f757ae4da1fc,8505.56,debit,bank-fee,AU00000,5453f0a3-083c-43c6-9086-adfe94df9918,,,2022-09-07T00:00:00Z,,https://au-api.basiq.io/users/11103cba-4a08-4397-84a5-22ac125ed2f6/transactions/ed34a710-3058-4b28-9079-91ef90940e21,https://au-api.basiq.io/users/11103cba-4a08-4397-84a5-22ac125ed2f6/accounts/0b107c33-e858-4bbd-abba-f757ae4da1fc,https://au-api.basiq.io/institutions/AU00000,,,
transaction,e25ae48a-fd4a-431d-8bd0-7bcf4f2a158f,posted,MEDIC ALERT,-36.35,0b107c33-e858-4bbd-abba-f757ae4da1fc,8508.06,debit,payment,AU00000,5453f0a3-083c-43c6-9086-adfe94df9918,,,2022-09-01T00:00:00Z,,https://au-api.basiq.io/users/11103cba-4a08-4397-84a5-22ac125ed2f6/transactions/e25ae48a-fd4a-431d-8bd0-7bcf4f2a158f,https://au-api.basiq.io/users/11103cba-4a08-4397-84a5-22ac125ed2f6/accounts/0b107c33-e858-4bbd-abba-f757ae4da1fc,https://au-api.basiq.io/institutions/AU00000,,Other Health Care Services,859
transaction,28b0058a-b256-4a1e-9cf8-e7bbe32197e9,posted,Wdl ATM CBA ATM  BALGOWLAH A    NSW 210901   AUS,-400.00,0b107c33-e858-4bbd-abba-f757ae4da1fc,8544.41,debit,cash-withdrawal,AU00000,5453f0a3-083c-43c6-9086-adfe94df9918,,,2022-08-31T00:00:00Z,,https://au-api.basiq.io/users/11103cba-4a08-4397-84a5-22ac125ed2f6/transactions/28b0058a-b256-4a1e-9cf8-e7bbe32197e9,https://au-api.basiq.io/users/11103cba-4a08-4397-84a5-22ac125ed2f6/accounts/0b107c33-e858-4bbd-abba-f757ae4da1fc,https://au-api.basiq.io/institutions/AU00000,,,
transaction,b4f73b27-1539-44c0-bbb0-2eda72b61a7e,posted,Transfer Platnm Homeloan 346454,-3935.00,0b107c33-e858-4bbd-abba-f757ae4da1fc,8944.41,debit,transfer,AU00000,5453f0a3-083c-43c6-9086-adfe94df9918,,,2022-08-28T00:00:00Z,,https://au-api.basiq.io/users/11103cba-4a08-4397-84a5-22ac125ed2f6/transactions/b4f73b27-1539-44c0-bbb0-2eda72b61a7e,https://au-api.basiq.io/users/11103cba-4a08-4397-84a5-22ac125ed2f6/accounts/0b107c33-e858-4bbd-abba-f757ae4da1fc,https://au-api.basiq.io/institutions/AU00000,,,
transaction,9f33d56c-27b7-4664-98c8-904020aebb65,posted,TFR From Transaction to CC Acc 13,-9323.50,0b107c33-e858-4bbd-abba-f757ae4da1fc,12879.41,debit,transfer,AU00000,5453f0a3-083c-43c6-9086-adfe94df9918,,,2022-08-27T00:00:00Z,,https://au-api.basiq.io/users/11103cba-4a08-4397-84a5-22ac125ed2f6/transactions/9f33d56c-27b7-4664-98c8-904020aebb65,https://au-api.basiq.io/users/11103cba-4a08-4397-84a5-22ac125ed2f6/accounts/0b107c33-e858-4bbd-abba-f757ae4da1fc,https://au-api.basiq.io/institutions/AU00000,,,
transaction,99a01ee4-941c-45ce-bff1-190c2d11219d,posted,Payroll WFRMS 15439393,15985.00,0b107c33-e858-4bbd-abba-f757ae4da1fc,22202.91,credit,transfer,AU00000,5453f0a3-083c-43c6-9086-adfe94df9918,,,2022-08-27T00:00:00Z,,https://au-api.basiq.io/users/11103cba-4a08-4397-84a5-22ac125ed2f6/transactions/99a01ee4-941c-45ce-bff1-190c2d11219d,https://au-api.basiq.io/users/11103cba-4a08-4397-84a5-22ac125ed2f6/accounts/0b107c33-e858-4bbd-abba-f757ae4da1fc,https://au-api.basiq.io/institutions/AU00000,,,
transaction,0ce719d0-be2c-4c0d-a999-edab6390a83d,posted,Manly Maths Tutor Wages,201.00,0b107c33-e858-4bbd-abba-f757ae4da1fc,6217.91,credit,transfer,AU00000,5453f0a3-083c-43c6-9086-adfe94df9918,,,2022-08-17T00:00:00Z,,https://au-api.basiq.io/users/11103cba-4a08-4397-84a5-22ac125ed2f6/transactions/0ce719d0-be2c-4c0d-a999-edab6390a83d,https://au-api.basiq.io/users/11103cba-4a08-4397-84a5-22ac125ed2f6/accounts/0b107c33-e858-4bbd-abba-f757ae4da1fc,https://au-api.basiq.io/institutions/AU00000,,,
transaction,858c588a-6839-41c4-ac70-60c8f195d1ee,posted,MANLY WEST SCHOOL,-2530.81,0b107c33-e858-4bbd-abba-f757ae4da1fc,6016.91,debit,payment,AU00000,5453f0a3-083c-43c6-9086-adfe94df9918,,,2022-08-16T00:00:00Z,,https://au-api.basiq.io/users/11103cba-4a08-4397-84a5-22ac125ed2f6/transactions/858c588a-6839-41c4-ac70-60c8f195d1ee,https://au-api.basiq.io/users/11103cba-4a08-4397-84a5-22ac125ed2f6/accounts/0b107c33-e858-4bbd-abba-f757ae4da1fc,https://au-api.basiq.io/institutions/AU00000,,School Education,802
transaction,9be101a5-5539-4211-81c7-ede07e8dabbe,posted,MANLY WEST SCHOOL,-101.00,0b107c33-e858-4bbd-abba-f757ae4da1fc,8547.72,debit,payment,AU00000,5453f0a3-083c-43c6-9086-adfe94df9918,,,2022-08-16T00:00:00Z,,https://au-api.basiq.io/users/11103cba-4a08-4397-84a5-22ac125ed2f6/transactions/9be101a5-5539-4211-81c7-ede07e8dabbe,https://au-api.basiq.io/users/11103cba-4a08-4397-84a5-22ac125ed2f6/accounts/0b107c33-e858-4bbd-abba-f757ae4da1fc,https://au-api.basiq.io/institutions/AU00000,,School Education,802
transaction,552d2ea3-11a5-4c14-823c-55fbc4705af6,posted,Manly Maths Tutor Wages,201.00,0b107c33-e858-4bbd-abba-f757ae4da1fc,8648.72,credit,transfer,AU00000,5453f0a3-083c-43c6-9086-adfe94df9918,,,2022-08-13T00:00:00Z,,https://au-api.basiq.io/users/11103cba-4a08-4397-84a5-22ac125ed2f6/transactions/552d2ea3-11a5-4c14-823c-55fbc4705af6,https://au-api.basiq.io/users/11103cba-4a08-4397-84a5-22ac125ed2f6/accounts/0b107c33-e858-4bbd-abba-f757ae4da1fc,https://au-api.basiq.io/institutions/AU00000,,,
transaction,ac760323-64c9-483e-aa4d-e517ed4e4f9e,posted,TFR Acc14000 TO 12389,-500.00,0b107c33-e858-4bbd-abba-f757ae4da1fc,8447.72,debit,transfer,AU00000,5453f0a3-083c-43c6-9086-adfe94df9918,,,2022-08-12T00:00:00Z,,https://au-api.basiq.io/users/11103cba-4a08-4397-84a5-22ac125ed2f6/transactions/ac760323-64c9-483e-aa4d-e517ed4e4f9e,https://au-api.basiq.io/users/11103cba-4a08-4397-84a5-22ac125ed2f6/accounts/0b107c33-e858-4bbd-abba-f757ae4da1fc,https://au-api.basiq.io/institutions/AU00000,,,
transaction,58aab59c-a486-4696-a4ca-4d9d0095795b,posted,AGL RETAIL ENERGY LTD,-160.00,0b107c33-e858-4bbd-abba-f757ae4da1fc,8947.72,debit,payment,AU00000,5453f0a3-083c-43c6-9086-adfe94df9918,,,2022-08-09T00:00:00Z,,https://au-api.basiq.io/users/11103cba-4a08-4397-84a5-22ac125ed2f6/transactions/58aab59c-a486-4696-a4ca-4d9d0095795b,https://au-api.basiq.io/users/11103cba-4a08-4397-84a5-22ac125ed2f6/accounts/0b107c33-e858-4bbd-abba-f757ae4da1fc,https://au-api.basiq.io/institutions/AU00000,,Electricity Distribution,263
transaction,27a90f2b-11ec-43d5-a0c2-e551546f1bc9,posted,AGL RETAIL ENERGY LTD (GAS),-69.00,0b107c33-e858-4bbd-abba-f757ae4da1fc,9107.72,debit,payment,AU00000,5453f0a3-083c-43c6-9086-adfe94df9918,,,2022-08-09T00:00:00Z,,https://au-api.basiq.io/users/11103cba-4a08-4397-84a5-22ac125ed2f6/transactions/27a90f2b-11ec-43d5-a0c2-e551546f1bc9,https://au-api.basiq.io/users/11103cba-4a08-4397-84a5-22ac125ed2f6/accounts/0b107c33-e858-4bbd-abba-f757ae4da1fc,https://au-api.basiq.io/institutions/AU00000,,Electricity Distribution,263
transaction,762e069d-9b96-46c3-bf90-1018c3f4fe2c,posted,Wdl ATM WES IGA BALGOWLAH HGT  BALGOWL        AU,-200.00,0b107c33-e858-4bbd-abba-f757ae4da1fc,9176.72,debit,cash-withdrawal,AU00000,5453f0a3-083c-43c6-9086-adfe94df9918,,,2022-08-03T00:00:00Z,,https://au-api.basiq.io/users/11103cba-4a08-4397-84a5-22ac125ed2f6/transactions/762e069d-9b96-46c3-bf90-1018c3f4fe2c,https://au-api.basiq.io/users/11103cba-4a08-4397-84a5-22ac125ed2f6/accounts/0b107c33-e858-4bbd-abba-f757ae4da1fc,https://au-api.basiq.io/institutions/AU00000,,,
transaction,c7e4453a-c1d1-4b55-97ae-addeb74efb03,posted,Non Hooli ATM Withdrawal Fee,-2.50,0b107c33-e858-4bbd-abba-f757ae4da1fc,9376.72,debit,bank-fee,AU00000,5453f0a3-083c-43c6-9086-adfe94df9918,,,2022-08-03T00:00:00Z,,https://au-api.basiq.io/users/11103cba-4a08-4397-84a5-22ac125ed2f6/transactions/c7e4453a-c1d1-4b55-97ae-addeb74efb03,https://au-api.basiq.io/users/11103cba-4a08-4397-84a5-22ac125ed2f6/accounts/0b107c33-e858-4bbd-abba-f757ae4da1fc,https://au-api.basiq.io/institutions/AU00000,,,
transaction,df610556-1075-4f72-80fc-bf0b989660df,posted,Wdl ATM WES IGA BALGOWLAH HGT  BALGOWL        AU,-200.00,0b107c33-e858-4bbd-abba-f757ae4da1fc,9379.22,debit,cash-withdrawal,AU00000,5453f0a3-083c-43c6-9086-adfe94df9918,,,2022-08-03T00:00:00Z,,https://au-api.basiq.io/users/11103cba-4a08-4397-84a5-22ac125ed2f6/transactions/df610556-1075-4f72-80fc-bf0b989660df,https://au-api.basiq.io/users/11103cba-4a08-4397-84a5-22ac125ed2f6/accounts/0b107c33-e858-4bbd-abba-f757ae4da1fc,https://au-api.basiq.io/institutions/AU00000,,,
transaction,9adcd010-68e7-4e15-ab6e-5942d9750b39,posted,Non Hooli ATM Withdrawal Fee,-2.50,0b107c33-e858-4bbd-abba-f757ae4da1fc,9579.22,debit,bank-fee,AU00000,5453f0a3-083c-43c6-9086-adfe94df9918,,,2022-08-03T00:00:00Z,,https://au-api.basiq.io/users/11103cba-4a08-4397-84a5-22ac125ed2f6/transactions/9adcd010-68e7-4e15-ab6e-5942d9750b39,https://au-api.basiq.io/users/11103cba-4a08-4397-84a5-22ac125ed2f6/accounts/0b107c33-e858-4bbd-abba-f757ae4da1fc,https://au-api.basiq.io/institutions/AU00000,,,
transaction,6f08de92-08c9-4a9c-bccc-9f7ae10688bb,posted,Transfer Platnm Homeloan 346454,-3942.50,0b107c33-e858-4bbd-abba-f757ae4da1fc,9581.72,debit,transfer,AU00000,5453f0a3-083c-43c6-9086-adfe94df9918,,,2022-07-29T00:00:00Z,,https://au-api.basiq.io/users/11103cba-4a08-4397-84a5-22ac125ed2f6/transactions/6f08de92-08c9-4a9c-bccc-9f7ae10688bb,https://au-api.basiq.io/users/11103cba-4a08-4397-84a5-22ac125ed2f6/accounts/0b107c33-e858-4bbd-abba-f757ae4da1fc,https://au-api.basiq.io/institutions/AU00000,,,
transaction,4f4c2846-d333-43fd-9ae5-f75fb677d1de,posted,TFR From Transaction to CC Acc 13,-9316.00,0b107c33-e858-4bbd-abba-f757ae4da1fc,13524.22,debit,transfer,AU00000,5453f0a3-083c-43c6-9086-adfe94df9918,,,2022-07-28T00:00:00Z,,https://au-api.basiq.io/users/11103cba-4a08-4397-84a5-22ac125ed2f6/transactions/4f4c2846-d333-43fd-9ae5-f75fb677d1de,https://au-api.basiq.io/users/11103cba-4a08-4397-84a5-22ac125ed2f6/accounts/0b107c33-e858-4bbd-abba-f757ae4da1fc,https://au-api.basiq.io/institutions/AU00000,,,
transaction,6432193d-2551-4eb8-a301-50385be1a5ef,posted,Payroll WFRMS 15439393,15985.00,0b107c33-e858-4bbd-abba-f757ae4da1fc,22840.22,credit,transfer,AU00000,5453f0a3-083c-43c6-9086-adfe94df9918,,,2022-07-28T00:00:00Z,,https://au-api.basiq.io/users/11103cba-4a08-4397-84a5-22ac125ed2f6/transactions/6432193d-2551-4eb8-a301-50385be1a5ef,https://au-api.basiq.io/users/11103cba-4a08-4397-84a5-22ac125ed2f6/accounts/0b107c33-e858-4bbd-abba-f757ae4da1fc,https://au-api.basiq.io/institutions/AU00000,,,
transaction,95f77213-612a-4189-8332-78ad4c287c5d,posted,CTRLINK CARERS Ref: 998R6789201610974V,61.00,0b107c33-e858-4bbd-abba-f757ae4da1fc,6855.22,credit,transfer,AU00000,5453f0a3-083c-43c6-9086-adfe94df9918,,,2022-07-28T00:00:00Z,,https://au-api.basiq.io/users/11103cba-4a08-4397-84a5-22ac125ed2f6/transactions/95f77213-612a-4189-8332-78ad4c287c5d,https://au-api.basiq.io/users/11103cba-4a08-4397-84a5-22ac125ed2f6/accounts/0b107c33-e858-4bbd-abba-f757ae4da1fc,https://au-api.basiq.io/institutions/AU00000,,,
transaction,5d0f07e9-899e-44ed-ab05-61eab4d35610,posted,Manly Maths Tutor Wages,201.00,0b107c33-e858-4bbd-abba-f757ae4da1fc,6794.22,credit,transfer,AU00000,5453f0a3-083c-43c6-9086-adfe94df9918,,,2022-07-17T00:00:00Z,,https://au-api.basiq.io/users/11103cba-4a08-4397-84a5-22ac125ed2f6/transactions/5d0f07e9-899e-44ed-ab05-61eab4d35610,https://au-api.basiq.io/users/11103cba-4a08-4397-84a5-22ac125ed2f6/accounts/0b107c33-e858-4bbd-abba-f757ae4da1fc,https://au-api.basiq.io/institutions/AU00000,,,
transaction,09dde656-7999-47e0-980e-816975747c88,posted,MANLY WEST SCHOOL,-2530.81,0b107c33-e858-4bbd-abba-f757ae4da1fc,6593.22,debit,payment,AU00000,5453f0a3-083c-43c6-9086-adfe94df9918,,,2022-07-15T00:00:00Z,,https://au-api.basiq.io/users/11103cba-4a08-4397-84a5-22ac125ed2f6/transactions/09dde656-7999-47e0-980e-816975747c88,https://au-api.basiq.io/users/11103cba-4a08-4397-84a5-22ac125ed2f6/accounts/0b107c33-e858-4bbd-abba-f757ae4da1fc,https://au-api.basiq.io/institutions/AU00000,,School Education,802
transaction,2109a1f6-665d-4c2e-9b50-9014353ee919,posted,MANLY WEST SCHOOL,-101.00,0b107c33-e858-4bbd-abba-f757ae4da1fc,9124.03,debit,payment,AU00000,5453f0a3-083c-43c6-9086-adfe94df9918,,,2022-07-15T00:00:00Z,,https://au-api.basiq.io/users/11103cba-4a08-4397-84a5-22ac125ed2f6/transactions/2109a1f6-665d-4c2e-9b50-9014353ee919,https://au-api.basiq.io/users/11103cba-4a08-4397-84a5-22ac125ed2f6/accounts/0b107c33-e858-4bbd-abba-f757ae4da1fc,https://au-api.basiq.io/institutions/AU00000,,School Education,802
transaction,15d2f831-c7a6-41e0-b9b6-438a2c025715,posted,Manly Maths Tutor Wages,201.00,0b107c33-e858-4bbd-abba-f757ae4da1fc,9225.03,credit,transfer,AU00000,5453f0a3-083c-43c6-9086-adfe94df9918,,,2022-07-13T00:00:00Z,,https://au-api.basiq.io/users/11103cba-4a08-4397-84a5-22ac125ed2f6/transactions/15d2f831-c7a6-41e0-b9b6-438a2c025715,https://au-api.basiq.io/users/11103cba-4a08-4397-84a5-22ac125ed2f6/accounts/0b107c33-e858-4bbd-abba-f757ae4da1fc,https://au-api.basiq.io/institutions/AU00000,,,
transaction,c53964ac-aaca-4536-87f3-af6c4c323c14,posted,MANLY WEST SCHOOL,-26.00,0b107c33-e858-4bbd-abba-f757ae4da1fc,9024.03,debit,payment,AU00000,5453f0a3-083c-43c6-9086-adfe94df9918,,,2022-07-12T00:00:00Z,,https://au-api.basiq.io/users/11103cba-4a08-4397-84a5-22ac125ed2f6/transactions/c53964ac-aaca-4536-87f3-af6c4c323c14,https://au-api.basiq.io/users/11103cba-4a08-4397-84a5-22ac125ed2f6/accounts/0b107c33-e858-4bbd-abba-f757ae4da1fc,https://au-api.basiq.io/institutions/AU00000,,School Education,802
transaction,2bbed430-4aff-4e44-bab5-14d85f7fa3ab,posted,TFR Acc14000 TO 12389,-500.00,0b107c33-e858-4bbd-abba-f757ae4da1fc,9050.03,debit,transfer,AU00000,5453f0a3-083c-43c6-9086-adfe94df9918,,,2022-07-12T00:00:00Z,,https://au-api.basiq.io/users/11103cba-4a08-4397-84a5-22ac125ed2f6/transactions/2bbed430-4aff-4e44-bab5-14d85f7fa3ab,https://au-api.basiq.io/users/11103cba-4a08-4397-84a5-22ac125ed2f6/accounts/0b107c33-e858-4bbd-abba-f757ae4da1fc,https://au-api.basiq.io/institutions/AU00000,,,
transaction,9af4db44-84b8-4946-b2df-779f7402f2e1,posted,AGL RETAIL ENERGY LTD,-160.00,0b107c33-e858-4bbd-abba-f757ae4da1fc,9550.03,debit,payment,AU00000,5453f0a3-083c-43c6-9086-adfe94df9918,,,2022-07-11T00:00:00Z,,https://au-api.basiq.io/users/11103cba-4a08-4397-84a5-22ac125ed2f6/transactions/9af4db44-84b8-4946-b2df-779f7402f2e1,https://au-api.basiq.io/users/11103cba-4a08-4397-84a5-22ac125ed2f6/accounts/0b107c33-e858-4bbd-abba-f757ae4da1fc,https://au-api.basiq.io/institutions/AU00000,,Electricity Distribution,263
transaction,a769aafc-0a5d-456b-8262-d5e850d440f8,posted,AGL RETAIL ENERGY LTD (GAS),-69.00,0b107c33-e858-4bbd-abba-f757ae4da1fc,9710.03,debit,payment,AU00000,5453f0a3-083c-43c6-9086-adfe94df9918,,,2022-07-11T00:00:00Z,,https://au-api.basiq.io/users/11103cba-4a08-4397-84a5-22ac125ed2f6/transactions/a769aafc-0a5d-456b-8262-d5e850d440f8,https://au-api.basiq.io/users/11103cba-4a08-4397-84a5-22ac125ed2f6/accounts/0b107c33-e858-4bbd-abba-f757ae4da1fc,https://au-api.basiq.io/institutions/AU00000,,Electricity Distribution,263
transaction,3e5b6647-f882-47dc-b8e3-6b6e5d86e5b4,posted,CTRLINK CARERS Ref: 998R6789201610974V,14.00,0b107c33-e858-4bbd-abba-f757ae4da1fc,9779.03,credit,transfer,AU00000,5453f0a3-083c-43c6-9086-adfe94df9918,,,2022-07-06T00:00:00Z,,https://au-api.basiq.io/users/11103cba-4a08-4397-84a5-22ac125ed2f6/transactions/3e5b6647-f882-47dc-b8e3-6b6e5d86e5b4,https://au-api.basiq.io/users/11103cba-4a08-4397-84a5-22ac125ed2f6/accounts/0b107c33-e858-4bbd-abba-f757ae4da1fc,https://au-api.basiq.io/institutions/AU00000,,,
transaction,17cd6549-b353-43ec-9959-66db49eeb33d,posted,Wdl ATM CBA ATM  SEAFORTH       NSW 225101   AUS,-750.00,0b107c33-e858-4bbd-abba-f757ae4da1fc,9765.03,debit,cash-withdrawal,AU00000,5453f0a3-083c-43c6-9086-adfe94df9918,,,2022-07-03T00:00:00Z,,https://au-api.basiq.io/users/11103cba-4a08-4397-84a5-22ac125ed2f6/transactions/17cd6549-b353-43ec-9959-66db49eeb33d,https://au-api.basiq.io/users/11103cba-4a08-4397-84a5-22ac125ed2f6/accounts/0b107c33-e858-4bbd-abba-f757ae4da1fc,https://au-api.basiq.io/institutions/AU00000,,,
transaction,dcd269cf-f73e-4e6e-a9d5-3945780f76ce,posted,Transfer Platnm Homeloan 346454,3927.50,2df58481-c77a-40b1-8249-949cb3ea9670,-354005.75,credit,loan-repayment,AU00000,5453f0a3-083c-43c6-9086-adfe94df9918,,,2022-09-28T00:00:00Z,,https://au-api.basiq.io/users/11103cba-4a08-4397-84a5-22ac125ed2f6/transactions/dcd269cf-f73e-4e6e-a9d5-3945780f76ce,https://au-api.basiq.io/users/11103cba-4a08-4397-84a5-22ac125ed2f6/accounts/2df58481-c77a-40b1-8249-949cb3ea9670,https://au-api.basiq.io/institutions/AU00000,,,
transaction,2590df27-63cd-4ad7-ac12-258ac75f0feb,posted,Mortgage Interest Payment 746833,-3683.25,2df58481-c77a-40b1-8249-949cb3ea9670,-357933.25,debit,loan-interest,AU00000,5453f0a3-083c-43c6-9086-adfe94df9918,,,2022-09-16T00:00:00Z,,https://au-api.basiq.io/users/11103cba-4a08-4397-84a5-22ac125ed2f6/transactions/2590df27-63cd-4ad7-ac12-258ac75f0feb,https://au-api.basiq.io/users/11103cba-4a08-4397-84a5-22ac125ed2f6/accounts/2df58481-c77a-40b1-8249-949cb3ea9670,https://au-api.basiq.io/institutions/AU00000,,,
transaction,f1bf7e90-976b-40d5-816b-143b251d27ad,posted,Transfer Platnm Homeloan 346454,3935.00,2df58481-c77a-40b1-8249-949cb3ea9670,-354250.00,credit,loan-repayment,AU00000,5453f0a3-083c-43c6-9086-adfe94df9918,,,2022-08-28T00:00:00Z,,https://au-api.basiq.io/users/11103cba-4a08-4397-84a5-22ac125ed2f6/transactions/f1bf7e90-976b-40d5-816b-143b251d27ad,https://au-api.basiq.io/users/11103cba-4a08-4397-84a5-22ac125ed2f6/accounts/2df58481-c77a-40b1-8249-949cb3ea9670,https://au-api.basiq.io/institutions/AU00000,,,
transaction,5bb95c4f-ac33-4e1d-a89d-34b2d83ad8ff,posted,Mortgage Interest Payment 746833,-3676.00,2df58481-c77a-40b1-8249-949cb3ea9670,-358185.00,debit,loan-interest,AU00000,5453f0a3-083c-43c6-9086-adfe94df9918,,,2022-08-17T00:00:00Z,,https://au-api.basiq.io/users/11103cba-4a08-4397-84a5-22ac125ed2f6/transactions/5bb95c4f-ac33-4e1d-a89d-34b2d83ad8ff,https://au-api.basiq.io/users/11103cba-4a08-4397-84a5-22ac125ed2f6/accounts/2df58481-c77a-40b1-8249-949cb3ea9670,https://au-api.basiq.io/institutions/AU00000,,,
transaction,456874b1-3ff2-4da8-8323-270e8d9b6308,posted,Transfer Platnm Homeloan 346454,3942.50,2df58481-c77a-40b1-8249-949cb3ea9670,-354509.00,credit,loan-repayment,AU00000,5453f0a3-083c-43c6-9086-adfe94df9918,,,2022-07-29T00:00:00Z,,https://au-api.basiq.io/users/11103cba-4a08-4397-84a5-22ac125ed2f6/transactions/456874b1-3ff2-4da8-8323-270e8d9b6308,https://au-api.basiq.io/users/11103cba-4a08-4397-84a5-22ac125ed2f6/accounts/2df58481-c77a-40b1-8249-949cb3ea9670,https://au-api.basiq.io/institutions/AU00000,,,
transaction,d54c9014-6c10-4504-9853-6c65f0f7d686,posted,Mortgage Interest Payment 746833,-3668.25,2df58481-c77a-40b1-8249-949cb3ea9670,-358451.50,debit,loan-interest,AU00000,5453f0a3-083c-43c6-9086-adfe94df9918,,,2022-07-17T00:00:00Z,,https://au-api.basiq.io/users/11103cba-4a08-4397-84a5-22ac125ed2f6/transactions/d54c9014-6c10-4504-9853-6c65f0f7d686,https://au-api.basiq.io/users/11103cba-4a08-4397-84a5-22ac125ed2f6/accounts/2df58481-c77a-40b1-8249-949cb3ea9670,https://au-api.basiq.io/institutions/AU00000,,,
transaction,9340e903-3e7f-4d19-9430-4572dfb33b6f,posted,TOP MARQUES AUTOMOTI FORESTVILLE AU,-40.00,49544383-c19c-4c97-b8d1-5322d0faa6af,-991.66,debit,payment,AU00000,5453f0a3-083c-43c6-9086-adfe94df9918,,,2022-09-29T00:00:00Z,,https://au-api.basiq.io/users/11103cba-4a08-4397-84a5-22ac125ed2f6/transactions/9340e903-3e7f-4d19-9430-4572dfb33b6f,https://au-api.basiq.io/users/11103cba-4a08-4397-84a5-22ac125ed2f6/accounts/49544383-c19c-4c97-b8d1-5322d0faa6af,https://au-api.basiq.io/institutions/AU00000,,Automotive Repair and Maintenance,941
transaction,e1a86b92-54f6-423a-8740-90157fe37225,posted,SOURCE BULK FOODS WILL,-67.79,49544383-c19c-4c97-b8d1-5322d0faa6af,-951.66,debit,payment,AU00000,5453f0a3-083c-43c6-9086-adfe94df9918,,,2022-09-29T00:00:00Z,,https://au-api.basiq.io/users/11103cba-4a08-4397-84a5-22ac125ed2f6/transactions/e1a86b92-54f6-423a-8740-90157fe37225,https://au-api.basiq.io/users/11103cba-4a08-4397-84a5-22ac125ed2f6/accounts/49544383-c19c-4c97-b8d1-5322d0faa6af,https://au-api.basiq.io/institutions/AU00000,,Specialised Food Retailing,412
transaction,c1db8d9b-7634-49da-9f9f-261184aa529f,posted,WALTONWAY PTY. LTD. WILL,-23.00,49544383-c19c-4c97-b8d1-5322d0faa6af,-883.87,debit,payment,AU00000,5453f0a3-083c-43c6-9086-adfe94df9918,,,2022-09-29T00:00:00Z,,https://au-api.basiq.io/users/11103cba-4a08-4397-84a5-22ac125ed2f6/transactions/c1db8d9b-7634-49da-9f9f-261184aa529f,https://au-api.basiq.io/users/11103cba-4a08-4397-84a5-22ac125ed2f6/accounts/49544383-c19c-4c97-b8d1-5322d0faa6af,https://au-api.basiq.io/institutions/AU00000,,Unknown,0
transaction,bc99e9e5-343b-4ad4-ab29-31b9208ecb3d,posted,WOOLWORTHS 1063 FR FREN,-2.25,49544383-c19c-4c97-b8d1-5322d0faa6af,-860.87,debit,payment,AU00000,5453f0a3-083c-43c6-9086-adfe94df9918,,,2022-09-29T00:00:00Z,,https://au-api.basiq.io/users/11103cba-4a08-4397-84a5-22ac125ed2f6/transactions/bc99e9e5-343b-4ad4-ab29-31b9208ecb3d,https://au-api.basiq.io/users/11103cba-4a08-4397-84a5-22ac125ed2f6/accounts/49544383-c19c-4c97-b8d1-5322d0faa6af,https://au-api.basiq.io/institutions/AU00000,,Supermarket and Grocery Stores,411
transaction,efa6d74c-d980-49b9-9e4c-d82323c07b9b,posted,Only About Children Seaforth 1244301,-157.00,49544383-c19c-4c97-b8d1-5322d0faa6af,-858.62,debit,payment,AU00000,5453f0a3-083c-43c6-9086-adfe94df9918,,,2022-09-29T00:00:00Z,,https://au-api.basiq.io/users/11103cba-4a08-4397-84a5-22ac125ed2f6/transactions/efa6d74c-d980-49b9-9e4c-d82323c07b9b,https://au-api.basiq.io/users/11103cba-4a08-4397-84a5-22ac125ed2f6/accounts/49544383-c19c-4c97-b8d1-5322d0faa6af,https://au-api.basiq.io/institutions/AU00000,,Other Health Care Services,859
transaction,50d82edb-9018-41f9-93d3-7cf6fdd2490c,posted,HEADYS PTY LTD BROO,-36.84,49544383-c19c-4c97-b8d1-5322d0faa6af,-701.62,debit,payment,AU00000,5453f0a3-083c-43c6-9086-adfe94df9918,,,2022-09-28T00:00:00Z,,https://au-api.basiq.io/users/11103cba-4a08-4397-84a5-22ac125ed2f6/transactions/50d82edb-9018-41f9-93d3-7cf6fdd2490c,https://au-api.basiq.io/users/11103cba-4a08-4397-84a5-22ac125ed2f6/accounts/49544383-c19c-4c97-b8d1-5322d0faa6af,https://au-api.basiq.io/institutions/AU00000,,Specialised Food Retailing,412
transaction,e455e36e-ae53-4201-a199-8e6e3b69e398,posted,LE PARISIEN KILL,-32.50,49544383-c19c-4c97-b8d1-5322d0faa6af,-664.78,debit,payment,AU00000,5453f0a3-083c-43c6-9086-adfe94df9918,,,2022-09-28T00:00:00Z,,https://au-api.basiq.io/users/11103cba-4a08-4397-84a5-22ac125ed2f6/transactions/e455e36e-ae53-4201-a199-8e6e3b69e398,https://au-api.basiq.io/users/11103cba-4a08-4397-84a5-22ac125ed2f6/accounts/49544383-c19c-4c97-b8d1-5322d0faa6af,https://au-api.basiq.io/institutions/AU00000,,"Cafes, Restaurants and Takeaway Food Services",451
transaction,1d25046b-9493-4dfe-ade0-7c831781b770,posted,MAVEN DENTAL GROUP P NEUTRAL BAY AU,-421.00,49544383-c19c-4c97-b8d1-5322d0faa6af,-632.28,debit,payment,AU00000,5453f0a3-083c-43c6-9086-adfe94df9918,,,2022-09-28T00:00:00Z,,https://au-api.basiq.io/users/11103cba-4a08-4397-84a5-22ac125ed2f6/transactions/1d25046b-9493-4dfe-ade0-7c831781b770,https://au-api.basiq.io/users/11103cba-4a08-4397-84a5-22ac125ed2f6/accounts/49544383-c19c-4c97-b8d1-5322d0faa6af,https://au-api.basiq.io/institutions/AU00000,,Allied Health Services,853
transaction,e24a05d2-0cb3-43e6-9f3b-386d8163537c,posted,BISTROT GAVROCHE CHIP,-492.00,49544383-c19c-4c97-b8d1-5322d0faa6af,-211.28,debit,payment,AU00000,5453f0a3-083c-43c6-9086-adfe94df9918,,,2022-09-27T00:00:00Z,,https://au-api.basiq.io/users/11103cba-4a08-4397-84a5-22ac125ed2f6/transactions/e24a05d2-0cb3-43e6-9f3b-386d8163537c,https://au-api.basiq.io/users/11103cba-4a08-4397-84a5-22ac125ed2f6/accounts/49544383-c19c-4c97-b8d1-5322d0faa6af,https://au-api.basiq.io/institutions/AU00000,,"Cafes, Restaurants and Takeaway Food Services",451
transaction,edabb7db-dc74-491f-974c-eedb0f286e5d,posted,FRATELLI POLITO PROD CROM,-86.00,49544383-c19c-4c97-b8d1-5322d0faa6af,280.72,debit,payment,AU00000,5453f0a3-083c-43c6-9086-adfe94df9918,,,2022-09-27T00:00:00Z,,https://au-api.basiq.io/users/11103cba-4a08-4397-84a5-22ac125ed2f6/transactions/edabb7db-dc74-491f-974c-eedb0f286e5d,https://au-api.basiq.io/users/11103cba-4a08-4397-84a5-22ac125ed2f6/accounts/49544383-c19c-4c97-b8d1-5322d0faa6af,https://au-api.basiq.io/institutions/AU00000,,Specialised Food Retailing,412
transaction,6e64acbb-eeac-4c92-80ba-f9d25cc1f8be,posted,MIRAMARE GARDENS BOU TERR,-59.50,49544383-c19c-4c97-b8d1-5322d0faa6af,366.72,debit,payment,AU00000,5453f0a3-083c-43c6-9086-adfe94df9918,,,2022-09-27T00:00:00Z,,https://au-api.basiq.io/users/11103cba-4a08-4397-84a5-22ac125ed2f6/transactions/6e64acbb-eeac-4c92-80ba-f9d25cc1f8be,https://au-api.basiq.io/users/11103cba-4a08-4397-84a5-22ac125ed2f6/accounts/49544383-c19c-4c97-b8d1-5322d0faa6af,https://au-api.basiq.io/institutions/AU00000,,Accommodation,440
transaction,7e9abd9c-6fcc-4b7e-82e9-1e43fd0dc5e5,posted,TFR From Transaction to CC Acc 13,9331.00,49544383-c19c-4c97-b8d1-5322d0faa6af,426.22,credit,transfer,AU00000,5453f0a3-083c-43c6-9086-adfe94df9918,,,2022-09-27T00:00:00Z,,https://au-api.basiq.io/users/11103cba-4a08-4397-84a5-22ac125ed2f6/transactions/7e9abd9c-6fcc-4b7e-82e9-1e43fd0dc5e5,https://au-api.basiq.io/users/11103cba-4a08-4397-84a5-22ac125ed2f6/accounts/49544383-c19c-4c97-b8d1-5322d0faa6af,https://au-api.basiq.io/institutions/AU00000,,,
transaction,98e956fa-bbc8-4656-9f1a-80c6289418ca,posted,BMT TAX DEPRECIATION,-716.00,49544383-c19c-4c97-b8d1-5322d0faa6af,-8904.78,debit,payment,AU00000,5453f0a3-083c-43c6-9086-adfe94df9918,,,2022-09-27T00:00:00Z,,https://au-api.basiq.io/users/11103cba-4a08-4397-84a5-22ac125ed2f6/transactions/98e956fa-bbc8-4656-9f1a-80c6289418ca,https://au-api.basiq.io/users/11103cba-4a08-4397-84a5-22ac125ed2f6/accounts/49544383-c19c-4c97-b8d1-5322d0faa6af,https://au-api.basiq.io/institutions/AU00000,,Legal and Accounting Services,693
transaction,4fd09b4e-73ec-41ef-a14c-7b937bca5510,posted,BUNNINGS 551000 WARR,-90.70,49544383-c19c-4c97-b8d1-5322d0faa6af,-8188.78,debit,payment,AU00000,5453f0a3-083c-43c6-9086-adfe94df9918,,,2022-09-26T00:00:00Z,,https://au-api.basiq.io/users/11103cba-4a08-4397-84a5-22ac125ed2f6/transactions/4fd09b4e-73ec-41ef-a14c-7b937bca5510,https://au-api.basiq.io/users/11103cba-4a08-4397-84a5-22ac125ed2f6/accounts/49544383-c19c-4c97-b8d1-5322d0faa6af,https://au-api.basiq.io/institutions/AU00000,,"Hardware, Building and Garden Supplies Retailing",423
transaction,a76e5af6-2614-41ab-ad78-b2512e2f696d,posted,EB *Wildlife Photograp 801-,-80.00,49544383-c19c-4c97-b8d1-5322d0faa6af,-8098.08,debit,payment,AU00000,5453f0a3-083c-43c6-9086-adfe94df9918,,,2022-09-26T00:00:00Z,,https://au-api.basiq.io/users/11103cba-4a08-4397-84a5-22ac125ed2f6/transactions/a76e5af6-2614-41ab-ad78-b2512e2f696d,https://au-api.basiq.io/users/11103cba-4a08-4397-84a5-22ac125ed2f6/accounts/49544383-c19c-4c97-b8d1-5322d0faa6af,https://au-api.basiq.io/institutions/AU00000,,Other Administrative Services,729
transaction,cb89f3a8-81e7-486d-97c7-5c4ec6306191,posted,RADIO CAIRO CREM,-46.00,49544383-c19c-4c97-b8d1-5322d0faa6af,-8018.08,debit,payment,AU00000,5453f0a3-083c-43c6-9086-adfe94df9918,,,2022-09-26T00:00:00Z,,https://au-api.basiq.io/users/11103cba-4a08-4397-84a5-22ac125ed2f6/transactions/cb89f3a8-81e7-486d-97c7-5c4ec6306191,https://au-api.basiq.io/users/11103cba-4a08-4397-84a5-22ac125ed2f6/accounts/49544383-c19c-4c97-b8d1-5322d0faa6af,https://au-api.basiq.io/institutions/AU00000,,Television Broadcasting,562
transaction,c88c2173-fbe1-4904-9f30-ee4ba49ab2bf,posted,AGSR TRAILERS PTY LT CROMER AU,-559.00,49544383-c19c-4c97-b8d1-5322d0faa6af,-7972.08,debit,payment,AU00000,5453f0a3-083c-43c6-9086-adfe94df9918,,,2022-09-26T00:00:00Z,,https://au-api.basiq.io/users/11103cba-4a08-4397-84a5-22ac125ed2f6/transactions/c88c2173-fbe1-4904-9f30-ee4ba49ab2bf,https://au-api.basiq.io/users/11103cba-4a08-4397-84a5-22ac125ed2f6/accounts/49544383-c19c-4c97-b8d1-5322d0faa6af,https://au-api.basiq.io/institutions/AU00000,,Motor Vehicle Retailing,391
transaction,9f9245ce-c49a-4815-b402-ef2452e7ed63,posted,TOP MARQUES AUTOMOTI FORESTVILLE AU,-32.00,49544383-c19c-4c97-b8d1-5322d0faa6af,-7413.08,debit,payment,AU00000,5453f0a3-083c-43c6-9086-adfe94df9918,,,2022-09-25T00:00:00Z,,https://au-api.basiq.io/users/11103cba-4a08-4397-84a5-22ac125ed2f6/transactions/9f9245ce-c49a-4815-b402-ef2452e7ed63,https://au-api.basiq.io/users/11103cba-4a08-4397-84a5-22ac125ed2f6/accounts/49544383-c19c-4c97-b8d1-5322d0faa6af,https://au-api.basiq.io/institutions/AU00000,,Automotive Repair and Maintenance,941
transaction,28b8b7d7-b61f-44b5-85d8-ccbabc91e90e,posted,BP FORESTVILLE 2227 FORE,-53.14,49544383-c19c-4c97-b8d1-5322d0faa6af,-7381.08,debit,payment,AU00000,5453f0a3-083c-43c6-9086-adfe94df9918,,,2022-09-25T00:00:00Z,,https://au-api.basiq.io/users/11103cba-4a08-4397-84a5-22ac125ed2f6/transactions/28b8b7d7-b61f-44b5-85d8-ccbabc91e90e,https://au-api.basiq.io/users/11103cba-4a08-4397-84a5-22ac125ed2f6/accounts/49544383-c19c-4c97-b8d1-5322d0faa6af,https://au-api.basiq.io/institutions/AU00000,,Fuel Retailing,400
transaction,9978b98f-6b68-4dc1-960a-15ac1987f51b,posted,WOOLWORTHS 1262 BELR,-233.80,49544383-c19c-4c97-b8d1-5322d0faa6af,-7327.94,debit,payment,AU00000,5453f0a3-083c-43c6-9086-adfe94df9918,,,2022-09-24T00:00:00Z,,https://au-api.basiq.io/users/11103cba-4a08-4397-84a5-22ac125ed2f6/transactions/9978b98f-6b68-4dc1-960a-15ac1987f51b,https://au-api.basiq.io/users/11103cba-4a08-4397-84a5-22ac125ed2f6/accounts/49544383-c19c-4c97-b8d1-5322d0faa6af,https://au-api.basiq.io/institutions/AU00000,,Supermarket and Grocery Stores,411
transaction,1496cb85-e857-4777-836f-15e3a81d0627,posted,AGL SALES P/L 0307 MELB,-48.64,49544383-c19c-4c97-b8d1-5322d0faa6af,-7094.14,debit,payment,AU00000,5453f0a3-083c-43c6-9086-adfe94df9918,,,2022-09-22T00:00:00Z,,https://au-api.basiq.io/users/11103cba-4a08-4397-84a5-22ac125ed2f6/transactions/1496cb85-e857-4777-836f-15e3a81d0627,https://au-api.basiq.io/users/11103cba-4a08-4397-84a5-22ac125ed2f6/accounts/49544383-c19c-4c97-b8d1-5322d0faa6af,https://au-api.basiq.io/institutions/AU00000,,Electricity Distribution,263
transaction,832a48f0-b878-4057-9bd0-dd4f6b8958aa,posted,Impulse Chiropractic Nort,-46.00,49544383-c19c-4c97-b8d1-5322d0faa6af,-7045.50,debit,payment,AU00000,5453f0a3-083c-43c6-9086-adfe94df9918,,,2022-09-22T00:00:00Z,,https://au-api.basiq.io/users/11103cba-4a08-4397-84a5-22ac125ed2f6/transactions/832a48f0-b878-4057-9bd0-dd4f6b8958aa,https://au-api.basiq.io/users/11103cba-4a08-4397-84a5-22ac125ed2f6/accounts/49544383-c19c-4c97-b8d1-5322d0faa6af,https://au-api.basiq.io/institutions/AU00000,,Allied Health Services,853
transaction,cff9bb31-4446-445d-ad52-53e0089153ef,posted,COOH NTH CURL CURL NORT,-46.00,49544383-c19c-4c97-b8d1-5322d0faa6af,-6999.50,debit,payment,AU00000,5453f0a3-083c-43c6-9086-adfe94df9918,,,2022-09-22T00:00:00Z,,https://au-api.basiq.io/users/11103cba-4a08-4397-84a5-22ac125ed2f6/transactions/cff9bb31-4446-445d-ad52-53e0089153ef,https://au-api.basiq.io/users/11103cba-4a08-4397-84a5-22ac125ed2f6/accounts/49544383-c19c-4c97-b8d1-5322d0faa6af,https://au-api.basiq.io/institutions/AU00000,,"Cafes, Restaurants and Takeaway Food Services",451
transaction,b812a3dd-79a1-4d05-980b-45f36c09791a,posted,Only About Children Seaforth 1244301,-157.00,49544383-c19c-4c97-b8d1-5322d0faa6af,-6953.50,debit,payment,AU00000,5453f0a3-083c-43c6-9086-adfe94df9918,,,2022-09-22T00:00:00Z,,https://au-api.basiq.io/users/11103cba-4a08-4397-84a5-22ac125ed2f6/transactions/b812a3dd-79a1-4d05-980b-45f36c09791a,https://au-api.basiq.io/users/11103cba-4a08-4397-84a5-22ac125ed2f6/accounts/49544383-c19c-4c97-b8d1-5322d0faa6af,https://au-api.basiq.io/institutions/AU00000,,Other Health Care Services,859
transaction,1df3a9bb-768f-4fd2-949f-aa280f01e1e3,posted,CNSLT GNRL DE FRNCE SYDN,-80.40,49544383-c19c-4c97-b8d1-5322d0faa6af,-6796.50,debit,payment,AU00000,5453f0a3-083c-43c6-9086-adfe94df9918,,,2022-09-21T00:00:00Z,,https://au-api.basiq.io/users/11103cba-4a08-4397-84a5-22ac125ed2f6/transactions/1df3a9bb-768f-4fd2-949f-aa280f01e1e3,https://au-api.basiq.io/users/11103cba-4a08-4397-84a5-22ac125ed2f6/accounts/49544383-c19c-4c97-b8d1-5322d0faa6af,https://au-api.basiq.io/institutions/AU00000,,Management and Related Consulting Services,696
transaction,28b5df11-bb98-4133-9936-621ce69a5e6c,posted,NAKED FOOD WARRINGAH BOND,-66.10,49544383-c19c-4c97-b8d1-5322d0faa6af,-6716.10,debit,payment,AU00000,5453f0a3-083c-43c6-9086-adfe94df9918,,,2022-09-21T00:00:00Z,,https://au-api.basiq.io/users/11103cba-4a08-4397-84a5-22ac125ed2f6/transactions/28b5df11-bb98-4133-9936-621ce69a5e6c,https://au-api.basiq.io/users/11103cba-4a08-4397-84a5-22ac125ed2f6/accounts/49544383-c19c-4c97-b8d1-5322d0faa6af,https://au-api.basiq.io/institutions/AU00000,,Specialised Food Retailing,412
transaction,3b356a25-89c2-49f9-b3d4-ece960023187,posted,HEADYS PTY LTD BROO,-30.75,49544383-c19c-4c97-b8d1-5322d0faa6af,-6650.00,debit,payment,AU00000,5453f0a3-083c-43c6-9086-adfe94df9918,,,2022-09-21T00:00:00Z,,https://au-api.basiq.io/users/11103cba-4a08-4397-84a5-22ac125ed2f6/transactions/3b356a25-89c2-49f9-b3d4-ece960023187,https://au-api.basiq.io/users/11103cba-4a08-4397-84a5-22ac125ed2f6/accounts/49544383-c19c-4c97-b8d1-5322d0faa6af,https://au-api.basiq.io/institutions/AU00000,,Specialised Food Retailing,412
transaction,c4b190f7-1c16-4212-90c0-a047fc1f0aad,posted,WOOLWORTHS 1262 BELR,-29.13,49544383-c19c-4c97-b8d1-5322d0faa6af,-6619.25,debit,payment,AU00000,5453f0a3-083c-43c6-9086-adfe94df9918,,,2022-09-21T00:00:00Z,,https://au-api.basiq.io/users/11103cba-4a08-4397-84a5-22ac125ed2f6/transactions/c4b190f7-1c16-4212-90c0-a047fc1f0aad,https://au-api.basiq.io/users/11103cba-4a08-4397-84a5-22ac125ed2f6/accounts/49544383-c19c-4c97-b8d1-5322d0faa6af,https://au-api.basiq.io/institutions/AU00000,,Supermarket and Grocery Stores,411
transaction,07602e50-4a99-46a0-a4c5-540c1f41eec6,posted,WOOLWORTHS 1262 BELR,-6.20,49544383-c19c-4c97-b8d1-5322d0faa6af,-6590.12,debit,payment,AU00000,5453f0a3-083c-43c6-9086-adfe94df9918,,,2022-09-21T00:00:00Z,,https://au-api.basiq.io/users/11103cba-4a08-4397-84a5-22ac125ed2f6/transactions/07602e50-4a99-46a0-a4c5-540c1f41eec6,https://au-api.basiq.io/users/11103cba-4a08-4397-84a5-22ac125ed2f6/accounts/49544383-c19c-4c97-b8d1-5322d0faa6af,https://au-api.basiq.io/institutions/AU00000,,Supermarket and Grocery Stores,411
transaction,8021968a-046c-4b17-b6fe-b6ca59ff2b27,posted,NORTHERN BEACHES COUNCIL - SOUTH RATES,-369.00,49544383-c19c-4c97-b8d1-5322d0faa6af,-6583.92,debit,payment,AU00000,5453f0a3-083c-43c6-9086-adfe94df9918,,,2022-09-21T00:00:00Z,,https://au-api.basiq.io/users/11103cba-4a08-4397-84a5-22ac125ed2f6/transactions/8021968a-046c-4b17-b6fe-b6ca59ff2b27,https://au-api.basiq.io/users/11103cba-4a08-4397-84a5-22ac125ed2f6/accounts/49544383-c19c-4c97-b8d1-5322d0faa6af,https://au-api.basiq.io/institutions/AU00000,,Local Government Administration,753
transaction,62595b48-3632-4461-8e89-c6e3f09e7de5,posted,HEADYS PTY LTD BROO,-37.21,49544383-c19c-4c97-b8d1-5322d0faa6af,-6214.92,debit,payment,AU00000,5453f0a3-083c-43c6-9086-adfe94df9918,,,2022-09-20T00:00:00Z,,https://au-api.basiq.io/users/11103cba-4a08-4397-84a5-22ac125ed2f6/transactions/62595b48-3632-4461-8e89-c6e3f09e7de5,https://au-api.basiq.io/users/11103cba-4a08-4397-84a5-22ac125ed2f6/accounts/49544383-c19c-4c97-b8d1-5322d0faa6af,https://au-api.basiq.io/institutions/AU00000,,Specialised Food Retailing,412
transaction,9cba23db-01a2-469b-9ca9-97f3663fbe6d,posted,OFARM ORGANIC GROCER BROO,-33.69,49544383-c19c-4c97-b8d1-5322d0faa6af,-6177.71,debit,payment,AU00000,5453f0a3-083c-43c6-9086-adfe94df9918,,,2022-09-20T00:00:00Z,,https://au-api.basiq.io/users/11103cba-4a08-4397-84a5-22ac125ed2f6/transactions/9cba23db-01a2-469b-9ca9-97f3663fbe6d,https://au-api.basiq.io/users/11103cba-4a08-4397-84a5-22ac125ed2f6/accounts/49544383-c19c-4c97-b8d1-5322d0faa6af,https://au-api.basiq.io/institutions/AU00000,,Supermarket and Grocery Stores,411
transaction,806bb77c-926f-4c50-a21b-6f05112d7545,posted,TASTE BAGUETTE GLNRS BELR,-21.20,49544383-c19c-4c97-b8d1-5322d0faa6af,-6144.02,debit,payment,AU00000,5453f0a3-083c-43c6-9086-adfe94df9918,,,2022-09-20T00:00:00Z,,https://au-api.basiq.io/users/11103cba-4a08-4397-84a5-22ac125ed2f6/transactions/806bb77c-926f-4c50-a21b-6f05112d7545,https://au-api.basiq.io/users/11103cba-4a08-4397-84a5-22ac125ed2f6/accounts/49544383-c19c-4c97-b8d1-5322d0faa6af,https://au-api.basiq.io/institutions/AU00000,,"Cafes, Restaurants and Takeaway Food Services",451
transaction,89a902b6-8e21-481b-b7ce-b6f92830bee6,posted,WOOLWORTHS 1282 BROO,-20.40,49544383-c19c-4c97-b8d1-5322d0faa6af,-6122.82,debit,payment,AU00000,5453f0a3-083c-43c6-9086-adfe94df9918,,,2022-09-20T00:00:00Z,,https://au-api.basiq.io/users/11103cba-4a08-4397-84a5-22ac125ed2f6/transactions/89a902b6-8e21-481b-b7ce-b6f92830bee6,https://au-api.basiq.io/users/11103cba-4a08-4397-84a5-22ac125ed2f6/accounts/49544383-c19c-4c97-b8d1-5322d0faa6af,https://au-api.basiq.io/institutions/AU00000,,Supermarket and Grocery Stores,411
transaction,9efe2808-8d9d-4138-b905-8d6d816d3f8e,posted,NAKED FOOD WARRINGAH BOND,-11.90,49544383-c19c-4c97-b8d1-5322d0faa6af,-6102.42,debit,payment,AU00000,5453f0a3-083c-43c6-9086-adfe94df9918,,,2022-09-20T00:00:00Z,,https://au-api.basiq.io/users/11103cba-4a08-4397-84a5-22ac125ed2f6/transactions/9efe2808-8d9d-4138-b905-8d6d816d3f8e,https://au-api.basiq.io/users/11103cba-4a08-4397-84a5-22ac125ed2f6/accounts/49544383-c19c-4c97-b8d1-5322d0faa6af,https://au-api.basiq.io/institutions/AU00000,,Specialised Food Retailing,412
transaction,b6714de1-c0f5-472f-a6e3-55356fa4fb62,posted,Mail Redirection Serv MELB,-245.70,49544383-c19c-4c97-b8d1-5322d0faa6af,-6090.52,debit,payment,AU00000,5453f0a3-083c-43c6-9086-adfe94df9918,,,2022-09-19T00:00:00Z,,https://au-api.basiq.io/users/11103cba-4a08-4397-84a5-22ac125ed2f6/transactions/b6714de1-c0f5-472f-a6e3-55356fa4fb62,https://au-api.basiq.io/users/11103cba-4a08-4397-84a5-22ac125ed2f6/accounts/49544383-c19c-4c97-b8d1-5322d0faa6af,https://au-api.basiq.io/institutions/AU00000,,Postal and Courier Pick-up and Delivery Services,510
transaction,42f0c1f9-d0c2-4b06-8dec-c885a7278208,posted,Harry Hartog Warr,-52.97,49544383-c19c-4c97-b8d1-5322d0faa6af,-5844.82,debit,payment,AU00000,5453f0a3-083c-43c6-9086-adfe94df9918,,,2022-09-19T00:00:00Z,,https://au-api.basiq.io/users/11103cba-4a08-4397-84a5-22ac125ed2f6/transactions/42f0c1f9-d0c2-4b06-8dec-c885a7278208,https://au-api.basiq.io/users/11103cba-4a08-4397-84a5-22ac125ed2f6/accounts/49544383-c19c-4c97-b8d1-5322d0faa6af,https://au-api.basiq.io/institutions/AU00000,,Recreational Goods Retailing,424
transaction,f5572b44-514f-4185-9e48-3a8f28261aae,posted,BIG W 0145 WARRING BROO,-6.00,49544383-c19c-4c97-b8d1-5322d0faa6af,-5791.85,debit,payment,AU00000,5453f0a3-083c-43c6-9086-adfe94df9918,,,2022-09-19T00:00:00Z,,https://au-api.basiq.io/users/11103cba-4a08-4397-84a5-22ac125ed2f6/transactions/f5572b44-514f-4185-9e48-3a8f28261aae,https://au-api.basiq.io/users/11103cba-4a08-4397-84a5-22ac125ed2f6/accounts/49544383-c19c-4c97-b8d1-5322d0faa6af,https://au-api.basiq.io/institutions/AU00000,,Department Stores,426
transaction,3e913dbb-24f9-4857-a646-c17f68098666,posted,eDebit 201465-10556,-59.55,49544383-c19c-4c97-b8d1-5322d0faa6af,-5785.85,debit,payment,AU00000,5453f0a3-083c-43c6-9086-adfe94df9918,,,2022-09-19T00:00:00Z,,https://au-api.basiq.io/users/11103cba-4a08-4397-84a5-22ac125ed2f6/transactions/3e913dbb-24f9-4857-a646-c17f68098666,https://au-api.basiq.io/users/11103cba-4a08-4397-84a5-22ac125ed2f6/accounts/49544383-c19c-4c97-b8d1-5322d0faa6af,https://au-api.basiq.io/institutions/AU00000,,Unknown,0
transaction,d0d07899-adcd-414c-9297-045d320de5b3,posted,WOOLWORTHS 1262 BELR,-60.78,49544383-c19c-4c97-b8d1-5322d0faa6af,-5726.30,debit,payment,AU00000,5453f0a3-083c-43c6-9086-adfe94df9918,,,2022-09-18T00:00:00Z,,https://au-api.basiq.io/users/11103cba-4a08-4397-84a5-22ac125ed2f6/transactions/d0d07899-adcd-414c-9297-045d320de5b3,https://au-api.basiq.io/users/11103cba-4a08-4397-84a5-22ac125ed2f6/accounts/49544383-c19c-4c97-b8d1-5322d0faa6af,https://au-api.basiq.io/institutions/AU00000,,Supermarket and Grocery Stores,411
transaction,12ce8b04-d1cc-4f01-8243-21025c4b12e2,posted,TASTE BAGUETTE GLNRS BELR,-21.40,49544383-c19c-4c97-b8d1-5322d0faa6af,-5665.52,debit,payment,AU00000,5453f0a3-083c-43c6-9086-adfe94df9918,,,2022-09-18T00:00:00Z,,https://au-api.basiq.io/users/11103cba-4a08-4397-84a5-22ac125ed2f6/transactions/12ce8b04-d1cc-4f01-8243-21025c4b12e2,https://au-api.basiq.io/users/11103cba-4a08-4397-84a5-22ac125ed2f6/accounts/49544383-c19c-4c97-b8d1-5322d0faa6af,https://au-api.basiq.io/institutions/AU00000,,"Cafes, Restaurants and Takeaway Food Services",451
transaction,01e61ce9-8e18-4d95-9f4b-22dedfb04ab4,posted,BELROSE CHEMIST BELR,-20.76,49544383-c19c-4c97-b8d1-5322d0faa6af,-5644.12,debit,payment,AU00000,5453f0a3-083c-43c6-9086-adfe94df9918,,,2022-09-18T00:00:00Z,,https://au-api.basiq.io/users/11103cba-4a08-4397-84a5-22ac125ed2f6/transactions/01e61ce9-8e18-4d95-9f4b-22dedfb04ab4,https://au-api.basiq.io/users/11103cba-4a08-4397-84a5-22ac125ed2f6/accounts/49544383-c19c-4c97-b8d1-5322d0faa6af,https://au-api.basiq.io/institutions/AU00000,,Pharmaceutical and Other Store-Based Retailing,427
transaction,654b2dbb-850c-406f-ae9f-a33482c05f7d,posted,Cash Wdr  46      SYDNEY    02,-104.50,49544383-c19c-4c97-b8d1-5322d0faa6af,-5623.36,debit,cash-withdrawal,AU00000,5453f0a3-083c-43c6-9086-adfe94df9918,,,2022-09-18T00:00:00Z,,https://au-api.basiq.io/users/11103cba-4a08-4397-84a5-22ac125ed2f6/transactions/654b2dbb-850c-406f-ae9f-a33482c05f7d,https://au-api.basiq.io/users/11103cba-4a08-4397-84a5-22ac125ed2f6/accounts/49544383-c19c-4c97-b8d1-5322d0faa6af,https://au-api.basiq.io/institutions/AU00000,,,
transaction,ac631eb2-9c41-4f08-b8b4-4f5548026aee,posted,WOOLWORTHS 1282 WRINGAH MALL NSW AU,-54.98,49544383-c19c-4c97-b8d1-5322d0faa6af,-5518.86,debit,payment,AU00000,5453f0a3-083c-43c6-9086-adfe94df9918,,,2022-09-17T00:00:00Z,,https://au-api.basiq.io/users/11103cba-4a08-4397-84a5-22ac125ed2f6/transactions/ac631eb2-9c41-4f08-b8b4-4f5548026aee,https://au-api.basiq.io/users/11103cba-4a08-4397-84a5-22ac125ed2f6/accounts/49544383-c19c-4c97-b8d1-5322d0faa6af,https://au-api.basiq.io/institutions/AU00000,,Supermarket and Grocery Stores,411
transaction,479686d5-edd8-4032-baa9-7b6dc02b778b,posted,SYDNEY WATER,-169.38,49544383-c19c-4c97-b8d1-5322d0faa6af,-5463.88,debit,payment,AU00000,5453f0a3-083c-43c6-9086-adfe94df9918,,,2022-09-16T00:00:00Z,,https://au-api.basiq.io/users/11103cba-4a08-4397-84a5-22ac125ed2f6/transactions/479686d5-edd8-4032-baa9-7b6dc02b778b,https://au-api.basiq.io/users/11103cba-4a08-4397-84a5-22ac125ed2f6/accounts/49544383-c19c-4c97-b8d1-5322d0faa6af,https://au-api.basiq.io/institutions/AU00000,,"Water Supply, Sewerage and Drainage Services",281
transaction,f15e0ad1-69c0-4546-b980-d53ea66f875e,posted,Venture Health Manly Manl,-158.50,49544383-c19c-4c97-b8d1-5322d0faa6af,-5294.50,debit,payment,AU00000,5453f0a3-083c-43c6-9086-adfe94df9918,,,2022-09-15T00:00:00Z,,https://au-api.basiq.io/users/11103cba-4a08-4397-84a5-22ac125ed2f6/transactions/f15e0ad1-69c0-4546-b980-d53ea66f875e,https://au-api.basiq.io/users/11103cba-4a08-4397-84a5-22ac125ed2f6/accounts/49544383-c19c-4c97-b8d1-5322d0faa6af,https://au-api.basiq.io/institutions/AU00000,,Specialised Food Retailing,412
transaction,4392e3f5-b801-43fa-a2b0-91e4bc9dda94,posted,CTX WOW BELROSE BELR,-53.32,49544383-c19c-4c97-b8d1-5322d0faa6af,-5136.00,debit,payment,AU00000,5453f0a3-083c-43c6-9086-adfe94df9918,,,2022-09-15T00:00:00Z,,https://au-api.basiq.io/users/11103cba-4a08-4397-84a5-22ac125ed2f6/transactions/4392e3f5-b801-43fa-a2b0-91e4bc9dda94,https://au-api.basiq.io/users/11103cba-4a08-4397-84a5-22ac125ed2f6/accounts/49544383-c19c-4c97-b8d1-5322d0faa6af,https://au-api.basiq.io/institutions/AU00000,,Fuel Retailing,400
transaction,9d5e6e7f-0ecd-420d-9a10-a30daa72da14,posted,MOMOKKO BELR,-32.80,49544383-c19c-4c97-b8d1-5322d0faa6af,-5082.68,debit,payment,AU00000,5453f0a3-083c-43c6-9086-adfe94df9918,,,2022-09-15T00:00:00Z,,https://au-api.basiq.io/users/11103cba-4a08-4397-84a5-22ac125ed2f6/transactions/9d5e6e7f-0ecd-420d-9a10-a30daa72da14,https://au-api.basiq.io/users/11103cba-4a08-4397-84a5-22ac125ed2f6/accounts/49544383-c19c-4c97-b8d1-5322d0faa6af,https://au-api.basiq.io/institutions/AU00000,,"Cafes, Restaurants and Takeaway Food Services",451
transaction,c85b96a4-4e09-4c9c-8d6d-96ba87bf41ec,posted,METROPOLE CAFE QVB,-12.10,49544383-c19c-4c97-b8d1-5322d0faa6af,-5049.88,debit,payment,AU00000,5453f0a3-083c-43c6-9086-adfe94df9918,,,2022-09-15T00:00:00Z,,https://au-api.basiq.io/users/11103cba-4a08-4397-84a5-22ac125ed2f6/transactions/c85b96a4-4e09-4c9c-8d6d-96ba87bf41ec,https://au-api.basiq.io/users/11103cba-4a08-4397-84a5-22ac125ed2f6/accounts/49544383-c19c-4c97-b8d1-5322d0faa6af,https://au-api.basiq.io/institutions/AU00000,,"Cafes, Restaurants and Takeaway Food Services",451
transaction,4911350d-6922-47af-887c-ea1effb9ed0f,posted,Ora Manl,-7.00,49544383-c19c-4c97-b8d1-5322d0faa6af,-5037.78,debit,payment,AU00000,5453f0a3-083c-43c6-9086-adfe94df9918,,,2022-09-15T00:00:00Z,,https://au-api.basiq.io/users/11103cba-4a08-4397-84a5-22ac125ed2f6/transactions/4911350d-6922-47af-887c-ea1effb9ed0f,https://au-api.basiq.io/users/11103cba-4a08-4397-84a5-22ac125ed2f6/accounts/49544383-c19c-4c97-b8d1-5322d0faa6af,https://au-api.basiq.io/institutions/AU00000,,"Cafes, Restaurants and Takeaway Food Services",451
transaction,65aa662e-0fa9-4fbd-b9e8-080393dd52bc,posted,Only About Children Seaforth 1244301,-157.00,49544383-c19c-4c97-b8d1-5322d0faa6af,-5030.78,debit,payment,AU00000,5453f0a3-083c-43c6-9086-adfe94df9918,,,2022-09-15T00:00:00Z,,https://au-api.basiq.io/users/11103cba-4a08-4397-84a5-22ac125ed2f6/transactions/65aa662e-0fa9-4fbd-b9e8-080393dd52bc,https://au-api.basiq.io/users/11103cba-4a08-4397-84a5-22ac125ed2f6/accounts/49544383-c19c-4c97-b8d1-5322d0faa6af,https://au-api.basiq.io/institutions/AU00000,,Other Health Care Services,859
transaction,08f1c43f-4a0b-48a3-936f-7340ab199075,posted,HFM MANLY MANLY AU,-71.43,49544383-c19c-4c97-b8d1-5322d0faa6af,-4873.78,debit,payment,AU00000,5453f0a3-083c-43c6-9086-adfe94df9918,,,2022-09-15T00:00:00Z,,https://au-api.basiq.io/users/11103cba-4a08-4397-84a5-22ac125ed2f6/transactions/08f1c43f-4a0b-48a3-936f-7340ab199075,https://au-api.basiq.io/users/11103cba-4a08-4397-84a5-22ac125ed2f6/accounts/49544383-c19c-4c97-b8d1-5322d0faa6af,https://au-api.basiq.io/institutions/AU00000,,Supermarket and Grocery Stores,411
transaction,cf6905fc-0bec-444a-8c0a-cbbb4fc7a874,posted,HEADYS PTY LTD BROO,-83.86,49544383-c19c-4c97-b8d1-5322d0faa6af,-4802.35,debit,payment,AU00000,5453f0a3-083c-43c6-9086-adfe94df9918,,,2022-09-14T00:00:00Z,,https://au-api.basiq.io/users/11103cba-4a08-4397-84a5-22ac125ed2f6/transactions/cf6905fc-0bec-444a-8c0a-cbbb4fc7a874,https://au-api.basiq.io/users/11103cba-4a08-4397-84a5-22ac125ed2f6/accounts/49544383-c19c-4c97-b8d1-5322d0faa6af,https://au-api.basiq.io/institutions/AU00000,,Specialised Food Retailing,412
transaction,2d9823eb-3e49-475a-a8f2-284dda6cabee,posted,GINSENG HEALTH FOODS FREN,-58.15,49544383-c19c-4c97-b8d1-5322d0faa6af,-4718.49,debit,payment,AU00000,5453f0a3-083c-43c6-9086-adfe94df9918,,,2022-09-14T00:00:00Z,,https://au-api.basiq.io/users/11103cba-4a08-4397-84a5-22ac125ed2f6/transactions/2d9823eb-3e49-475a-a8f2-284dda6cabee,https://au-api.basiq.io/users/11103cba-4a08-4397-84a5-22ac125ed2f6/accounts/49544383-c19c-4c97-b8d1-5322d0faa6af,https://au-api.basiq.io/institutions/AU00000,,Specialised Food Retailing,412
transaction,18ef8c51-363a-4ad0-86d5-e9c402295d3d,posted,OFARM ORGANIC GROCER BROO,-31.99,49544383-c19c-4c97-b8d1-5322d0faa6af,-4660.34,debit,payment,AU00000,5453f0a3-083c-43c6-9086-adfe94df9918,,,2022-09-14T00:00:00Z,,https://au-api.basiq.io/users/11103cba-4a08-4397-84a5-22ac125ed2f6/transactions/18ef8c51-363a-4ad0-86d5-e9c402295d3d,https://au-api.basiq.io/users/11103cba-4a08-4397-84a5-22ac125ed2f6/accounts/49544383-c19c-4c97-b8d1-5322d0faa6af,https://au-api.basiq.io/institutions/AU00000,,Supermarket and Grocery Stores,411
transaction,5f3aa2f9-3ca9-4220-94e6-7d739428918f,posted,FRATELLI POLITO PROD CROM,-61.00,49544383-c19c-4c97-b8d1-5322d0faa6af,-4628.35,debit,payment,AU00000,5453f0a3-083c-43c6-9086-adfe94df9918,,,2022-09-13T00:00:00Z,,https://au-api.basiq.io/users/11103cba-4a08-4397-84a5-22ac125ed2f6/transactions/5f3aa2f9-3ca9-4220-94e6-7d739428918f,https://au-api.basiq.io/users/11103cba-4a08-4397-84a5-22ac125ed2f6/accounts/49544383-c19c-4c97-b8d1-5322d0faa6af,https://au-api.basiq.io/institutions/AU00000,,Specialised Food Retailing,412
transaction,3a3c1c48-039e-4198-a640-4472ce320077,posted,HEADYS PTY LTD BROO,-40.97,49544383-c19c-4c97-b8d1-5322d0faa6af,-4567.35,debit,payment,AU00000,5453f0a3-083c-43c6-9086-adfe94df9918,,,2022-09-13T00:00:00Z,,https://au-api.basiq.io/users/11103cba-4a08-4397-84a5-22ac125ed2f6/transactions/3a3c1c48-039e-4198-a640-4472ce320077,https://au-api.basiq.io/users/11103cba-4a08-4397-84a5-22ac125ed2f6/accounts/49544383-c19c-4c97-b8d1-5322d0faa6af,https://au-api.basiq.io/institutions/AU00000,,Specialised Food Retailing,412
transaction,4fcbcc67-5fa5-481e-bc5b-f0e8d307a73e,posted,POST BELROSE WEST BELR,-29.75,49544383-c19c-4c97-b8d1-5322d0faa6af,-4526.38,debit,payment,AU00000,5453f0a3-083c-43c6-9086-adfe94df9918,,,2022-09-13T00:00:00Z,,https://au-api.basiq.io/users/11103cba-4a08-4397-84a5-22ac125ed2f6/transactions/4fcbcc67-5fa5-481e-bc5b-f0e8d307a73e,https://au-api.basiq.io/users/11103cba-4a08-4397-84a5-22ac125ed2f6/accounts/49544383-c19c-4c97-b8d1-5322d0faa6af,https://au-api.basiq.io/institutions/AU00000,,Postal and Courier Pick-up and Delivery Services,510
transaction,bf67181a-c389-4212-bb82-f0cacbbd0fb2,posted,NAKED FOOD WARRINGAH BOND,-25.42,49544383-c19c-4c97-b8d1-5322d0faa6af,-4496.63,debit,payment,AU00000,5453f0a3-083c-43c6-9086-adfe94df9918,,,2022-09-13T00:00:00Z,,https://au-api.basiq.io/users/11103cba-4a08-4397-84a5-22ac125ed2f6/transactions/bf67181a-c389-4212-bb82-f0cacbbd0fb2,https://au-api.basiq.io/users/11103cba-4a08-4397-84a5-22ac125ed2f6/accounts/49544383-c19c-4c97-b8d1-5322d0faa6af,https://au-api.basiq.io/institutions/AU00000,,Specialised Food Retailing,412
transaction,3b43103d-6e1c-4871-a0e7-38374c54e496,posted,OPTUS PREPAID MELBOURN,-40.00,49544383-c19c-4c97-b8d1-5322d0faa6af,-4471.21,debit,payment,AU00000,5453f0a3-083c-43c6-9086-adfe94df9918,,,2022-09-13T00:00:00Z,,https://au-api.basiq.io/users/11103cba-4a08-4397-84a5-22ac125ed2f6/transactions/3b43103d-6e1c-4871-a0e7-38374c54e496,https://au-api.basiq.io/users/11103cba-4a08-4397-84a5-22ac125ed2f6/accounts/49544383-c19c-4c97-b8d1-5322d0faa6af,https://au-api.basiq.io/institutions/AU00000,,Telecommunications Services,580
transaction,7d04183f-2234-4ef1-baa2-5df61565837d,posted,WOOLWORTHS 1282 BROO,-95.98,49544383-c19c-4c97-b8d1-5322d0faa6af,-4431.21,debit,payment,AU00000,5453f0a3-083c-43c6-9086-adfe94df9918,,,2022-09-12T00:00:00Z,,https://au-api.basiq.io/users/11103cba-4a08-4397-84a5-22ac125ed2f6/transactions/7d04183f-2234-4ef1-baa2-5df61565837d,https://au-api.basiq.io/users/11103cba-4a08-4397-84a5-22ac125ed2f6/accounts/49544383-c19c-4c97-b8d1-5322d0faa6af,https://au-api.basiq.io/institutions/AU00000,,Supermarket and Grocery Stores,411
transaction,67e9db97-3a98-4e6e-ae2d-8d4ff37dfabd,posted,NAKED FOOD WARRINGAH BOND,-47.87,49544383-c19c-4c97-b8d1-5322d0faa6af,-4335.23,debit,payment,AU00000,5453f0a3-083c-43c6-9086-adfe94df9918,,,2022-09-12T00:00:00Z,,https://au-api.basiq.io/users/11103cba-4a08-4397-84a5-22ac125ed2f6/transactions/67e9db97-3a98-4e6e-ae2d-8d4ff37dfabd,https://au-api.basiq.io/users/11103cba-4a08-4397-84a5-22ac125ed2f6/accounts/49544383-c19c-4c97-b8d1-5322d0faa6af,https://au-api.basiq.io/institutions/AU00000,,Specialised Food Retailing,412
transaction,682f0cba-191f-4152-81e3-864b5d7cb60f,posted,MLI HOLDINGS PTY. LI CHAT,-39.00,49544383-c19c-4c97-b8d1-5322d0faa6af,-4287.36,debit,payment,AU00000,5453f0a3-083c-43c6-9086-adfe94df9918,,,2022-09-12T00:00:00Z,,https://au-api.basiq.io/users/11103cba-4a08-4397-84a5-22ac125ed2f6/transactions/682f0cba-191f-4152-81e3-864b5d7cb60f,https://au-api.basiq.io/users/11103cba-4a08-4397-84a5-22ac125ed2f6/accounts/49544383-c19c-4c97-b8d1-5322d0faa6af,https://au-api.basiq.io/institutions/AU00000,,"Cafes, Restaurants and Takeaway Food Services",451
transaction,211260ce-56c6-4740-ae98-0ee9339a6f4a,posted,THAI KITCHEN GELNROS BELR,-23.00,49544383-c19c-4c97-b8d1-5322d0faa6af,-4248.36,debit,payment,AU00000,5453f0a3-083c-43c6-9086-adfe94df9918,,,2022-09-12T00:00:00Z,,https://au-api.basiq.io/users/11103cba-4a08-4397-84a5-22ac125ed2f6/transactions/211260ce-56c6-4740-ae98-0ee9339a6f4a,https://au-api.basiq.io/users/11103cba-4a08-4397-84a5-22ac125ed2f6/accounts/49544383-c19c-4c97-b8d1-5322d0faa6af,https://au-api.basiq.io/institutions/AU00000,,"Cafes, Restaurants and Takeaway Food Services",451
transaction,6fc45b4e-2bbb-46ca-a722-b3a256829532,posted,SMIGGLE S20 BROO,-22.95,49544383-c19c-4c97-b8d1-5322d0faa6af,-4225.36,debit,payment,AU00000,5453f0a3-083c-43c6-9086-adfe94df9918,,,2022-09-12T00:00:00Z,,https://au-api.basiq.io/users/11103cba-4a08-4397-84a5-22ac125ed2f6/transactions/6fc45b4e-2bbb-46ca-a722-b3a256829532,https://au-api.basiq.io/users/11103cba-4a08-4397-84a5-22ac125ed2f6/accounts/49544383-c19c-4c97-b8d1-5322d0faa6af,https://au-api.basiq.io/institutions/AU00000,,Pharmaceutical and Other Store-Based Retailing,427
transaction,96bc2ed9-8a0d-4d42-8346-3ac864db2608,posted,WOOLWORTHS 1282 BROO,-19.00,49544383-c19c-4c97-b8d1-5322d0faa6af,-4202.41,debit,payment,AU00000,5453f0a3-083c-43c6-9086-adfe94df9918,,,2022-09-12T00:00:00Z,,https://au-api.basiq.io/users/11103cba-4a08-4397-84a5-22ac125ed2f6/transactions/96bc2ed9-8a0d-4d42-8346-3ac864db2608,https://au-api.basiq.io/users/11103cba-4a08-4397-84a5-22ac125ed2f6/accounts/49544383-c19c-4c97-b8d1-5322d0faa6af,https://au-api.basiq.io/institutions/AU00000,,Supermarket and Grocery Stores,411
transaction,59a3143a-fcf5-499c-9fde-9e610e99e7d2,posted,Cash Wdr  42   SYDNEY       AU,-104.50,49544383-c19c-4c97-b8d1-5322d0faa6af,-4183.41,debit,cash-withdrawal,AU00000,5453f0a3-083c-43c6-9086-adfe94df9918,,,2022-09-10T00:00:00Z,,https://au-api.basiq.io/users/11103cba-4a08-4397-84a5-22ac125ed2f6/transactions/59a3143a-fcf5-499c-9fde-9e610e99e7d2,https://au-api.basiq.io/users/11103cba-4a08-4397-84a5-22ac125ed2f6/accounts/49544383-c19c-4c97-b8d1-5322d0faa6af,https://au-api.basiq.io/institutions/AU00000,,,
transaction,5f3b194e-5db0-460d-9374-3839d1758600,posted,AGL RETAIL ENERGY LTD (GAS),-115.52,49544383-c19c-4c97-b8d1-5322d0faa6af,-4078.91,debit,payment,AU00000,5453f0a3-083c-43c6-9086-adfe94df9918,,,2022-09-08T00:00:00Z,,https://au-api.basiq.io/users/11103cba-4a08-4397-84a5-22ac125ed2f6/transactions/5f3b194e-5db0-460d-9374-3839d1758600,https://au-api.basiq.io/users/11103cba-4a08-4397-84a5-22ac125ed2f6/accounts/49544383-c19c-4c97-b8d1-5322d0faa6af,https://au-api.basiq.io/institutions/AU00000,,Electricity Distribution,263
transaction,d973f45f-d1c2-4119-ba05-8db2a926cb4b,posted,AGL RETAIL ENERGY LTD,-219.59,49544383-c19c-4c97-b8d1-5322d0faa6af,-3963.39,debit,payment,AU00000,5453f0a3-083c-43c6-9086-adfe94df9918,,,2022-09-08T00:00:00Z,,https://au-api.basiq.io/users/11103cba-4a08-4397-84a5-22ac125ed2f6/transactions/d973f45f-d1c2-4119-ba05-8db2a926cb4b,https://au-api.basiq.io/users/11103cba-4a08-4397-84a5-22ac125ed2f6/accounts/49544383-c19c-4c97-b8d1-5322d0faa6af,https://au-api.basiq.io/institutions/AU00000,,Electricity Distribution,263
transaction,ad56f8af-f840-49f3-b309-4741372ff7d5,posted,RMS ETOLL PH 131865 PARR,-51.22,49544383-c19c-4c97-b8d1-5322d0faa6af,-3743.80,debit,payment,AU00000,5453f0a3-083c-43c6-9086-adfe94df9918,,,2022-09-08T00:00:00Z,,https://au-api.basiq.io/users/11103cba-4a08-4397-84a5-22ac125ed2f6/transactions/ad56f8af-f840-49f3-b309-4741372ff7d5,https://au-api.basiq.io/users/11103cba-4a08-4397-84a5-22ac125ed2f6/accounts/49544383-c19c-4c97-b8d1-5322d0faa6af,https://au-api.basiq.io/institutions/AU00000,,Unknown,0
transaction,3e22c913-15a4-4a67-89c0-d7073c6b22c5,posted,Only About Children Seaforth 1244301,-157.00,49544383-c19c-4c97-b8d1-5322d0faa6af,-3692.58,debit,payment,AU00000,5453f0a3-083c-43c6-9086-adfe94df9918,,,2022-09-08T00:00:00Z,,https://au-api.basiq.io/users/11103cba-4a08-4397-84a5-22ac125ed2f6/transactions/3e22c913-15a4-4a67-89c0-d7073c6b22c5,https://au-api.basiq.io/users/11103cba-4a08-4397-84a5-22ac125ed2f6/accounts/49544383-c19c-4c97-b8d1-5322d0faa6af,https://au-api.basiq.io/institutions/AU00000,,Other Health Care Services,859
transaction,61a581c1-fb65-49d4-b0f3-59403536faf6,posted,WOOLWORTHS 1262 BELR,-83.64,49544383-c19c-4c97-b8d1-5322d0faa6af,-3535.58,debit,payment,AU00000,5453f0a3-083c-43c6-9086-adfe94df9918,,,2022-09-08T00:00:00Z,,https://au-api.basiq.io/users/11103cba-4a08-4397-84a5-22ac125ed2f6/transactions/61a581c1-fb65-49d4-b0f3-59403536faf6,https://au-api.basiq.io/users/11103cba-4a08-4397-84a5-22ac125ed2f6/accounts/49544383-c19c-4c97-b8d1-5322d0faa6af,https://au-api.basiq.io/institutions/AU00000,,Supermarket and Grocery Stores,411
transaction,e4543797-5ef6-4e02-947c-e8f09b8fc11f,posted,LE PARISIEN KILL,-26.50,49544383-c19c-4c97-b8d1-5322d0faa6af,-3451.94,debit,payment,AU00000,5453f0a3-083c-43c6-9086-adfe94df9918,,,2022-09-07T00:00:00Z,,https://au-api.basiq.io/users/11103cba-4a08-4397-84a5-22ac125ed2f6/transactions/e4543797-5ef6-4e02-947c-e8f09b8fc11f,https://au-api.basiq.io/users/11103cba-4a08-4397-84a5-22ac125ed2f6/accounts/49544383-c19c-4c97-b8d1-5322d0faa6af,https://au-api.basiq.io/institutions/AU00000,,"Cafes, Restaurants and Takeaway Food Services",451
transaction,d56409af-fbe8-4f0e-b293-fc6b22043cea,posted,ATOS FRAMING BROO,-401.00,49544383-c19c-4c97-b8d1-5322d0faa6af,-3425.44,debit,payment,AU00000,5453f0a3-083c-43c6-9086-adfe94df9918,,,2022-09-06T00:00:00Z,,https://au-api.basiq.io/users/11103cba-4a08-4397-84a5-22ac125ed2f6/transactions/d56409af-fbe8-4f0e-b293-fc6b22043cea,https://au-api.basiq.io/users/11103cba-4a08-4397-84a5-22ac125ed2f6/accounts/49544383-c19c-4c97-b8d1-5322d0faa6af,https://au-api.basiq.io/institutions/AU00000,,Pharmaceutical and Other Store-Based Retailing,427
transaction,fcefee3b-a034-4ebb-8b1e-0e1d47da481e,posted,TPG Internet PTY LTD Nort,-59.99,49544383-c19c-4c97-b8d1-5322d0faa6af,-3024.44,debit,payment,AU00000,5453f0a3-083c-43c6-9086-adfe94df9918,,,2022-09-06T00:00:00Z,,https://au-api.basiq.io/users/11103cba-4a08-4397-84a5-22ac125ed2f6/transactions/fcefee3b-a034-4ebb-8b1e-0e1d47da481e,https://au-api.basiq.io/users/11103cba-4a08-4397-84a5-22ac125ed2f6/accounts/49544383-c19c-4c97-b8d1-5322d0faa6af,https://au-api.basiq.io/institutions/AU00000,,Internet Service Providers and Web Search Portals,591
transaction,c9a37442-a833-44ea-a6c8-bf2e61107273,posted,CRUISING YACHT CLUB DARL,-22.50,49544383-c19c-4c97-b8d1-5322d0faa6af,-2964.45,debit,payment,AU00000,5453f0a3-083c-43c6-9086-adfe94df9918,,,2022-09-06T00:00:00Z,,https://au-api.basiq.io/users/11103cba-4a08-4397-84a5-22ac125ed2f6/transactions/c9a37442-a833-44ea-a6c8-bf2e61107273,https://au-api.basiq.io/users/11103cba-4a08-4397-84a5-22ac125ed2f6/accounts/49544383-c19c-4c97-b8d1-5322d0faa6af,https://au-api.basiq.io/institutions/AU00000,,"Cafes, Restaurants and Takeaway Food Services",451
transaction,e1d4c97f-cc96-49c0-bf19-105211d2b627,posted,THE HONEST CHCKEN PL BELR,-17.90,49544383-c19c-4c97-b8d1-5322d0faa6af,-2941.95,debit,payment,AU00000,5453f0a3-083c-43c6-9086-adfe94df9918,,,2022-09-06T00:00:00Z,,https://au-api.basiq.io/users/11103cba-4a08-4397-84a5-22ac125ed2f6/transactions/e1d4c97f-cc96-49c0-bf19-105211d2b627,https://au-api.basiq.io/users/11103cba-4a08-4397-84a5-22ac125ed2f6/accounts/49544383-c19c-4c97-b8d1-5322d0faa6af,https://au-api.basiq.io/institutions/AU00000,,"Cafes, Restaurants and Takeaway Food Services",451
transaction,f2f930b6-515c-43f8-8933-c83be8b390fb,posted,BILL BUCKLE AUTO PAR BROOKVALE AU,-389.49,49544383-c19c-4c97-b8d1-5322d0faa6af,-2924.05,debit,payment,AU00000,5453f0a3-083c-43c6-9086-adfe94df9918,,,2022-09-06T00:00:00Z,,https://au-api.basiq.io/users/11103cba-4a08-4397-84a5-22ac125ed2f6/transactions/f2f930b6-515c-43f8-8933-c83be8b390fb,https://au-api.basiq.io/users/11103cba-4a08-4397-84a5-22ac125ed2f6/accounts/49544383-c19c-4c97-b8d1-5322d0faa6af,https://au-api.basiq.io/institutions/AU00000,,Motor Vehicle Retailing,391
transaction,5bdda720-7ba0-4734-b616-dd678efb4247,posted,METRO PETROLEUM FR FORE,-57.21,49544383-c19c-4c97-b8d1-5322d0faa6af,-2534.56,debit,payment,AU00000,5453f0a3-083c-43c6-9086-adfe94df9918,,,2022-09-05T00:00:00Z,,https://au-api.basiq.io/users/11103cba-4a08-4397-84a5-22ac125ed2f6/transactions/5bdda720-7ba0-4734-b616-dd678efb4247,https://au-api.basiq.io/users/11103cba-4a08-4397-84a5-22ac125ed2f6/accounts/49544383-c19c-4c97-b8d1-5322d0faa6af,https://au-api.basiq.io/institutions/AU00000,,Fuel Retailing,400
transaction,a3000e40-b099-4be3-8dd3-c48c186ecfb7,posted,HAYDEN THEATRES CREM,-36.00,49544383-c19c-4c97-b8d1-5322d0faa6af,-2477.35,debit,payment,AU00000,5453f0a3-083c-43c6-9086-adfe94df9918,,,2022-09-05T00:00:00Z,,https://au-api.basiq.io/users/11103cba-4a08-4397-84a5-22ac125ed2f6/transactions/a3000e40-b099-4be3-8dd3-c48c186ecfb7,https://au-api.basiq.io/users/11103cba-4a08-4397-84a5-22ac125ed2f6/accounts/49544383-c19c-4c97-b8d1-5322d0faa6af,https://au-api.basiq.io/institutions/AU00000,,Motion Picture and Video Activities,551
transaction,d6dc5d98-c0a0-4374-b2fe-36aba7dc4b74,posted,WOOLWORTHS 1262 BELR,-29.60,49544383-c19c-4c97-b8d1-5322d0faa6af,-2441.35,debit,payment,AU00000,5453f0a3-083c-43c6-9086-adfe94df9918,,,2022-09-05T00:00:00Z,,https://au-api.basiq.io/users/11103cba-4a08-4397-84a5-22ac125ed2f6/transactions/d6dc5d98-c0a0-4374-b2fe-36aba7dc4b74,https://au-api.basiq.io/users/11103cba-4a08-4397-84a5-22ac125ed2f6/accounts/49544383-c19c-4c97-b8d1-5322d0faa6af,https://au-api.basiq.io/institutions/AU00000,,Supermarket and Grocery Stores,411
transaction,e861fad6-fb19-41aa-a8b7-41e159951a55,posted,MLI HOLDINGS PTY LIM ST L,-14.50,49544383-c19c-4c97-b8d1-5322d0faa6af,-2411.75,debit,payment,AU00000,5453f0a3-083c-43c6-9086-adfe94df9918,,,2022-09-05T00:00:00Z,,https://au-api.basiq.io/users/11103cba-4a08-4397-84a5-22ac125ed2f6/transactions/e861fad6-fb19-41aa-a8b7-41e159951a55,https://au-api.basiq.io/users/11103cba-4a08-4397-84a5-22ac125ed2f6/accounts/49544383-c19c-4c97-b8d1-5322d0faa6af,https://au-api.basiq.io/institutions/AU00000,,"Cafes, Restaurants and Takeaway Food Services",451
transaction,a5e5a1a0-78af-4b21-8f8e-6c717f06a8a6,posted,eDebit 201465-10554,-59.55,49544383-c19c-4c97-b8d1-5322d0faa6af,-2397.25,debit,payment,AU00000,5453f0a3-083c-43c6-9086-adfe94df9918,,,2022-09-05T00:00:00Z,,https://au-api.basiq.io/users/11103cba-4a08-4397-84a5-22ac125ed2f6/transactions/a5e5a1a0-78af-4b21-8f8e-6c717f06a8a6,https://au-api.basiq.io/users/11103cba-4a08-4397-84a5-22ac125ed2f6/accounts/49544383-c19c-4c97-b8d1-5322d0faa6af,https://au-api.basiq.io/institutions/AU00000,,Unknown,0
transaction,df6f8859-ade9-4271-989d-127099401674,posted,FIKA SWEDISH KITCHEN MANL,-35.00,49544383-c19c-4c97-b8d1-5322d0faa6af,-2337.70,debit,payment,AU00000,5453f0a3-083c-43c6-9086-adfe94df9918,,,2022-09-04T00:00:00Z,,https://au-api.basiq.io/users/11103cba-4a08-4397-84a5-22ac125ed2f6/transactions/df6f8859-ade9-4271-989d-127099401674,https://au-api.basiq.io/users/11103cba-4a08-4397-84a5-22ac125ed2f6/accounts/49544383-c19c-4c97-b8d1-5322d0faa6af,https://au-api.basiq.io/institutions/AU00000,,"Cafes, Restaurants and Takeaway Food Services",451
transaction,8c736abc-7eb8-43b2-86e8-be09f68ee828,posted,THAI KITCHEN GELNROS BELR,-12.00,49544383-c19c-4c97-b8d1-5322d0faa6af,-2302.70,debit,payment,AU00000,5453f0a3-083c-43c6-9086-adfe94df9918,,,2022-09-04T00:00:00Z,,https://au-api.basiq.io/users/11103cba-4a08-4397-84a5-22ac125ed2f6/transactions/8c736abc-7eb8-43b2-86e8-be09f68ee828,https://au-api.basiq.io/users/11103cba-4a08-4397-84a5-22ac125ed2f6/accounts/49544383-c19c-4c97-b8d1-5322d0faa6af,https://au-api.basiq.io/institutions/AU00000,,"Cafes, Restaurants and Takeaway Food Services",451
transaction,fe966195-6245-45ac-9305-b073bd09a90f,posted,BUNNINGS 588000 BELROSE AU,-29.20,49544383-c19c-4c97-b8d1-5322d0faa6af,-2290.70,debit,payment,AU00000,5453f0a3-083c-43c6-9086-adfe94df9918,,,2022-09-03T00:00:00Z,,https://au-api.basiq.io/users/11103cba-4a08-4397-84a5-22ac125ed2f6/transactions/fe966195-6245-45ac-9305-b073bd09a90f,https://au-api.basiq.io/users/11103cba-4a08-4397-84a5-22ac125ed2f6/accounts/49544383-c19c-4c97-b8d1-5322d0faa6af,https://au-api.basiq.io/institutions/AU00000,,"Hardware, Building and Garden Supplies Retailing",423
transaction,a42384a6-52ab-48d7-ad83-967586e2374d,posted,POST BELROSE WEST LP AU,-142.00,49544383-c19c-4c97-b8d1-5322d0faa6af,-2261.50,debit,payment,AU00000,5453f0a3-083c-43c6-9086-adfe94df9918,,,2022-09-02T00:00:00Z,,https://au-api.basiq.io/users/11103cba-4a08-4397-84a5-22ac125ed2f6/transactions/a42384a6-52ab-48d7-ad83-967586e2374d,https://au-api.basiq.io/users/11103cba-4a08-4397-84a5-22ac125ed2f6/accounts/49544383-c19c-4c97-b8d1-5322d0faa6af,https://au-api.basiq.io/institutions/AU00000,,Postal and Courier Pick-up and Delivery Services,510
transaction,6a823d20-2f75-4c0b-a4a4-a6479ca972e6,posted,Cash Wdr  LPO           NSW AU,-167.95,49544383-c19c-4c97-b8d1-5322d0faa6af,-2119.50,debit,cash-withdrawal,AU00000,5453f0a3-083c-43c6-9086-adfe94df9918,,,2022-09-02T00:00:00Z,,https://au-api.basiq.io/users/11103cba-4a08-4397-84a5-22ac125ed2f6/transactions/6a823d20-2f75-4c0b-a4a4-a6479ca972e6,https://au-api.basiq.io/users/11103cba-4a08-4397-84a5-22ac125ed2f6/accounts/49544383-c19c-4c97-b8d1-5322d0faa6af,https://au-api.basiq.io/institutions/AU00000,,,
transaction,3a14cf59-d1ee-4d87-932a-96bf97b0d4f4,posted,Venture Health Manly Manl,-33.75,49544383-c19c-4c97-b8d1-5322d0faa6af,-1951.55,debit,payment,AU00000,5453f0a3-083c-43c6-9086-adfe94df9918,,,2022-09-01T00:00:00Z,,https://au-api.basiq.io/users/11103cba-4a08-4397-84a5-22ac125ed2f6/transactions/3a14cf59-d1ee-4d87-932a-96bf97b0d4f4,https://au-api.basiq.io/users/11103cba-4a08-4397-84a5-22ac125ed2f6/accounts/49544383-c19c-4c97-b8d1-5322d0faa6af,https://au-api.basiq.io/institutions/AU00000,,Specialised Food Retailing,412
transaction,2c0babff-d652-41e1-8f54-582bb5834296,posted,TASTE BAGUETTE GLNRS BELR,-22.10,49544383-c19c-4c97-b8d1-5322d0faa6af,-1917.80,debit,payment,AU00000,5453f0a3-083c-43c6-9086-adfe94df9918,,,2022-09-01T00:00:00Z,,https://au-api.basiq.io/users/11103cba-4a08-4397-84a5-22ac125ed2f6/transactions/2c0babff-d652-41e1-8f54-582bb5834296,https://au-api.basiq.io/users/11103cba-4a08-4397-84a5-22ac125ed2f6/accounts/49544383-c19c-4c97-b8d1-5322d0faa6af,https://au-api.basiq.io/institutions/AU00000,,"Cafes, Restaurants and Takeaway Food Services",451
transaction,0719d252-db5a-462f-9f22-f5e1b78eb14b,posted,Only About Children Seaforth 1244301,-157.00,49544383-c19c-4c97-b8d1-5322d0faa6af,-1895.70,debit,payment,AU00000,5453f0a3-083c-43c6-9086-adfe94df9918,,,2022-09-01T00:00:00Z,,https://au-api.basiq.io/users/11103cba-4a08-4397-84a5-22ac125ed2f6/transactions/0719d252-db5a-462f-9f22-f5e1b78eb14b,https://au-api.basiq.io/users/11103cba-4a08-4397-84a5-22ac125ed2f6/accounts/49544383-c19c-4c97-b8d1-5322d0faa6af,https://au-api.basiq.io/institutions/AU00000,,Other Health Care Services,859
transaction,eb4abe44-8001-48d3-b669-6108fe02eee6,posted,Cash Wdr  Frenchs Fores02AU,-83.00,49544383-c19c-4c97-b8d1-5322d0faa6af,-1738.70,debit,cash-withdrawal,AU00000,5453f0a3-083c-43c6-9086-adfe94df9918,,,2022-09-01T00:00:00Z,,https://au-api.basiq.io/users/11103cba-4a08-4397-84a5-22ac125ed2f6/transactions/eb4abe44-8001-48d3-b669-6108fe02eee6,https://au-api.basiq.io/users/11103cba-4a08-4397-84a5-22ac125ed2f6/accounts/49544383-c19c-4c97-b8d1-5322d0faa6af,https://au-api.basiq.io/institutions/AU00000,,,
transaction,26de81dc-a9d3-43b0-ae25-a2beb4d4786e,posted,HFM MANLY MANLY AU,-97.73,49544383-c19c-4c97-b8d1-5322d0faa6af,-1655.70,debit,payment,AU00000,5453f0a3-083c-43c6-9086-adfe94df9918,,,2022-09-01T00:00:00Z,,https://au-api.basiq.io/users/11103cba-4a08-4397-84a5-22ac125ed2f6/transactions/26de81dc-a9d3-43b0-ae25-a2beb4d4786e,https://au-api.basiq.io/users/11103cba-4a08-4397-84a5-22ac125ed2f6/accounts/49544383-c19c-4c97-b8d1-5322d0faa6af,https://au-api.basiq.io/institutions/AU00000,,Supermarket and Grocery Stores,411
transaction,2ef3f53b-c077-42ec-ab7c-9f1054a7b45c,posted,HEADYS PTY LTD BROO,-59.33,49544383-c19c-4c97-b8d1-5322d0faa6af,-1557.97,debit,payment,AU00000,5453f0a3-083c-43c6-9086-adfe94df9918,,,2022-08-31T00:00:00Z,,https://au-api.basiq.io/users/11103cba-4a08-4397-84a5-22ac125ed2f6/transactions/2ef3f53b-c077-42ec-ab7c-9f1054a7b45c,https://au-api.basiq.io/users/11103cba-4a08-4397-84a5-22ac125ed2f6/accounts/49544383-c19c-4c97-b8d1-5322d0faa6af,https://au-api.basiq.io/institutions/AU00000,,Specialised Food Retailing,412
transaction,25f5f3e6-cbb8-45c7-8cfb-4f24e340b1df,posted,LE PARISIEN KILL,-17.00,49544383-c19c-4c97-b8d1-5322d0faa6af,-1498.64,debit,payment,AU00000,5453f0a3-083c-43c6-9086-adfe94df9918,,,2022-08-31T00:00:00Z,,https://au-api.basiq.io/users/11103cba-4a08-4397-84a5-22ac125ed2f6/transactions/25f5f3e6-cbb8-45c7-8cfb-4f24e340b1df,https://au-api.basiq.io/users/11103cba-4a08-4397-84a5-22ac125ed2f6/accounts/49544383-c19c-4c97-b8d1-5322d0faa6af,https://au-api.basiq.io/institutions/AU00000,,"Cafes, Restaurants and Takeaway Food Services",451
transaction,f3343c89-9f5a-4325-817d-b6812bc9efb6,posted,OFARM ORGANIC GROCER BROO,-63.25,49544383-c19c-4c97-b8d1-5322d0faa6af,-1481.64,debit,payment,AU00000,5453f0a3-083c-43c6-9086-adfe94df9918,,,2022-08-30T00:00:00Z,,https://au-api.basiq.io/users/11103cba-4a08-4397-84a5-22ac125ed2f6/transactions/f3343c89-9f5a-4325-817d-b6812bc9efb6,https://au-api.basiq.io/users/11103cba-4a08-4397-84a5-22ac125ed2f6/accounts/49544383-c19c-4c97-b8d1-5322d0faa6af,https://au-api.basiq.io/institutions/AU00000,,Supermarket and Grocery Stores,411
transaction,4f103b34-d888-4923-8d20-7f6f9f28cf77,posted,TICKET SOLUTIONS-OZTIX WOOL,-46.00,49544383-c19c-4c97-b8d1-5322d0faa6af,-1418.39,debit,payment,AU00000,5453f0a3-083c-43c6-9086-adfe94df9918,,,2022-08-30T00:00:00Z,,https://au-api.basiq.io/users/11103cba-4a08-4397-84a5-22ac125ed2f6/transactions/4f103b34-d888-4923-8d20-7f6f9f28cf77,https://au-api.basiq.io/users/11103cba-4a08-4397-84a5-22ac125ed2f6/accounts/49544383-c19c-4c97-b8d1-5322d0faa6af,https://au-api.basiq.io/institutions/AU00000,,Unknown,0
transaction,0751b17f-99e8-40d3-bcf0-3eab695aff26,posted,HEADYS PTY LTD BROO,-26.50,49544383-c19c-4c97-b8d1-5322d0faa6af,-1372.39,debit,payment,AU00000,5453f0a3-083c-43c6-9086-adfe94df9918,,,2022-08-30T00:00:00Z,,https://au-api.basiq.io/users/11103cba-4a08-4397-84a5-22ac125ed2f6/transactions/0751b17f-99e8-40d3-bcf0-3eab695aff26,https://au-api.basiq.io/users/11103cba-4a08-4397-84a5-22ac125ed2f6/accounts/49544383-c19c-4c97-b8d1-5322d0faa6af,https://au-api.basiq.io/institutions/AU00000,,Specialised Food Retailing,412
transaction,d3d3fa27-87c6-4165-92c8-9cbb1e5cb1ca,posted,NAKED FOOD WARRINGAH BOND,-16.75,49544383-c19c-4c97-b8d1-5322d0faa6af,-1345.89,debit,payment,AU00000,5453f0a3-083c-43c6-9086-adfe94df9918,,,2022-08-30T00:00:00Z,,https://au-api.basiq.io/users/11103cba-4a08-4397-84a5-22ac125ed2f6/transactions/d3d3fa27-87c6-4165-92c8-9cbb1e5cb1ca,https://au-api.basiq.io/users/11103cba-4a08-4397-84a5-22ac125ed2f6/accounts/49544383-c19c-4c97-b8d1-5322d0faa6af,https://au-api.basiq.io/institutions/AU00000,,Specialised Food Retailing,412
transaction,bdcad972-7c38-45d0-b9f4-3647aea27125,posted,IKEA RHODES RHOD,-150.00,49544383-c19c-4c97-b8d1-5322d0faa6af,-1329.14,debit,payment,AU00000,5453f0a3-083c-43c6-9086-adfe94df9918,,,2022-08-29T00:00:00Z,,https://au-api.basiq.io/users/11103cba-4a08-4397-84a5-22ac125ed2f6/transactions/bdcad972-7c38-45d0-b9f4-3647aea27125,https://au-api.basiq.io/users/11103cba-4a08-4397-84a5-22ac125ed2f6/accounts/49544383-c19c-4c97-b8d1-5322d0faa6af,https://au-api.basiq.io/institutions/AU00000,,"Furniture, Floor Coverings, Houseware and Textile Goods Retailing",421
transaction,6d2fe535-f398-4511-8ec4-358b165ee5bc,posted,Jaycar Electronics Broo,-35.55,49544383-c19c-4c97-b8d1-5322d0faa6af,-1179.14,debit,payment,AU00000,5453f0a3-083c-43c6-9086-adfe94df9918,,,2022-08-29T00:00:00Z,,https://au-api.basiq.io/users/11103cba-4a08-4397-84a5-22ac125ed2f6/transactions/6d2fe535-f398-4511-8ec4-358b165ee5bc,https://au-api.basiq.io/users/11103cba-4a08-4397-84a5-22ac125ed2f6/accounts/49544383-c19c-4c97-b8d1-5322d0faa6af,https://au-api.basiq.io/institutions/AU00000,,Electrical and Electronic Goods Retailing,422
transaction,d3721921-baf2-4a0f-b90e-38641347342a,posted,GIRDLERS GRIND BROO,-34.00,49544383-c19c-4c97-b8d1-5322d0faa6af,-1143.59,debit,payment,AU00000,5453f0a3-083c-43c6-9086-adfe94df9918,,,2022-08-29T00:00:00Z,,https://au-api.basiq.io/users/11103cba-4a08-4397-84a5-22ac125ed2f6/transactions/d3721921-baf2-4a0f-b90e-38641347342a,https://au-api.basiq.io/users/11103cba-4a08-4397-84a5-22ac125ed2f6/accounts/49544383-c19c-4c97-b8d1-5322d0faa6af,https://au-api.basiq.io/institutions/AU00000,,"Cafes, Restaurants and Takeaway Food Services",451
transaction,c6df88bd-0694-4f03-9c65-2cfbd2b64be2,posted,Dee Why Discount V&SS Dee,-19.80,49544383-c19c-4c97-b8d1-5322d0faa6af,-1109.59,debit,payment,AU00000,5453f0a3-083c-43c6-9086-adfe94df9918,,,2022-08-29T00:00:00Z,,https://au-api.basiq.io/users/11103cba-4a08-4397-84a5-22ac125ed2f6/transactions/c6df88bd-0694-4f03-9c65-2cfbd2b64be2,https://au-api.basiq.io/users/11103cba-4a08-4397-84a5-22ac125ed2f6/accounts/49544383-c19c-4c97-b8d1-5322d0faa6af,https://au-api.basiq.io/institutions/AU00000,,Specialised Food Retailing,412
transaction,4c9c9e75-d0e0-4f71-8654-bf27dcf8c40b,posted,T2 - WARRINGAH MALL BROO,-16.00,49544383-c19c-4c97-b8d1-5322d0faa6af,-1089.79,debit,payment,AU00000,5453f0a3-083c-43c6-9086-adfe94df9918,,,2022-08-29T00:00:00Z,,https://au-api.basiq.io/users/11103cba-4a08-4397-84a5-22ac125ed2f6/transactions/4c9c9e75-d0e0-4f71-8654-bf27dcf8c40b,https://au-api.basiq.io/users/11103cba-4a08-4397-84a5-22ac125ed2f6/accounts/49544383-c19c-4c97-b8d1-5322d0faa6af,https://au-api.basiq.io/institutions/AU00000,,Pharmaceutical and Other Store-Based Retailing,427
transaction,92f7d6a6-ce33-42f2-b5bd-ca6f7565b3fb,posted,RIOT ART & CRAFT2040 BROO,-3.99,49544383-c19c-4c97-b8d1-5322d0faa6af,-1073.79,debit,payment,AU00000,5453f0a3-083c-43c6-9086-adfe94df9918,,,2022-08-29T00:00:00Z,,https://au-api.basiq.io/users/11103cba-4a08-4397-84a5-22ac125ed2f6/transactions/92f7d6a6-ce33-42f2-b5bd-ca6f7565b3fb,https://au-api.basiq.io/users/11103cba-4a08-4397-84a5-22ac125ed2f6/accounts/49544383-c19c-4c97-b8d1-5322d0faa6af,https://au-api.basiq.io/institutions/AU00000,,Pharmaceutical and Other Store-Based Retailing,427
transaction,e4fc140b-6383-4d9f-ab2c-5d014c4ce82e,posted,WOOLWORTHS 1262 BELR,-17.49,49544383-c19c-4c97-b8d1-5322d0faa6af,-1069.80,debit,payment,AU00000,5453f0a3-083c-43c6-9086-adfe94df9918,,,2022-08-28T00:00:00Z,,https://au-api.basiq.io/users/11103cba-4a08-4397-84a5-22ac125ed2f6/transactions/e4fc140b-6383-4d9f-ab2c-5d014c4ce82e,https://au-api.basiq.io/users/11103cba-4a08-4397-84a5-22ac125ed2f6/accounts/49544383-c19c-4c97-b8d1-5322d0faa6af,https://au-api.basiq.io/institutions/AU00000,,Supermarket and Grocery Stores,411
transaction,4e03fb29-f8f1-427f-9bdb-c5d8d4b3cd6f,posted,LUSH WARRINGAH BROO,-12.90,49544383-c19c-4c97-b8d1-5322d0faa6af,-1052.31,debit,payment,AU00000,5453f0a3-083c-43c6-9086-adfe94df9918,,,2022-08-28T00:00:00Z,,https://au-api.basiq.io/users/11103cba-4a08-4397-84a5-22ac125ed2f6/transactions/4e03fb29-f8f1-427f-9bdb-c5d8d4b3cd6f,https://au-api.basiq.io/users/11103cba-4a08-4397-84a5-22ac125ed2f6/accounts/49544383-c19c-4c97-b8d1-5322d0faa6af,https://au-api.basiq.io/institutions/AU00000,,Pharmaceutical and Other Store-Based Retailing,427
transaction,b2f870a9-4251-4cae-899e-1b641305aea7,posted,NAKED FOOD WARRINGAH BOND,-8.90,49544383-c19c-4c97-b8d1-5322d0faa6af,-1039.41,debit,payment,AU00000,5453f0a3-083c-43c6-9086-adfe94df9918,,,2022-08-28T00:00:00Z,,https://au-api.basiq.io/users/11103cba-4a08-4397-84a5-22ac125ed2f6/transactions/b2f870a9-4251-4cae-899e-1b641305aea7,https://au-api.basiq.io/users/11103cba-4a08-4397-84a5-22ac125ed2f6/accounts/49544383-c19c-4c97-b8d1-5322d0faa6af,https://au-api.basiq.io/institutions/AU00000,,Specialised Food Retailing,412
transaction,6aaeaa3d-b6a6-44c7-a950-e317739537c6,posted,TFR From Transaction to CC Acc 13,9323.50,49544383-c19c-4c97-b8d1-5322d0faa6af,-1030.51,credit,transfer,AU00000,5453f0a3-083c-43c6-9086-adfe94df9918,,,2022-08-27T00:00:00Z,,https://au-api.basiq.io/users/11103cba-4a08-4397-84a5-22ac125ed2f6/transactions/6aaeaa3d-b6a6-44c7-a950-e317739537c6,https://au-api.basiq.io/users/11103cba-4a08-4397-84a5-22ac125ed2f6/accounts/49544383-c19c-4c97-b8d1-5322d0faa6af,https://au-api.basiq.io/institutions/AU00000,,,
transaction,36277846-a579-4626-bf61-5c54898dea98,posted,BUNNINGS 588000 BELROSE AU,-48.72,49544383-c19c-4c97-b8d1-5322d0faa6af,-10354.01,debit,payment,AU00000,5453f0a3-083c-43c6-9086-adfe94df9918,,,2022-08-27T00:00:00Z,,https://au-api.basiq.io/users/11103cba-4a08-4397-84a5-22ac125ed2f6/transactions/36277846-a579-4626-bf61-5c54898dea98,https://au-api.basiq.io/users/11103cba-4a08-4397-84a5-22ac125ed2f6/accounts/49544383-c19c-4c97-b8d1-5322d0faa6af,https://au-api.basiq.io/institutions/AU00000,,"Hardware, Building and Garden Supplies Retailing",423
transaction,a78f053e-94df-40f7-8f51-1eba24aa9e3e,posted,BP ALLAMBIE 0754 ALLA,-90.59,49544383-c19c-4c97-b8d1-5322d0faa6af,-10305.29,debit,payment,AU00000,5453f0a3-083c-43c6-9086-adfe94df9918,,,2022-08-25T00:00:00Z,,https://au-api.basiq.io/users/11103cba-4a08-4397-84a5-22ac125ed2f6/transactions/a78f053e-94df-40f7-8f51-1eba24aa9e3e,https://au-api.basiq.io/users/11103cba-4a08-4397-84a5-22ac125ed2f6/accounts/49544383-c19c-4c97-b8d1-5322d0faa6af,https://au-api.basiq.io/institutions/AU00000,,Fuel Retailing,400
transaction,9e7bc7bf-a8e1-4360-9326-f8dffcef6309,posted,AG WARRINGAH MALL BROO,-35.65,49544383-c19c-4c97-b8d1-5322d0faa6af,-10214.70,debit,payment,AU00000,5453f0a3-083c-43c6-9086-adfe94df9918,,,2022-08-25T00:00:00Z,,https://au-api.basiq.io/users/11103cba-4a08-4397-84a5-22ac125ed2f6/transactions/9e7bc7bf-a8e1-4360-9326-f8dffcef6309,https://au-api.basiq.io/users/11103cba-4a08-4397-84a5-22ac125ed2f6/accounts/49544383-c19c-4c97-b8d1-5322d0faa6af,https://au-api.basiq.io/institutions/AU00000,,"Newspaper, Periodical, Book and Directory Publishing",541
transaction,48bd6dfc-d20c-44a5-ab7b-6c7366bb76a1,posted,GIRDLERS GRIND BROO,-34.00,49544383-c19c-4c97-b8d1-5322d0faa6af,-10179.05,debit,payment,AU00000,5453f0a3-083c-43c6-9086-adfe94df9918,,,2022-08-25T00:00:00Z,,https://au-api.basiq.io/users/11103cba-4a08-4397-84a5-22ac125ed2f6/transactions/48bd6dfc-d20c-44a5-ab7b-6c7366bb76a1,https://au-api.basiq.io/users/11103cba-4a08-4397-84a5-22ac125ed2f6/accounts/49544383-c19c-4c97-b8d1-5322d0faa6af,https://au-api.basiq.io/institutions/AU00000,,"Cafes, Restaurants and Takeaway Food Services",451
transaction,56b8b13e-25f6-476a-9ba6-38f4b877248b,posted,AG WARRINGAH MALL BROO,-24.90,49544383-c19c-4c97-b8d1-5322d0faa6af,-10145.05,debit,payment,AU00000,5453f0a3-083c-43c6-9086-adfe94df9918,,,2022-08-25T00:00:00Z,,https://au-api.basiq.io/users/11103cba-4a08-4397-84a5-22ac125ed2f6/transactions/56b8b13e-25f6-476a-9ba6-38f4b877248b,https://au-api.basiq.io/users/11103cba-4a08-4397-84a5-22ac125ed2f6/accounts/49544383-c19c-4c97-b8d1-5322d0faa6af,https://au-api.basiq.io/institutions/AU00000,,"Newspaper, Periodical, Book and Directory Publishing",541
transaction,103fc1b7-c43c-4221-a8bd-68ab222450de,posted,WOOLWORTHS 1282 BROO,-20.00,49544383-c19c-4c97-b8d1-5322d0faa6af,-10120.15,debit,payment,AU00000,5453f0a3-083c-43c6-9086-adfe94df9918,,,2022-08-25T00:00:00Z,,https://au-api.basiq.io/users/11103cba-4a08-4397-84a5-22ac125ed2f6/transactions/103fc1b7-c43c-4221-a8bd-68ab222450de,https://au-api.basiq.io/users/11103cba-4a08-4397-84a5-22ac125ed2f6/accounts/49544383-c19c-4c97-b8d1-5322d0faa6af,https://au-api.basiq.io/institutions/AU00000,,Supermarket and Grocery Stores,411
transaction,3ee11002-5941-49ff-9b55-31473e000c5e,posted,COLES 0897 BROO,-17.50,49544383-c19c-4c97-b8d1-5322d0faa6af,-10100.15,debit,payment,AU00000,5453f0a3-083c-43c6-9086-adfe94df9918,,,2022-08-25T00:00:00Z,,https://au-api.basiq.io/users/11103cba-4a08-4397-84a5-22ac125ed2f6/transactions/3ee11002-5941-49ff-9b55-31473e000c5e,https://au-api.basiq.io/users/11103cba-4a08-4397-84a5-22ac125ed2f6/accounts/49544383-c19c-4c97-b8d1-5322d0faa6af,https://au-api.basiq.io/institutions/AU00000,,Supermarket and Grocery Stores,411
transaction,71b07356-53c0-420b-8699-110e50ee80d3,posted,ALDI STORES BELR,-5.51,49544383-c19c-4c97-b8d1-5322d0faa6af,-10082.65,debit,payment,AU00000,5453f0a3-083c-43c6-9086-adfe94df9918,,,2022-08-25T00:00:00Z,,https://au-api.basiq.io/users/11103cba-4a08-4397-84a5-22ac125ed2f6/transactions/71b07356-53c0-420b-8699-110e50ee80d3,https://au-api.basiq.io/users/11103cba-4a08-4397-84a5-22ac125ed2f6/accounts/49544383-c19c-4c97-b8d1-5322d0faa6af,https://au-api.basiq.io/institutions/AU00000,,Supermarket and Grocery Stores,411
transaction,29f9b99c-1a5d-4ff9-95db-40f28b129279,posted,Only About Children Seaforth 1244301,-125.00,49544383-c19c-4c97-b8d1-5322d0faa6af,-10077.14,debit,payment,AU00000,5453f0a3-083c-43c6-9086-adfe94df9918,,,2022-08-25T00:00:00Z,,https://au-api.basiq.io/users/11103cba-4a08-4397-84a5-22ac125ed2f6/transactions/29f9b99c-1a5d-4ff9-95db-40f28b129279,https://au-api.basiq.io/users/11103cba-4a08-4397-84a5-22ac125ed2f6/accounts/49544383-c19c-4c97-b8d1-5322d0faa6af,https://au-api.basiq.io/institutions/AU00000,,Other Health Care Services,859
transaction,dcd39578-4b83-4852-a195-d8a4eb73b3f9,posted,METRO PETROLEUM FR FORESTVILLE AU,-55.48,49544383-c19c-4c97-b8d1-5322d0faa6af,-9952.14,debit,payment,AU00000,5453f0a3-083c-43c6-9086-adfe94df9918,,,2022-08-24T00:00:00Z,,https://au-api.basiq.io/users/11103cba-4a08-4397-84a5-22ac125ed2f6/transactions/dcd39578-4b83-4852-a195-d8a4eb73b3f9,https://au-api.basiq.io/users/11103cba-4a08-4397-84a5-22ac125ed2f6/accounts/49544383-c19c-4c97-b8d1-5322d0faa6af,https://au-api.basiq.io/institutions/AU00000,,Fuel Retailing,400
transaction,bac7f64e-3c53-4c4d-9ef4-d8cfa17d634b,posted,WOOLWORTHS 1063 FR FREN,-89.21,49544383-c19c-4c97-b8d1-5322d0faa6af,-9896.66,debit,payment,AU00000,5453f0a3-083c-43c6-9086-adfe94df9918,,,2022-08-24T00:00:00Z,,https://au-api.basiq.io/users/11103cba-4a08-4397-84a5-22ac125ed2f6/transactions/bac7f64e-3c53-4c4d-9ef4-d8cfa17d634b,https://au-api.basiq.io/users/11103cba-4a08-4397-84a5-22ac125ed2f6/accounts/49544383-c19c-4c97-b8d1-5322d0faa6af,https://au-api.basiq.io/institutions/AU00000,,Supermarket and Grocery Stores,411
transaction,20180ba9-01ae-494d-8c31-13ac1ae8e927,posted,LOTUS HHC NEUT,-801.00,49544383-c19c-4c97-b8d1-5322d0faa6af,-9807.45,debit,payment,AU00000,5453f0a3-083c-43c6-9086-adfe94df9918,,,2022-08-23T00:00:00Z,,https://au-api.basiq.io/users/11103cba-4a08-4397-84a5-22ac125ed2f6/transactions/20180ba9-01ae-494d-8c31-13ac1ae8e927,https://au-api.basiq.io/users/11103cba-4a08-4397-84a5-22ac125ed2f6/accounts/49544383-c19c-4c97-b8d1-5322d0faa6af,https://au-api.basiq.io/institutions/AU00000,,Allied Health Services,853
transaction,b98556e9-3016-46f2-b5e9-4ade572668d2,posted,COMMONWEALTH AUTOBANK CASH,-151.00,49544383-c19c-4c97-b8d1-5322d0faa6af,-9006.45,debit,payment,AU00000,5453f0a3-083c-43c6-9086-adfe94df9918,,,2022-08-23T00:00:00Z,,https://au-api.basiq.io/users/11103cba-4a08-4397-84a5-22ac125ed2f6/transactions/b98556e9-3016-46f2-b5e9-4ade572668d2,https://au-api.basiq.io/users/11103cba-4a08-4397-84a5-22ac125ed2f6/accounts/49544383-c19c-4c97-b8d1-5322d0faa6af,https://au-api.basiq.io/institutions/AU00000,,Unknown,0
transaction,c7c42abe-0d00-4cde-8bfa-dc64afab2192,posted,SQ *FRATELLI POLITO PR Fren,-141.00,49544383-c19c-4c97-b8d1-5322d0faa6af,-8855.45,debit,payment,AU00000,5453f0a3-083c-43c6-9086-adfe94df9918,,,2022-08-23T00:00:00Z,,https://au-api.basiq.io/users/11103cba-4a08-4397-84a5-22ac125ed2f6/transactions/c7c42abe-0d00-4cde-8bfa-dc64afab2192,https://au-api.basiq.io/users/11103cba-4a08-4397-84a5-22ac125ed2f6/accounts/49544383-c19c-4c97-b8d1-5322d0faa6af,https://au-api.basiq.io/institutions/AU00000,,Specialised Food Retailing,412
transaction,38ca1ea2-7372-4557-a73a-9a9a9edb3ed7,posted,SQ *TASTY BITES BAKERY Scot,-102.50,49544383-c19c-4c97-b8d1-5322d0faa6af,-8714.45,debit,payment,AU00000,5453f0a3-083c-43c6-9086-adfe94df9918,,,2022-08-23T00:00:00Z,,https://au-api.basiq.io/users/11103cba-4a08-4397-84a5-22ac125ed2f6/transactions/38ca1ea2-7372-4557-a73a-9a9a9edb3ed7,https://au-api.basiq.io/users/11103cba-4a08-4397-84a5-22ac125ed2f6/accounts/49544383-c19c-4c97-b8d1-5322d0faa6af,https://au-api.basiq.io/institutions/AU00000,,Specialised Food Retailing,412
transaction,aa0ca6f4-82e4-43c8-b757-c86105fba9b8,posted,SUSHI PLUS MANLY MANL,-40.40,49544383-c19c-4c97-b8d1-5322d0faa6af,-8611.95,debit,payment,AU00000,5453f0a3-083c-43c6-9086-adfe94df9918,,,2022-08-23T00:00:00Z,,https://au-api.basiq.io/users/11103cba-4a08-4397-84a5-22ac125ed2f6/transactions/aa0ca6f4-82e4-43c8-b757-c86105fba9b8,https://au-api.basiq.io/users/11103cba-4a08-4397-84a5-22ac125ed2f6/accounts/49544383-c19c-4c97-b8d1-5322d0faa6af,https://au-api.basiq.io/institutions/AU00000,,"Cafes, Restaurants and Takeaway Food Services",451
transaction,63a8bfaa-53c5-4292-8fc1-5b644cdef94b,posted,DIR CHG OTH ATM COMMONWEACASH,-3.00,49544383-c19c-4c97-b8d1-5322d0faa6af,-8571.55,debit,payment,AU00000,5453f0a3-083c-43c6-9086-adfe94df9918,,,2022-08-23T00:00:00Z,,https://au-api.basiq.io/users/11103cba-4a08-4397-84a5-22ac125ed2f6/transactions/63a8bfaa-53c5-4292-8fc1-5b644cdef94b,https://au-api.basiq.io/users/11103cba-4a08-4397-84a5-22ac125ed2f6/accounts/49544383-c19c-4c97-b8d1-5322d0faa6af,https://au-api.basiq.io/institutions/AU00000,,Depository Financial Intermediation,622
transaction,49dfc1fd-6f55-43fb-9820-9343f7cc9244,posted,TPG Internet PTY LTD Nort,-2.00,49544383-c19c-4c97-b8d1-5322d0faa6af,-8568.55,debit,payment,AU00000,5453f0a3-083c-43c6-9086-adfe94df9918,,,2022-08-23T00:00:00Z,,https://au-api.basiq.io/users/11103cba-4a08-4397-84a5-22ac125ed2f6/transactions/49dfc1fd-6f55-43fb-9820-9343f7cc9244,https://au-api.basiq.io/users/11103cba-4a08-4397-84a5-22ac125ed2f6/accounts/49544383-c19c-4c97-b8d1-5322d0faa6af,https://au-api.basiq.io/institutions/AU00000,,Internet Service Providers and Web Search Portals,591
transaction,918dc7a2-da83-4a0f-88ca-cf1bf1d201df,posted,WOOLWORTHS 1262 BELR,-291.43,49544383-c19c-4c97-b8d1-5322d0faa6af,-8566.55,debit,payment,AU00000,5453f0a3-083c-43c6-9086-adfe94df9918,,,2022-08-22T00:00:00Z,,https://au-api.basiq.io/users/11103cba-4a08-4397-84a5-22ac125ed2f6/transactions/918dc7a2-da83-4a0f-88ca-cf1bf1d201df,https://au-api.basiq.io/users/11103cba-4a08-4397-84a5-22ac125ed2f6/accounts/49544383-c19c-4c97-b8d1-5322d0faa6af,https://au-api.basiq.io/institutions/AU00000,,Supermarket and Grocery Stores,411
transaction,a79c12f6-8f31-4263-95a1-e0f653f10254,posted,WWW.UNKYA.COM MACK,-111.00,49544383-c19c-4c97-b8d1-5322d0faa6af,-8275.12,debit,payment,AU00000,5453f0a3-083c-43c6-9086-adfe94df9918,,,2022-08-21T00:00:00Z,,https://au-api.basiq.io/users/11103cba-4a08-4397-84a5-22ac125ed2f6/transactions/a79c12f6-8f31-4263-95a1-e0f653f10254,https://au-api.basiq.io/users/11103cba-4a08-4397-84a5-22ac125ed2f6/accounts/49544383-c19c-4c97-b8d1-5322d0faa6af,https://au-api.basiq.io/institutions/AU00000,,Unknown,0
transaction,4d2db373-a620-4363-996c-40bffc3d4001,posted,WOOLWORTHS 1063 FRENCHS FRST NSW AU,-113.58,49544383-c19c-4c97-b8d1-5322d0faa6af,-8164.12,debit,payment,AU00000,5453f0a3-083c-43c6-9086-adfe94df9918,,,2022-08-20T00:00:00Z,,https://au-api.basiq.io/users/11103cba-4a08-4397-84a5-22ac125ed2f6/transactions/4d2db373-a620-4363-996c-40bffc3d4001,https://au-api.basiq.io/users/11103cba-4a08-4397-84a5-22ac125ed2f6/accounts/49544383-c19c-4c97-b8d1-5322d0faa6af,https://au-api.basiq.io/institutions/AU00000,,Supermarket and Grocery Stores,411
transaction,4bc4a616-20f6-4572-8408-64d375c7ecf8,posted,PUMA KEMPSEY SOUTH KEMPSEYAU,-156.88,49544383-c19c-4c97-b8d1-5322d0faa6af,-8050.54,debit,payment,AU00000,5453f0a3-083c-43c6-9086-adfe94df9918,,,2022-08-19T00:00:00Z,,https://au-api.basiq.io/users/11103cba-4a08-4397-84a5-22ac125ed2f6/transactions/4bc4a616-20f6-4572-8408-64d375c7ecf8,https://au-api.basiq.io/users/11103cba-4a08-4397-84a5-22ac125ed2f6/accounts/49544383-c19c-4c97-b8d1-5322d0faa6af,https://au-api.basiq.io/institutions/AU00000,,Fuel Retailing,400
transaction,3ff8ca11-4fb5-4e67-8a50-f12f105a4a8a,posted,AMANDA&WAYNE PURCELL NAMB,-63.50,49544383-c19c-4c97-b8d1-5322d0faa6af,-7893.66,debit,payment,AU00000,5453f0a3-083c-43c6-9086-adfe94df9918,,,2022-08-17T00:00:00Z,,https://au-api.basiq.io/users/11103cba-4a08-4397-84a5-22ac125ed2f6/transactions/3ff8ca11-4fb5-4e67-8a50-f12f105a4a8a,https://au-api.basiq.io/users/11103cba-4a08-4397-84a5-22ac125ed2f6/accounts/49544383-c19c-4c97-b8d1-5322d0faa6af,https://au-api.basiq.io/institutions/AU00000,,Accommodation,440
transaction,39a7c739-8567-48db-8872-ddc16a81d9b4,posted,THE GREEN ROOM CAFE AN CRES,-104.40,49544383-c19c-4c97-b8d1-5322d0faa6af,-7830.16,debit,payment,AU00000,5453f0a3-083c-43c6-9086-adfe94df9918,,,2022-08-16T00:00:00Z,,https://au-api.basiq.io/users/11103cba-4a08-4397-84a5-22ac125ed2f6/transactions/39a7c739-8567-48db-8872-ddc16a81d9b4,https://au-api.basiq.io/users/11103cba-4a08-4397-84a5-22ac125ed2f6/accounts/49544383-c19c-4c97-b8d1-5322d0faa6af,https://au-api.basiq.io/institutions/AU00000,,"Cafes, Restaurants and Takeaway Food Services",451
transaction,fbe7eb82-b327-4ab5-ae70-b9bbf8502a98,posted,CAFE CHA CHA MACK,-26.60,49544383-c19c-4c97-b8d1-5322d0faa6af,-7725.76,debit,payment,AU00000,5453f0a3-083c-43c6-9086-adfe94df9918,,,2022-08-16T00:00:00Z,,https://au-api.basiq.io/users/11103cba-4a08-4397-84a5-22ac125ed2f6/transactions/fbe7eb82-b327-4ab5-ae70-b9bbf8502a98,https://au-api.basiq.io/users/11103cba-4a08-4397-84a5-22ac125ed2f6/accounts/49544383-c19c-4c97-b8d1-5322d0faa6af,https://au-api.basiq.io/institutions/AU00000,,"Cafes, Restaurants and Takeaway Food Services",451
transaction,7c043644-f7d3-41d5-86f8-0be1f01ef3d4,posted,OPTUS PREPAID MELBOURN,-40.00,49544383-c19c-4c97-b8d1-5322d0faa6af,-7699.16,debit,payment,AU00000,5453f0a3-083c-43c6-9086-adfe94df9918,,,2022-08-13T00:00:00Z,,https://au-api.basiq.io/users/11103cba-4a08-4397-84a5-22ac125ed2f6/transactions/7c043644-f7d3-41d5-86f8-0be1f01ef3d4,https://au-api.basiq.io/users/11103cba-4a08-4397-84a5-22ac125ed2f6/accounts/49544383-c19c-4c97-b8d1-5322d0faa6af,https://au-api.basiq.io/institutions/AU00000,,Telecommunications Services,580
transaction,c0eb187a-c63d-4ee8-9e1d-47c65ca32998,posted,WOOLWORTHS 1434 MACKSVILLE NSW AU,-201.91,49544383-c19c-4c97-b8d1-5322d0faa6af,-7659.16,debit,payment,AU00000,5453f0a3-083c-43c6-9086-adfe94df9918,,,2022-08-09T00:00:00Z,,https://au-api.basiq.io/users/11103cba-4a08-4397-84a5-22ac125ed2f6/transactions/c0eb187a-c63d-4ee8-9e1d-47c65ca32998,https://au-api.basiq.io/users/11103cba-4a08-4397-84a5-22ac125ed2f6/accounts/49544383-c19c-4c97-b8d1-5322d0faa6af,https://au-api.basiq.io/institutions/AU00000,,Supermarket and Grocery Stores,411
transaction,36f77da8-b0e7-44fe-b7e8-d98371d78456,posted,NAMBUCCA BOATSHED & NAMBUCCA HEADAU,-27.89,49544383-c19c-4c97-b8d1-5322d0faa6af,-7457.25,debit,payment,AU00000,5453f0a3-083c-43c6-9086-adfe94df9918,,,2022-08-08T00:00:00Z,,https://au-api.basiq.io/users/11103cba-4a08-4397-84a5-22ac125ed2f6/transactions/36f77da8-b0e7-44fe-b7e8-d98371d78456,https://au-api.basiq.io/users/11103cba-4a08-4397-84a5-22ac125ed2f6/accounts/49544383-c19c-4c97-b8d1-5322d0faa6af,https://au-api.basiq.io/institutions/AU00000,,"Cafes, Restaurants and Takeaway Food Services",451
transaction,54221f71-3342-460a-a254-3ca93fb81fca,posted,STEVE BARNES NAMBUCCA HEADAU,-53.00,49544383-c19c-4c97-b8d1-5322d0faa6af,-7429.36,debit,payment,AU00000,5453f0a3-083c-43c6-9086-adfe94df9918,,,2022-08-08T00:00:00Z,,https://au-api.basiq.io/users/11103cba-4a08-4397-84a5-22ac125ed2f6/transactions/54221f71-3342-460a-a254-3ca93fb81fca,https://au-api.basiq.io/users/11103cba-4a08-4397-84a5-22ac125ed2f6/accounts/49544383-c19c-4c97-b8d1-5322d0faa6af,https://au-api.basiq.io/institutions/AU00000,,Recreational Goods Retailing,424
transaction,54784406-bfba-4444-b21e-f61c55ae5b0f,posted,SALTY DOG SEAFOOD CA COOL,-46.30,49544383-c19c-4c97-b8d1-5322d0faa6af,-7376.36,debit,payment,AU00000,5453f0a3-083c-43c6-9086-adfe94df9918,,,2022-08-08T00:00:00Z,,https://au-api.basiq.io/users/11103cba-4a08-4397-84a5-22ac125ed2f6/transactions/54784406-bfba-4444-b21e-f61c55ae5b0f,https://au-api.basiq.io/users/11103cba-4a08-4397-84a5-22ac125ed2f6/accounts/49544383-c19c-4c97-b8d1-5322d0faa6af,https://au-api.basiq.io/institutions/AU00000,,"Cafes, Restaurants and Takeaway Food Services",451
transaction,94b4f5f1-2499-4d09-a353-a5a723728010,posted,Impulse Chiropractic Nort,-71.00,49544383-c19c-4c97-b8d1-5322d0faa6af,-7330.06,debit,payment,AU00000,5453f0a3-083c-43c6-9086-adfe94df9918,,,2022-08-07T00:00:00Z,,https://au-api.basiq.io/users/11103cba-4a08-4397-84a5-22ac125ed2f6/transactions/94b4f5f1-2499-4d09-a353-a5a723728010,https://au-api.basiq.io/users/11103cba-4a08-4397-84a5-22ac125ed2f6/accounts/49544383-c19c-4c97-b8d1-5322d0faa6af,https://au-api.basiq.io/institutions/AU00000,,Allied Health Services,853
transaction,e1da2d89-28b4-4699-b6fc-85d069ad0f78,posted,Impulse Chiropractic Nort,-71.00,49544383-c19c-4c97-b8d1-5322d0faa6af,-7259.06,debit,payment,AU00000,5453f0a3-083c-43c6-9086-adfe94df9918,,,2022-08-07T00:00:00Z,,https://au-api.basiq.io/users/11103cba-4a08-4397-84a5-22ac125ed2f6/transactions/e1da2d89-28b4-4699-b6fc-85d069ad0f78,https://au-api.basiq.io/users/11103cba-4a08-4397-84a5-22ac125ed2f6/accounts/49544383-c19c-4c97-b8d1-5322d0faa6af,https://au-api.basiq.io/institutions/AU00000,,Allied Health Services,853
transaction,3c0faee8-d040-43e6-af86-b4e212dbcb8f,posted,WOOLWORTHS 1063 FR FREN,-54.20,49544383-c19c-4c97-b8d1-5322d0faa6af,-7188.06,debit,payment,AU00000,5453f0a3-083c-43c6-9086-adfe94df9918,,,2022-08-07T00:00:00Z,,https://au-api.basiq.io/users/11103cba-4a08-4397-84a5-22ac125ed2f6/transactions/3c0faee8-d040-43e6-af86-b4e212dbcb8f,https://au-api.basiq.io/users/11103cba-4a08-4397-84a5-22ac125ed2f6/accounts/49544383-c19c-4c97-b8d1-5322d0faa6af,https://au-api.basiq.io/institutions/AU00000,,Supermarket and Grocery Stores,411
transaction,abd54790-1e71-4683-ad24-8a776821cf86,posted,GLENROSE SUSHI PTY. BELR,-27.40,49544383-c19c-4c97-b8d1-5322d0faa6af,-7133.86,debit,payment,AU00000,5453f0a3-083c-43c6-9086-adfe94df9918,,,2022-08-07T00:00:00Z,,https://au-api.basiq.io/users/11103cba-4a08-4397-84a5-22ac125ed2f6/transactions/abd54790-1e71-4683-ad24-8a776821cf86,https://au-api.basiq.io/users/11103cba-4a08-4397-84a5-22ac125ed2f6/accounts/49544383-c19c-4c97-b8d1-5322d0faa6af,https://au-api.basiq.io/institutions/AU00000,,"Cafes, Restaurants and Takeaway Food Services",451
transaction,57b67dbe-b50a-4c88-9450-1b1ce4205050,posted,ZAP HOME & GIFT P/L BELR,-12.00,49544383-c19c-4c97-b8d1-5322d0faa6af,-7106.46,debit,payment,AU00000,5453f0a3-083c-43c6-9086-adfe94df9918,,,2022-08-07T00:00:00Z,,https://au-api.basiq.io/users/11103cba-4a08-4397-84a5-22ac125ed2f6/transactions/57b67dbe-b50a-4c88-9450-1b1ce4205050,https://au-api.basiq.io/users/11103cba-4a08-4397-84a5-22ac125ed2f6/accounts/49544383-c19c-4c97-b8d1-5322d0faa6af,https://au-api.basiq.io/institutions/AU00000,,Department Stores,426
transaction,a86eb4f1-4186-4d19-a6e3-10bc56e730c3,posted,MEAMM PTY LTD BELR,-6.50,49544383-c19c-4c97-b8d1-5322d0faa6af,-7094.46,debit,payment,AU00000,5453f0a3-083c-43c6-9086-adfe94df9918,,,2022-08-07T00:00:00Z,,https://au-api.basiq.io/users/11103cba-4a08-4397-84a5-22ac125ed2f6/transactions/a86eb4f1-4186-4d19-a6e3-10bc56e730c3,https://au-api.basiq.io/users/11103cba-4a08-4397-84a5-22ac125ed2f6/accounts/49544383-c19c-4c97-b8d1-5322d0faa6af,https://au-api.basiq.io/institutions/AU00000,,Unknown,0
transaction,664f3d29-4231-490a-b428-9ed2bed7ddfc,posted,LAIRDS FRNDLY GROCER SCOTTS HEAD AU,-51.10,49544383-c19c-4c97-b8d1-5322d0faa6af,-7087.96,debit,payment,AU00000,5453f0a3-083c-43c6-9086-adfe94df9918,,,2022-08-07T00:00:00Z,,https://au-api.basiq.io/users/11103cba-4a08-4397-84a5-22ac125ed2f6/transactions/664f3d29-4231-490a-b428-9ed2bed7ddfc,https://au-api.basiq.io/users/11103cba-4a08-4397-84a5-22ac125ed2f6/accounts/49544383-c19c-4c97-b8d1-5322d0faa6af,https://au-api.basiq.io/institutions/AU00000,,Specialised Food Retailing,412
transaction,a711007a-3433-4266-883f-4cb8fa05350f,posted,BP COOLONGOLOOK6396 COOLONGOLOOK AU,-231.16,49544383-c19c-4c97-b8d1-5322d0faa6af,-7036.86,debit,payment,AU00000,5453f0a3-083c-43c6-9086-adfe94df9918,,,2022-08-06T00:00:00Z,,https://au-api.basiq.io/users/11103cba-4a08-4397-84a5-22ac125ed2f6/transactions/a711007a-3433-4266-883f-4cb8fa05350f,https://au-api.basiq.io/users/11103cba-4a08-4397-84a5-22ac125ed2f6/accounts/49544383-c19c-4c97-b8d1-5322d0faa6af,https://au-api.basiq.io/institutions/AU00000,,Fuel Retailing,400
transaction,d32d0fa2-e64b-4b3f-91c7-736b2785051a,posted,WOOLWORTHS 1262 BELR,-326.93,49544383-c19c-4c97-b8d1-5322d0faa6af,-6805.70,debit,payment,AU00000,5453f0a3-083c-43c6-9086-adfe94df9918,,,2022-08-04T00:00:00Z,,https://au-api.basiq.io/users/11103cba-4a08-4397-84a5-22ac125ed2f6/transactions/d32d0fa2-e64b-4b3f-91c7-736b2785051a,https://au-api.basiq.io/users/11103cba-4a08-4397-84a5-22ac125ed2f6/accounts/49544383-c19c-4c97-b8d1-5322d0faa6af,https://au-api.basiq.io/institutions/AU00000,,Supermarket and Grocery Stores,411
transaction,25496a6e-b2a8-4228-9811-96d6042c8617,posted,RAYS PIZZA CAFE BALG,-61.00,49544383-c19c-4c97-b8d1-5322d0faa6af,-6478.77,debit,payment,AU00000,5453f0a3-083c-43c6-9086-adfe94df9918,,,2022-08-04T00:00:00Z,,https://au-api.basiq.io/users/11103cba-4a08-4397-84a5-22ac125ed2f6/transactions/25496a6e-b2a8-4228-9811-96d6042c8617,https://au-api.basiq.io/users/11103cba-4a08-4397-84a5-22ac125ed2f6/accounts/49544383-c19c-4c97-b8d1-5322d0faa6af,https://au-api.basiq.io/institutions/AU00000,,"Cafes, Restaurants and Takeaway Food Services",451
transaction,ae68e936-2b21-441c-b458-f869ecc6ed32,posted,JB HI FI WARRINGAH BROO,-23.00,49544383-c19c-4c97-b8d1-5322d0faa6af,-6417.77,debit,payment,AU00000,5453f0a3-083c-43c6-9086-adfe94df9918,,,2022-08-04T00:00:00Z,,https://au-api.basiq.io/users/11103cba-4a08-4397-84a5-22ac125ed2f6/transactions/ae68e936-2b21-441c-b458-f869ecc6ed32,https://au-api.basiq.io/users/11103cba-4a08-4397-84a5-22ac125ed2f6/accounts/49544383-c19c-4c97-b8d1-5322d0faa6af,https://au-api.basiq.io/institutions/AU00000,,Electrical and Electronic Goods Retailing,422
transaction,3ee600f8-915c-4426-8a84-ba6940b3b040,posted,Only About Children Seaforth 1244301,-157.00,49544383-c19c-4c97-b8d1-5322d0faa6af,-6394.77,debit,payment,AU00000,5453f0a3-083c-43c6-9086-adfe94df9918,,,2022-08-04T00:00:00Z,,https://au-api.basiq.io/users/11103cba-4a08-4397-84a5-22ac125ed2f6/transactions/3ee600f8-915c-4426-8a84-ba6940b3b040,https://au-api.basiq.io/users/11103cba-4a08-4397-84a5-22ac125ed2f6/accounts/49544383-c19c-4c97-b8d1-5322d0faa6af,https://au-api.basiq.io/institutions/AU00000,,Other Health Care Services,859
transaction,b945a858-b777-45fa-a8ab-b0c148a8a0a7,posted,NRMA LIMITED - 3 NORT,-200.00,49544383-c19c-4c97-b8d1-5322d0faa6af,-6237.77,debit,payment,AU00000,5453f0a3-083c-43c6-9086-adfe94df9918,,,2022-08-03T00:00:00Z,,https://au-api.basiq.io/users/11103cba-4a08-4397-84a5-22ac125ed2f6/transactions/b945a858-b777-45fa-a8ab-b0c148a8a0a7,https://au-api.basiq.io/users/11103cba-4a08-4397-84a5-22ac125ed2f6/accounts/49544383-c19c-4c97-b8d1-5322d0faa6af,https://au-api.basiq.io/institutions/AU00000,,Health and General Insurance,632
transaction,3c39ed2e-eb93-493c-9f96-72e59ef62b15,posted,LE PARISIEN KILL,-37.40,49544383-c19c-4c97-b8d1-5322d0faa6af,-6037.77,debit,payment,AU00000,5453f0a3-083c-43c6-9086-adfe94df9918,,,2022-08-03T00:00:00Z,,https://au-api.basiq.io/users/11103cba-4a08-4397-84a5-22ac125ed2f6/transactions/3c39ed2e-eb93-493c-9f96-72e59ef62b15,https://au-api.basiq.io/users/11103cba-4a08-4397-84a5-22ac125ed2f6/accounts/49544383-c19c-4c97-b8d1-5322d0faa6af,https://au-api.basiq.io/institutions/AU00000,,"Cafes, Restaurants and Takeaway Food Services",451
transaction,484a99f3-69fb-4135-87e5-7b2d4c7be59b,posted,REFUND  04/04,45.95,49544383-c19c-4c97-b8d1-5322d0faa6af,-6000.37,credit,refund,AU00000,5453f0a3-083c-43c6-9086-adfe94df9918,,,2022-08-03T00:00:00Z,,https://au-api.basiq.io/users/11103cba-4a08-4397-84a5-22ac125ed2f6/transactions/484a99f3-69fb-4135-87e5-7b2d4c7be59b,https://au-api.basiq.io/users/11103cba-4a08-4397-84a5-22ac125ed2f6/accounts/49544383-c19c-4c97-b8d1-5322d0faa6af,https://au-api.basiq.io/institutions/AU00000,,,
transaction,56eb620c-c12c-412f-b87c-53905b5b947a,posted,DISCOUNT TOY CO BELR,-179.35,49544383-c19c-4c97-b8d1-5322d0faa6af,-6046.32,debit,payment,AU00000,5453f0a3-083c-43c6-9086-adfe94df9918,,,2022-08-02T00:00:00Z,,https://au-api.basiq.io/users/11103cba-4a08-4397-84a5-22ac125ed2f6/transactions/56eb620c-c12c-412f-b87c-53905b5b947a,https://au-api.basiq.io/users/11103cba-4a08-4397-84a5-22ac125ed2f6/accounts/49544383-c19c-4c97-b8d1-5322d0faa6af,https://au-api.basiq.io/institutions/AU00000,,Recreational Goods Retailing,424
transaction,feca008e-fd58-4efd-b145-72cd271109eb,posted,HEADYS PTY LTD BROO,-52.25,49544383-c19c-4c97-b8d1-5322d0faa6af,-5866.97,debit,payment,AU00000,5453f0a3-083c-43c6-9086-adfe94df9918,,,2022-08-02T00:00:00Z,,https://au-api.basiq.io/users/11103cba-4a08-4397-84a5-22ac125ed2f6/transactions/feca008e-fd58-4efd-b145-72cd271109eb,https://au-api.basiq.io/users/11103cba-4a08-4397-84a5-22ac125ed2f6/accounts/49544383-c19c-4c97-b8d1-5322d0faa6af,https://au-api.basiq.io/institutions/AU00000,,Specialised Food Retailing,412
transaction,f4f050de-5573-40a2-879f-89167817e374,posted,DAVID JONES LIMITED BROO,-45.95,49544383-c19c-4c97-b8d1-5322d0faa6af,-5814.72,debit,payment,AU00000,5453f0a3-083c-43c6-9086-adfe94df9918,,,2022-08-02T00:00:00Z,,https://au-api.basiq.io/users/11103cba-4a08-4397-84a5-22ac125ed2f6/transactions/f4f050de-5573-40a2-879f-89167817e374,https://au-api.basiq.io/users/11103cba-4a08-4397-84a5-22ac125ed2f6/accounts/49544383-c19c-4c97-b8d1-5322d0faa6af,https://au-api.basiq.io/institutions/AU00000,,Department Stores,426
transaction,a91bda59-0510-4702-a36d-4a9ff153eddf,posted,BUNNINGS 551000 WARR,-29.20,49544383-c19c-4c97-b8d1-5322d0faa6af,-5768.77,debit,payment,AU00000,5453f0a3-083c-43c6-9086-adfe94df9918,,,2022-08-02T00:00:00Z,,https://au-api.basiq.io/users/11103cba-4a08-4397-84a5-22ac125ed2f6/transactions/a91bda59-0510-4702-a36d-4a9ff153eddf,https://au-api.basiq.io/users/11103cba-4a08-4397-84a5-22ac125ed2f6/accounts/49544383-c19c-4c97-b8d1-5322d0faa6af,https://au-api.basiq.io/institutions/AU00000,,"Hardware, Building and Garden Supplies Retailing",423
transaction,40813ef1-065f-4e5f-81cc-7eb4645deef4,posted,SQ *FRATELLI POLITO PR Fren,-106.00,49544383-c19c-4c97-b8d1-5322d0faa6af,-5739.57,debit,payment,AU00000,5453f0a3-083c-43c6-9086-adfe94df9918,,,2022-08-01T00:00:00Z,,https://au-api.basiq.io/users/11103cba-4a08-4397-84a5-22ac125ed2f6/transactions/40813ef1-065f-4e5f-81cc-7eb4645deef4,https://au-api.basiq.io/users/11103cba-4a08-4397-84a5-22ac125ed2f6/accounts/49544383-c19c-4c97-b8d1-5322d0faa6af,https://au-api.basiq.io/institutions/AU00000,,Specialised Food Retailing,412
transaction,6d426008-214c-4f70-97fd-34e50b8de5a0,posted,WABI SABI INTERNATIO CHAT,-80.30,49544383-c19c-4c97-b8d1-5322d0faa6af,-5633.57,debit,payment,AU00000,5453f0a3-083c-43c6-9086-adfe94df9918,,,2022-08-01T00:00:00Z,,https://au-api.basiq.io/users/11103cba-4a08-4397-84a5-22ac125ed2f6/transactions/6d426008-214c-4f70-97fd-34e50b8de5a0,https://au-api.basiq.io/users/11103cba-4a08-4397-84a5-22ac125ed2f6/accounts/49544383-c19c-4c97-b8d1-5322d0faa6af,https://au-api.basiq.io/institutions/AU00000,,"Cafes, Restaurants and Takeaway Food Services",451
transaction,b61e0d94-598c-43fd-8983-9f340bcdafc3,posted,GINSENG HEALTH FOODS FREN,-62.85,49544383-c19c-4c97-b8d1-5322d0faa6af,-5553.27,debit,payment,AU00000,5453f0a3-083c-43c6-9086-adfe94df9918,,,2022-08-01T00:00:00Z,,https://au-api.basiq.io/users/11103cba-4a08-4397-84a5-22ac125ed2f6/transactions/b61e0d94-598c-43fd-8983-9f340bcdafc3,https://au-api.basiq.io/users/11103cba-4a08-4397-84a5-22ac125ed2f6/accounts/49544383-c19c-4c97-b8d1-5322d0faa6af,https://au-api.basiq.io/institutions/AU00000,,Specialised Food Retailing,412
transaction,f7b7ab30-30bf-49a2-8876-e570b56b68f5,posted,TARGET 5078 BROO,-52.00,49544383-c19c-4c97-b8d1-5322d0faa6af,-5490.42,debit,payment,AU00000,5453f0a3-083c-43c6-9086-adfe94df9918,,,2022-08-01T00:00:00Z,,https://au-api.basiq.io/users/11103cba-4a08-4397-84a5-22ac125ed2f6/transactions/f7b7ab30-30bf-49a2-8876-e570b56b68f5,https://au-api.basiq.io/users/11103cba-4a08-4397-84a5-22ac125ed2f6/accounts/49544383-c19c-4c97-b8d1-5322d0faa6af,https://au-api.basiq.io/institutions/AU00000,,Department Stores,426
transaction,73b6ff02-892d-4c9a-804e-bf8555cd1e3c,posted,SQ *FRATELLI POLITO PR Fren,-21.00,49544383-c19c-4c97-b8d1-5322d0faa6af,-5438.42,debit,payment,AU00000,5453f0a3-083c-43c6-9086-adfe94df9918,,,2022-08-01T00:00:00Z,,https://au-api.basiq.io/users/11103cba-4a08-4397-84a5-22ac125ed2f6/transactions/73b6ff02-892d-4c9a-804e-bf8555cd1e3c,https://au-api.basiq.io/users/11103cba-4a08-4397-84a5-22ac125ed2f6/accounts/49544383-c19c-4c97-b8d1-5322d0faa6af,https://au-api.basiq.io/institutions/AU00000,,Specialised Food Retailing,412
transaction,1cf23cc8-2b6f-492a-b3a5-947d15d89696,posted,COLES 0854 FORE,-126.09,49544383-c19c-4c97-b8d1-5322d0faa6af,-5417.42,debit,payment,AU00000,5453f0a3-083c-43c6-9086-adfe94df9918,,,2022-07-31T00:00:00Z,,https://au-api.basiq.io/users/11103cba-4a08-4397-84a5-22ac125ed2f6/transactions/1cf23cc8-2b6f-492a-b3a5-947d15d89696,https://au-api.basiq.io/users/11103cba-4a08-4397-84a5-22ac125ed2f6/accounts/49544383-c19c-4c97-b8d1-5322d0faa6af,https://au-api.basiq.io/institutions/AU00000,,Supermarket and Grocery Stores,411
transaction,d8d5705f-d145-4f85-a3bc-47226ce0cdcb,posted,WOOLWORTHS 1063 FR FREN,-74.16,49544383-c19c-4c97-b8d1-5322d0faa6af,-5291.33,debit,payment,AU00000,5453f0a3-083c-43c6-9086-adfe94df9918,,,2022-07-31T00:00:00Z,,https://au-api.basiq.io/users/11103cba-4a08-4397-84a5-22ac125ed2f6/transactions/d8d5705f-d145-4f85-a3bc-47226ce0cdcb,https://au-api.basiq.io/users/11103cba-4a08-4397-84a5-22ac125ed2f6/accounts/49544383-c19c-4c97-b8d1-5322d0faa6af,https://au-api.basiq.io/institutions/AU00000,,Supermarket and Grocery Stores,411
transaction,e6a3007a-e134-4a0f-b0d2-a79cda06eafa,posted,TASTE BAGUETTE GLNRS BELR,-12.20,49544383-c19c-4c97-b8d1-5322d0faa6af,-5217.17,debit,payment,AU00000,5453f0a3-083c-43c6-9086-adfe94df9918,,,2022-07-31T00:00:00Z,,https://au-api.basiq.io/users/11103cba-4a08-4397-84a5-22ac125ed2f6/transactions/e6a3007a-e134-4a0f-b0d2-a79cda06eafa,https://au-api.basiq.io/users/11103cba-4a08-4397-84a5-22ac125ed2f6/accounts/49544383-c19c-4c97-b8d1-5322d0faa6af,https://au-api.basiq.io/institutions/AU00000,,"Cafes, Restaurants and Takeaway Food Services",451
transaction,ed3dae26-6405-47d6-98ac-7260942a7fd4,posted,DISCOUNT TOY CO BELR,-11.50,49544383-c19c-4c97-b8d1-5322d0faa6af,-5204.97,debit,payment,AU00000,5453f0a3-083c-43c6-9086-adfe94df9918,,,2022-07-31T00:00:00Z,,https://au-api.basiq.io/users/11103cba-4a08-4397-84a5-22ac125ed2f6/transactions/ed3dae26-6405-47d6-98ac-7260942a7fd4,https://au-api.basiq.io/users/11103cba-4a08-4397-84a5-22ac125ed2f6/accounts/49544383-c19c-4c97-b8d1-5322d0faa6af,https://au-api.basiq.io/institutions/AU00000,,Recreational Goods Retailing,424
transaction,219fc1ad-cd3c-42d6-b9d1-a0dbeccad86e,posted,GINSENG CHINESE MED CHATSWOOD AU,-881.00,49544383-c19c-4c97-b8d1-5322d0faa6af,-5193.47,debit,payment,AU00000,5453f0a3-083c-43c6-9086-adfe94df9918,,,2022-07-30T00:00:00Z,,https://au-api.basiq.io/users/11103cba-4a08-4397-84a5-22ac125ed2f6/transactions/219fc1ad-cd3c-42d6-b9d1-a0dbeccad86e,https://au-api.basiq.io/users/11103cba-4a08-4397-84a5-22ac125ed2f6/accounts/49544383-c19c-4c97-b8d1-5322d0faa6af,https://au-api.basiq.io/institutions/AU00000,,Other Health Care Services,859
transaction,45a27b1e-d7a7-4c19-999f-a5441878644f,posted,TFR From Transaction to CC Acc 13,9316.00,49544383-c19c-4c97-b8d1-5322d0faa6af,-4312.47,credit,transfer,AU00000,5453f0a3-083c-43c6-9086-adfe94df9918,,,2022-07-28T00:00:00Z,,https://au-api.basiq.io/users/11103cba-4a08-4397-84a5-22ac125ed2f6/transactions/45a27b1e-d7a7-4c19-999f-a5441878644f,https://au-api.basiq.io/users/11103cba-4a08-4397-84a5-22ac125ed2f6/accounts/49544383-c19c-4c97-b8d1-5322d0faa6af,https://au-api.basiq.io/institutions/AU00000,,,
transaction,6d201071-ff5b-4f32-9195-a87d0dbf175e,posted,Only About Children Seaforth 1244301,-157.00,49544383-c19c-4c97-b8d1-5322d0faa6af,-13628.47,debit,payment,AU00000,5453f0a3-083c-43c6-9086-adfe94df9918,,,2022-07-28T00:00:00Z,,https://au-api.basiq.io/users/11103cba-4a08-4397-84a5-22ac125ed2f6/transactions/6d201071-ff5b-4f32-9195-a87d0dbf175e,https://au-api.basiq.io/users/11103cba-4a08-4397-84a5-22ac125ed2f6/accounts/49544383-c19c-4c97-b8d1-5322d0faa6af,https://au-api.basiq.io/institutions/AU00000,,Other Health Care Services,859
transaction,16e3438c-9d13-40ab-b0cd-de40be0597ce,posted,IKEA RHODES RHODES AU,-899.89,49544383-c19c-4c97-b8d1-5322d0faa6af,-13471.47,debit,payment,AU00000,5453f0a3-083c-43c6-9086-adfe94df9918,,,2022-07-27T00:00:00Z,,https://au-api.basiq.io/users/11103cba-4a08-4397-84a5-22ac125ed2f6/transactions/16e3438c-9d13-40ab-b0cd-de40be0597ce,https://au-api.basiq.io/users/11103cba-4a08-4397-84a5-22ac125ed2f6/accounts/49544383-c19c-4c97-b8d1-5322d0faa6af,https://au-api.basiq.io/institutions/AU00000,,"Furniture, Floor Coverings, Houseware and Textile Goods Retailing",421
transaction,2ad6fdd7-0a11-4d43-a38a-c521c4dc5697,posted,IKEA RHODES RHODES AU,-4.00,49544383-c19c-4c97-b8d1-5322d0faa6af,-12571.58,debit,payment,AU00000,5453f0a3-083c-43c6-9086-adfe94df9918,,,2022-07-27T00:00:00Z,,https://au-api.basiq.io/users/11103cba-4a08-4397-84a5-22ac125ed2f6/transactions/2ad6fdd7-0a11-4d43-a38a-c521c4dc5697,https://au-api.basiq.io/users/11103cba-4a08-4397-84a5-22ac125ed2f6/accounts/49544383-c19c-4c97-b8d1-5322d0faa6af,https://au-api.basiq.io/institutions/AU00000,,"Furniture, Floor Coverings, Houseware and Textile Goods Retailing",421
transaction,e30a64e2-f497-439a-897a-8ece01c00ca3,posted,Cash Wdr  T    FRENCHS FR2  AU,-123.00,49544383-c19c-4c97-b8d1-5322d0faa6af,-12567.58,debit,cash-withdrawal,AU00000,5453f0a3-083c-43c6-9086-adfe94df9918,,,2022-07-26T00:00:00Z,,https://au-api.basiq.io/users/11103cba-4a08-4397-84a5-22ac125ed2f6/transactions/e30a64e2-f497-439a-897a-8ece01c00ca3,https://au-api.basiq.io/users/11103cba-4a08-4397-84a5-22ac125ed2f6/accounts/49544383-c19c-4c97-b8d1-5322d0faa6af,https://au-api.basiq.io/institutions/AU00000,,,
transaction,9dcf822a-ef5f-4c62-9f3f-b371a3bc374d,posted,GIO BRIS,-885.49,49544383-c19c-4c97-b8d1-5322d0faa6af,-12444.58,debit,payment,AU00000,5453f0a3-083c-43c6-9086-adfe94df9918,,,2022-07-26T00:00:00Z,,https://au-api.basiq.io/users/11103cba-4a08-4397-84a5-22ac125ed2f6/transactions/9dcf822a-ef5f-4c62-9f3f-b371a3bc374d,https://au-api.basiq.io/users/11103cba-4a08-4397-84a5-22ac125ed2f6/accounts/49544383-c19c-4c97-b8d1-5322d0faa6af,https://au-api.basiq.io/institutions/AU00000,,Health and General Insurance,632
transaction,71200820-143b-4442-867f-3f33c9ba003c,posted,SERVICE NSW SYDN,-359.57,49544383-c19c-4c97-b8d1-5322d0faa6af,-11559.09,debit,payment,AU00000,5453f0a3-083c-43c6-9086-adfe94df9918,,,2022-07-26T00:00:00Z,,https://au-api.basiq.io/users/11103cba-4a08-4397-84a5-22ac125ed2f6/transactions/71200820-143b-4442-867f-3f33c9ba003c,https://au-api.basiq.io/users/11103cba-4a08-4397-84a5-22ac125ed2f6/accounts/49544383-c19c-4c97-b8d1-5322d0faa6af,https://au-api.basiq.io/institutions/AU00000,,Regulatory Services,772
transaction,414b4cf4-d843-4f1c-bbdb-b26ff602543a,posted,MATFRUIT PTY LTD BROO,-58.94,49544383-c19c-4c97-b8d1-5322d0faa6af,-11199.52,debit,payment,AU00000,5453f0a3-083c-43c6-9086-adfe94df9918,,,2022-07-26T00:00:00Z,,https://au-api.basiq.io/users/11103cba-4a08-4397-84a5-22ac125ed2f6/transactions/414b4cf4-d843-4f1c-bbdb-b26ff602543a,https://au-api.basiq.io/users/11103cba-4a08-4397-84a5-22ac125ed2f6/accounts/49544383-c19c-4c97-b8d1-5322d0faa6af,https://au-api.basiq.io/institutions/AU00000,,Specialised Food Retailing,412
transaction,808f566d-4e2d-413c-8ce7-6f2e1ff2e33c,posted,HEADYS PTY LTD BROO,-39.72,49544383-c19c-4c97-b8d1-5322d0faa6af,-11140.58,debit,payment,AU00000,5453f0a3-083c-43c6-9086-adfe94df9918,,,2022-07-26T00:00:00Z,,https://au-api.basiq.io/users/11103cba-4a08-4397-84a5-22ac125ed2f6/transactions/808f566d-4e2d-413c-8ce7-6f2e1ff2e33c,https://au-api.basiq.io/users/11103cba-4a08-4397-84a5-22ac125ed2f6/accounts/49544383-c19c-4c97-b8d1-5322d0faa6af,https://au-api.basiq.io/institutions/AU00000,,Specialised Food Retailing,412
transaction,7c0dbd43-0e54-4cfe-86ac-6a2389ed6e14,posted,DAVID JONES LIMITED BROO,-38.89,49544383-c19c-4c97-b8d1-5322d0faa6af,-11100.86,debit,payment,AU00000,5453f0a3-083c-43c6-9086-adfe94df9918,,,2022-07-26T00:00:00Z,,https://au-api.basiq.io/users/11103cba-4a08-4397-84a5-22ac125ed2f6/transactions/7c0dbd43-0e54-4cfe-86ac-6a2389ed6e14,https://au-api.basiq.io/users/11103cba-4a08-4397-84a5-22ac125ed2f6/accounts/49544383-c19c-4c97-b8d1-5322d0faa6af,https://au-api.basiq.io/institutions/AU00000,,Department Stores,426
transaction,607f4bab-8f45-4f90-b1ee-1838f823e6bf,posted,BUNNINGS 588000 BELR,-13.75,49544383-c19c-4c97-b8d1-5322d0faa6af,-11061.97,debit,payment,AU00000,5453f0a3-083c-43c6-9086-adfe94df9918,,,2022-07-26T00:00:00Z,,https://au-api.basiq.io/users/11103cba-4a08-4397-84a5-22ac125ed2f6/transactions/607f4bab-8f45-4f90-b1ee-1838f823e6bf,https://au-api.basiq.io/users/11103cba-4a08-4397-84a5-22ac125ed2f6/accounts/49544383-c19c-4c97-b8d1-5322d0faa6af,https://au-api.basiq.io/institutions/AU00000,,"Hardware, Building and Garden Supplies Retailing",423
transaction,34316d75-c8d3-487e-a95b-b2b84b9257b7,posted,BUNNINGS 588000 BELR,-10.25,49544383-c19c-4c97-b8d1-5322d0faa6af,-11048.22,debit,payment,AU00000,5453f0a3-083c-43c6-9086-adfe94df9918,,,2022-07-26T00:00:00Z,,https://au-api.basiq.io/users/11103cba-4a08-4397-84a5-22ac125ed2f6/transactions/34316d75-c8d3-487e-a95b-b2b84b9257b7,https://au-api.basiq.io/users/11103cba-4a08-4397-84a5-22ac125ed2f6/accounts/49544383-c19c-4c97-b8d1-5322d0faa6af,https://au-api.basiq.io/institutions/AU00000,,"Hardware, Building and Garden Supplies Retailing",423
transaction,9ef7f6ad-b170-4ca3-b45b-225b87133718,posted,SQ *FRATELLI POLITO PR Fren,-91.00,49544383-c19c-4c97-b8d1-5322d0faa6af,-11037.97,debit,payment,AU00000,5453f0a3-083c-43c6-9086-adfe94df9918,,,2022-07-25T00:00:00Z,,https://au-api.basiq.io/users/11103cba-4a08-4397-84a5-22ac125ed2f6/transactions/9ef7f6ad-b170-4ca3-b45b-225b87133718,https://au-api.basiq.io/users/11103cba-4a08-4397-84a5-22ac125ed2f6/accounts/49544383-c19c-4c97-b8d1-5322d0faa6af,https://au-api.basiq.io/institutions/AU00000,,Specialised Food Retailing,412
transaction,35721b0c-fab5-4764-804e-ffc77d721041,posted,VILLEROY AND BOCH BROO,-5.95,49544383-c19c-4c97-b8d1-5322d0faa6af,-10946.97,debit,payment,AU00000,5453f0a3-083c-43c6-9086-adfe94df9918,,,2022-07-25T00:00:00Z,,https://au-api.basiq.io/users/11103cba-4a08-4397-84a5-22ac125ed2f6/transactions/35721b0c-fab5-4764-804e-ffc77d721041,https://au-api.basiq.io/users/11103cba-4a08-4397-84a5-22ac125ed2f6/accounts/49544383-c19c-4c97-b8d1-5322d0faa6af,https://au-api.basiq.io/institutions/AU00000,,Pharmaceutical and Other Store-Based Retailing,427
transaction,8a2c237a-4731-4880-a051-1e89e4dcfd2c,posted,POST WARRINGAH MAL L NSWAU,-103.14,49544383-c19c-4c97-b8d1-5322d0faa6af,-10941.02,debit,payment,AU00000,5453f0a3-083c-43c6-9086-adfe94df9918,,,2022-07-25T00:00:00Z,,https://au-api.basiq.io/users/11103cba-4a08-4397-84a5-22ac125ed2f6/transactions/8a2c237a-4731-4880-a051-1e89e4dcfd2c,https://au-api.basiq.io/users/11103cba-4a08-4397-84a5-22ac125ed2f6/accounts/49544383-c19c-4c97-b8d1-5322d0faa6af,https://au-api.basiq.io/institutions/AU00000,,Postal and Courier Pick-up and Delivery Services,510
transaction,e24e3dd0-96ab-41db-9a11-04c1f4d1331b,posted,GIRDLERS GRIND BROO,-26.00,49544383-c19c-4c97-b8d1-5322d0faa6af,-10837.88,debit,payment,AU00000,5453f0a3-083c-43c6-9086-adfe94df9918,,,2022-07-24T00:00:00Z,,https://au-api.basiq.io/users/11103cba-4a08-4397-84a5-22ac125ed2f6/transactions/e24e3dd0-96ab-41db-9a11-04c1f4d1331b,https://au-api.basiq.io/users/11103cba-4a08-4397-84a5-22ac125ed2f6/accounts/49544383-c19c-4c97-b8d1-5322d0faa6af,https://au-api.basiq.io/institutions/AU00000,,"Cafes, Restaurants and Takeaway Food Services",451
transaction,3983ce64-2c27-4666-bfaf-060325bbb25f,posted,TARGET 5078 BROO,-16.00,49544383-c19c-4c97-b8d1-5322d0faa6af,-10811.88,debit,payment,AU00000,5453f0a3-083c-43c6-9086-adfe94df9918,,,2022-07-24T00:00:00Z,,https://au-api.basiq.io/users/11103cba-4a08-4397-84a5-22ac125ed2f6/transactions/3983ce64-2c27-4666-bfaf-060325bbb25f,https://au-api.basiq.io/users/11103cba-4a08-4397-84a5-22ac125ed2f6/accounts/49544383-c19c-4c97-b8d1-5322d0faa6af,https://au-api.basiq.io/institutions/AU00000,,Department Stores,426
transaction,276cb9a3-58b9-460d-b501-2511707855ef,posted,WOOLWORTHS 1063 FRENCHS FRST NSW AU,-165.19,49544383-c19c-4c97-b8d1-5322d0faa6af,-10795.88,debit,payment,AU00000,5453f0a3-083c-43c6-9086-adfe94df9918,,,2022-07-23T00:00:00Z,,https://au-api.basiq.io/users/11103cba-4a08-4397-84a5-22ac125ed2f6/transactions/276cb9a3-58b9-460d-b501-2511707855ef,https://au-api.basiq.io/users/11103cba-4a08-4397-84a5-22ac125ed2f6/accounts/49544383-c19c-4c97-b8d1-5322d0faa6af,https://au-api.basiq.io/institutions/AU00000,,Supermarket and Grocery Stores,411
transaction,8e6cfc59-a12a-4a6a-ae6c-1139b57129aa,posted,GINSENG CHINESE MED CHATSWOOD AU,-351.00,49544383-c19c-4c97-b8d1-5322d0faa6af,-10630.69,debit,payment,AU00000,5453f0a3-083c-43c6-9086-adfe94df9918,,,2022-07-23T00:00:00Z,,https://au-api.basiq.io/users/11103cba-4a08-4397-84a5-22ac125ed2f6/transactions/8e6cfc59-a12a-4a6a-ae6c-1139b57129aa,https://au-api.basiq.io/users/11103cba-4a08-4397-84a5-22ac125ed2f6/accounts/49544383-c19c-4c97-b8d1-5322d0faa6af,https://au-api.basiq.io/institutions/AU00000,,Other Health Care Services,859
transaction,79f50b91-28c8-44fa-9fba-99ea78b73037,posted,Cash Wdr  T     WYNYARD NSW AU,-123.50,49544383-c19c-4c97-b8d1-5322d0faa6af,-10279.69,debit,cash-withdrawal,AU00000,5453f0a3-083c-43c6-9086-adfe94df9918,,,2022-07-22T00:00:00Z,,https://au-api.basiq.io/users/11103cba-4a08-4397-84a5-22ac125ed2f6/transactions/79f50b91-28c8-44fa-9fba-99ea78b73037,https://au-api.basiq.io/users/11103cba-4a08-4397-84a5-22ac125ed2f6/accounts/49544383-c19c-4c97-b8d1-5322d0faa6af,https://au-api.basiq.io/institutions/AU00000,,,
transaction,b7f6cfa9-972b-4c93-bbd3-5473106afb7f,posted,BP FORESTVILLE 2227 FORESTVILLE AU,-98.10,49544383-c19c-4c97-b8d1-5322d0faa6af,-10156.19,debit,payment,AU00000,5453f0a3-083c-43c6-9086-adfe94df9918,,,2022-07-22T00:00:00Z,,https://au-api.basiq.io/users/11103cba-4a08-4397-84a5-22ac125ed2f6/transactions/b7f6cfa9-972b-4c93-bbd3-5473106afb7f,https://au-api.basiq.io/users/11103cba-4a08-4397-84a5-22ac125ed2f6/accounts/49544383-c19c-4c97-b8d1-5322d0faa6af,https://au-api.basiq.io/institutions/AU00000,,Fuel Retailing,400
transaction,d8bcd2a2-cdcd-4c28-8685-860bfd0e9fff,posted,TOP MARQUES AUTOMOTI FORESTVILLE AU,-830.15,49544383-c19c-4c97-b8d1-5322d0faa6af,-10058.09,debit,payment,AU00000,5453f0a3-083c-43c6-9086-adfe94df9918,,,2022-07-22T00:00:00Z,,https://au-api.basiq.io/users/11103cba-4a08-4397-84a5-22ac125ed2f6/transactions/d8bcd2a2-cdcd-4c28-8685-860bfd0e9fff,https://au-api.basiq.io/users/11103cba-4a08-4397-84a5-22ac125ed2f6/accounts/49544383-c19c-4c97-b8d1-5322d0faa6af,https://au-api.basiq.io/institutions/AU00000,,Automotive Repair and Maintenance,941
transaction,e7c3b9f4-37d8-4314-831d-c9c768f07326,posted,REFUND  BROOKVALE    AU,22.00,49544383-c19c-4c97-b8d1-5322d0faa6af,-9227.94,credit,refund,AU00000,5453f0a3-083c-43c6-9086-adfe94df9918,,,2022-07-22T00:00:00Z,,https://au-api.basiq.io/users/11103cba-4a08-4397-84a5-22ac125ed2f6/transactions/e7c3b9f4-37d8-4314-831d-c9c768f07326,https://au-api.basiq.io/users/11103cba-4a08-4397-84a5-22ac125ed2f6/accounts/49544383-c19c-4c97-b8d1-5322d0faa6af,https://au-api.basiq.io/institutions/AU00000,,,
transaction,b0643213-cb91-434f-bdd2-a3440996dbc1,posted,Impulse Chiropractic North Curl AU,-156.00,49544383-c19c-4c97-b8d1-5322d0faa6af,-9249.94,debit,payment,AU00000,5453f0a3-083c-43c6-9086-adfe94df9918,,,2022-07-22T00:00:00Z,,https://au-api.basiq.io/users/11103cba-4a08-4397-84a5-22ac125ed2f6/transactions/b0643213-cb91-434f-bdd2-a3440996dbc1,https://au-api.basiq.io/users/11103cba-4a08-4397-84a5-22ac125ed2f6/accounts/49544383-c19c-4c97-b8d1-5322d0faa6af,https://au-api.basiq.io/institutions/AU00000,,Allied Health Services,853
transaction,513949f9-4bb4-4591-947b-453aa935469a,posted,Only About Children Seaforth 1244301,-157.00,49544383-c19c-4c97-b8d1-5322d0faa6af,-9093.94,debit,payment,AU00000,5453f0a3-083c-43c6-9086-adfe94df9918,,,2022-07-21T00:00:00Z,,https://au-api.basiq.io/users/11103cba-4a08-4397-84a5-22ac125ed2f6/transactions/513949f9-4bb4-4591-947b-453aa935469a,https://au-api.basiq.io/users/11103cba-4a08-4397-84a5-22ac125ed2f6/accounts/49544383-c19c-4c97-b8d1-5322d0faa6af,https://au-api.basiq.io/institutions/AU00000,,Other Health Care Services,859
transaction,c2b580d4-9fab-45b3-862e-23c3cb1c60e6,posted,CTX WOW BELROSE BELROSE AU,-51.10,49544383-c19c-4c97-b8d1-5322d0faa6af,-8936.94,debit,payment,AU00000,5453f0a3-083c-43c6-9086-adfe94df9918,,,2022-07-20T00:00:00Z,,https://au-api.basiq.io/users/11103cba-4a08-4397-84a5-22ac125ed2f6/transactions/c2b580d4-9fab-45b3-862e-23c3cb1c60e6,https://au-api.basiq.io/users/11103cba-4a08-4397-84a5-22ac125ed2f6/accounts/49544383-c19c-4c97-b8d1-5322d0faa6af,https://au-api.basiq.io/institutions/AU00000,,Fuel Retailing,400
transaction,261c52e4-714e-4ce2-bd96-a9be1247125b,posted,WOOLWORTHS 1262 BELR,-126.99,49544383-c19c-4c97-b8d1-5322d0faa6af,-8885.84,debit,payment,AU00000,5453f0a3-083c-43c6-9086-adfe94df9918,,,2022-07-19T00:00:00Z,,https://au-api.basiq.io/users/11103cba-4a08-4397-84a5-22ac125ed2f6/transactions/261c52e4-714e-4ce2-bd96-a9be1247125b,https://au-api.basiq.io/users/11103cba-4a08-4397-84a5-22ac125ed2f6/accounts/49544383-c19c-4c97-b8d1-5322d0faa6af,https://au-api.basiq.io/institutions/AU00000,,Supermarket and Grocery Stores,411
transaction,18a351b1-ddc5-4f77-a070-4ead67fd6cde,posted,BIG W ONLINE BELL,-109.90,49544383-c19c-4c97-b8d1-5322d0faa6af,-8758.85,debit,payment,AU00000,5453f0a3-083c-43c6-9086-adfe94df9918,,,2022-07-19T00:00:00Z,,https://au-api.basiq.io/users/11103cba-4a08-4397-84a5-22ac125ed2f6/transactions/18a351b1-ddc5-4f77-a070-4ead67fd6cde,https://au-api.basiq.io/users/11103cba-4a08-4397-84a5-22ac125ed2f6/accounts/49544383-c19c-4c97-b8d1-5322d0faa6af,https://au-api.basiq.io/institutions/AU00000,,Department Stores,426
transaction,bc5d5335-7b5c-4c9d-b498-162582b8f17b,posted,HOYTS SYDN,-45.80,49544383-c19c-4c97-b8d1-5322d0faa6af,-8648.95,debit,payment,AU00000,5453f0a3-083c-43c6-9086-adfe94df9918,,,2022-07-19T00:00:00Z,,https://au-api.basiq.io/users/11103cba-4a08-4397-84a5-22ac125ed2f6/transactions/bc5d5335-7b5c-4c9d-b498-162582b8f17b,https://au-api.basiq.io/users/11103cba-4a08-4397-84a5-22ac125ed2f6/accounts/49544383-c19c-4c97-b8d1-5322d0faa6af,https://au-api.basiq.io/institutions/AU00000,,Motion Picture and Video Activities,551
transaction,2c8f1e3b-abc9-40e1-8357-abf2712d29f8,posted,ACADEMY OF ACROBATIC BROOKVALE AU,-258.00,49544383-c19c-4c97-b8d1-5322d0faa6af,-8603.15,debit,payment,AU00000,5453f0a3-083c-43c6-9086-adfe94df9918,,,2022-07-19T00:00:00Z,,https://au-api.basiq.io/users/11103cba-4a08-4397-84a5-22ac125ed2f6/transactions/2c8f1e3b-abc9-40e1-8357-abf2712d29f8,https://au-api.basiq.io/users/11103cba-4a08-4397-84a5-22ac125ed2f6/accounts/49544383-c19c-4c97-b8d1-5322d0faa6af,https://au-api.basiq.io/institutions/AU00000,,Sports and Physical Recreation Activities,911
transaction,003f33d3-0aba-4e16-aada-45e732476029,posted,NRMA WEB SYDN,-49.36,49544383-c19c-4c97-b8d1-5322d0faa6af,-8345.15,debit,payment,AU00000,5453f0a3-083c-43c6-9086-adfe94df9918,,,2022-07-18T00:00:00Z,,https://au-api.basiq.io/users/11103cba-4a08-4397-84a5-22ac125ed2f6/transactions/003f33d3-0aba-4e16-aada-45e732476029,https://au-api.basiq.io/users/11103cba-4a08-4397-84a5-22ac125ed2f6/accounts/49544383-c19c-4c97-b8d1-5322d0faa6af,https://au-api.basiq.io/institutions/AU00000,,Health and General Insurance,632
transaction,bac9cff1-a964-465b-b62b-879865d95b48,posted,COLES 0897 BROO,-26.10,49544383-c19c-4c97-b8d1-5322d0faa6af,-8295.79,debit,payment,AU00000,5453f0a3-083c-43c6-9086-adfe94df9918,,,2022-07-18T00:00:00Z,,https://au-api.basiq.io/users/11103cba-4a08-4397-84a5-22ac125ed2f6/transactions/bac9cff1-a964-465b-b62b-879865d95b48,https://au-api.basiq.io/users/11103cba-4a08-4397-84a5-22ac125ed2f6/accounts/49544383-c19c-4c97-b8d1-5322d0faa6af,https://au-api.basiq.io/institutions/AU00000,,Supermarket and Grocery Stores,411
transaction,31f9bbea-5635-4a80-9adb-6d09e41bbeaf,posted,AGL SALES P/L 0307 MELB,-49.13,49544383-c19c-4c97-b8d1-5322d0faa6af,-8269.69,debit,payment,AU00000,5453f0a3-083c-43c6-9086-adfe94df9918,,,2022-07-17T00:00:00Z,,https://au-api.basiq.io/users/11103cba-4a08-4397-84a5-22ac125ed2f6/transactions/31f9bbea-5635-4a80-9adb-6d09e41bbeaf,https://au-api.basiq.io/users/11103cba-4a08-4397-84a5-22ac125ed2f6/accounts/49544383-c19c-4c97-b8d1-5322d0faa6af,https://au-api.basiq.io/institutions/AU00000,,Electricity Distribution,263
transaction,623d4e60-3b7e-48b8-b9ad-71233a6fc067,posted,AGL SALES P/L 0307 MELB,-32.76,49544383-c19c-4c97-b8d1-5322d0faa6af,-8220.56,debit,payment,AU00000,5453f0a3-083c-43c6-9086-adfe94df9918,,,2022-07-17T00:00:00Z,,https://au-api.basiq.io/users/11103cba-4a08-4397-84a5-22ac125ed2f6/transactions/623d4e60-3b7e-48b8-b9ad-71233a6fc067,https://au-api.basiq.io/users/11103cba-4a08-4397-84a5-22ac125ed2f6/accounts/49544383-c19c-4c97-b8d1-5322d0faa6af,https://au-api.basiq.io/institutions/AU00000,,Electricity Distribution,263
transaction,3442b4ea-da22-454f-b0bb-f286dbc692c3,posted,HAYDEN THEATRES CREM,-19.10,49544383-c19c-4c97-b8d1-5322d0faa6af,-8187.80,debit,payment,AU00000,5453f0a3-083c-43c6-9086-adfe94df9918,,,2022-07-17T00:00:00Z,,https://au-api.basiq.io/users/11103cba-4a08-4397-84a5-22ac125ed2f6/transactions/3442b4ea-da22-454f-b0bb-f286dbc692c3,https://au-api.basiq.io/users/11103cba-4a08-4397-84a5-22ac125ed2f6/accounts/49544383-c19c-4c97-b8d1-5322d0faa6af,https://au-api.basiq.io/institutions/AU00000,,Motion Picture and Video Activities,551
transaction,fd6f019d-a72b-48dd-aacb-c670284ca711,posted,WOOLWORTHS 1063 FRENCHS FRST NSW AU,-220.12,49544383-c19c-4c97-b8d1-5322d0faa6af,-8168.70,debit,payment,AU00000,5453f0a3-083c-43c6-9086-adfe94df9918,,,2022-07-16T00:00:00Z,,https://au-api.basiq.io/users/11103cba-4a08-4397-84a5-22ac125ed2f6/transactions/fd6f019d-a72b-48dd-aacb-c670284ca711,https://au-api.basiq.io/users/11103cba-4a08-4397-84a5-22ac125ed2f6/accounts/49544383-c19c-4c97-b8d1-5322d0faa6af,https://au-api.basiq.io/institutions/AU00000,,Supermarket and Grocery Stores,411
transaction,fd4046c4-c885-4283-b304-311171e69364,posted,Rev:WOOLWORTHS 1063 FRENCHS FRST NSW AU,-220.12,49544383-c19c-4c97-b8d1-5322d0faa6af,-7948.58,debit,payment,AU00000,5453f0a3-083c-43c6-9086-adfe94df9918,,,2022-07-16T00:00:00Z,,https://au-api.basiq.io/users/11103cba-4a08-4397-84a5-22ac125ed2f6/transactions/fd4046c4-c885-4283-b304-311171e69364,https://au-api.basiq.io/users/11103cba-4a08-4397-84a5-22ac125ed2f6/accounts/49544383-c19c-4c97-b8d1-5322d0faa6af,https://au-api.basiq.io/institutions/AU00000,,"Cafes, Restaurants and Takeaway Food Services",451
transaction,60f0eeb8-b2a0-4295-a26c-79046e24db7f,posted,WOOLWORTHS 1063 FRENCHS FRST NSW AU,-220.12,49544383-c19c-4c97-b8d1-5322d0faa6af,-7728.46,debit,payment,AU00000,5453f0a3-083c-43c6-9086-adfe94df9918,,,2022-07-16T00:00:00Z,,https://au-api.basiq.io/users/11103cba-4a08-4397-84a5-22ac125ed2f6/transactions/60f0eeb8-b2a0-4295-a26c-79046e24db7f,https://au-api.basiq.io/users/11103cba-4a08-4397-84a5-22ac125ed2f6/accounts/49544383-c19c-4c97-b8d1-5322d0faa6af,https://au-api.basiq.io/institutions/AU00000,,Supermarket and Grocery Stores,411
transaction,e8b4b07c-3b08-4db2-b736-2165de5a29f0,posted,JB HI FI WARRINGAH BROOKVALE AU,-291.00,49544383-c19c-4c97-b8d1-5322d0faa6af,-7508.34,debit,payment,AU00000,5453f0a3-083c-43c6-9086-adfe94df9918,,,2022-07-16T00:00:00Z,,https://au-api.basiq.io/users/11103cba-4a08-4397-84a5-22ac125ed2f6/transactions/e8b4b07c-3b08-4db2-b736-2165de5a29f0,https://au-api.basiq.io/users/11103cba-4a08-4397-84a5-22ac125ed2f6/accounts/49544383-c19c-4c97-b8d1-5322d0faa6af,https://au-api.basiq.io/institutions/AU00000,,Electrical and Electronic Goods Retailing,422
transaction,38be3bf6-4bad-478c-88aa-f96f907e88bd,posted,WOOLWORTHS 1262 BELR,-149.46,49544383-c19c-4c97-b8d1-5322d0faa6af,-7217.34,debit,payment,AU00000,5453f0a3-083c-43c6-9086-adfe94df9918,,,2022-07-15T00:00:00Z,,https://au-api.basiq.io/users/11103cba-4a08-4397-84a5-22ac125ed2f6/transactions/38be3bf6-4bad-478c-88aa-f96f907e88bd,https://au-api.basiq.io/users/11103cba-4a08-4397-84a5-22ac125ed2f6/accounts/49544383-c19c-4c97-b8d1-5322d0faa6af,https://au-api.basiq.io/institutions/AU00000,,Supermarket and Grocery Stores,411
transaction,1ebc0ebe-aca7-4261-8ff4-6a076aa1289c,posted,GINSENG CHINESE MED CHATSWOOD AU,-254.00,49544383-c19c-4c97-b8d1-5322d0faa6af,-7067.88,debit,payment,AU00000,5453f0a3-083c-43c6-9086-adfe94df9918,,,2022-07-15T00:00:00Z,,https://au-api.basiq.io/users/11103cba-4a08-4397-84a5-22ac125ed2f6/transactions/1ebc0ebe-aca7-4261-8ff4-6a076aa1289c,https://au-api.basiq.io/users/11103cba-4a08-4397-84a5-22ac125ed2f6/accounts/49544383-c19c-4c97-b8d1-5322d0faa6af,https://au-api.basiq.io/institutions/AU00000,,Other Health Care Services,859
transaction,5deca0b0-60be-4ed0-8f5e-b9787df795ea,posted,Only About Children Seaforth 1244301,-157.00,49544383-c19c-4c97-b8d1-5322d0faa6af,-6813.88,debit,payment,AU00000,5453f0a3-083c-43c6-9086-adfe94df9918,,,2022-07-14T00:00:00Z,,https://au-api.basiq.io/users/11103cba-4a08-4397-84a5-22ac125ed2f6/transactions/5deca0b0-60be-4ed0-8f5e-b9787df795ea,https://au-api.basiq.io/users/11103cba-4a08-4397-84a5-22ac125ed2f6/accounts/49544383-c19c-4c97-b8d1-5322d0faa6af,https://au-api.basiq.io/institutions/AU00000,,Other Health Care Services,859
transaction,9c0ce154-e33d-4347-9a55-b413a62bf5bb,posted,TOP MARQUES AUTOMOTI FORESTVILLE AU,-613.05,49544383-c19c-4c97-b8d1-5322d0faa6af,-6656.88,debit,payment,AU00000,5453f0a3-083c-43c6-9086-adfe94df9918,,,2022-07-14T00:00:00Z,,https://au-api.basiq.io/users/11103cba-4a08-4397-84a5-22ac125ed2f6/transactions/9c0ce154-e33d-4347-9a55-b413a62bf5bb,https://au-api.basiq.io/users/11103cba-4a08-4397-84a5-22ac125ed2f6/accounts/49544383-c19c-4c97-b8d1-5322d0faa6af,https://au-api.basiq.io/institutions/AU00000,,Automotive Repair and Maintenance,941
transaction,901465e1-0da5-4e20-9981-a1e0e5275262,posted,OPTUS PREPAID MELBOURN,-40.00,49544383-c19c-4c97-b8d1-5322d0faa6af,-6043.83,debit,payment,AU00000,5453f0a3-083c-43c6-9086-adfe94df9918,,,2022-07-14T00:00:00Z,,https://au-api.basiq.io/users/11103cba-4a08-4397-84a5-22ac125ed2f6/transactions/901465e1-0da5-4e20-9981-a1e0e5275262,https://au-api.basiq.io/users/11103cba-4a08-4397-84a5-22ac125ed2f6/accounts/49544383-c19c-4c97-b8d1-5322d0faa6af,https://au-api.basiq.io/institutions/AU00000,,Telecommunications Services,580
transaction,731fd10d-3980-47ee-8bb9-f1fb613e0579,posted,Cash Wdr  SEAFORTH  2  AU,-83.00,49544383-c19c-4c97-b8d1-5322d0faa6af,-6003.83,debit,cash-withdrawal,AU00000,5453f0a3-083c-43c6-9086-adfe94df9918,,,2022-07-13T00:00:00Z,,https://au-api.basiq.io/users/11103cba-4a08-4397-84a5-22ac125ed2f6/transactions/731fd10d-3980-47ee-8bb9-f1fb613e0579,https://au-api.basiq.io/users/11103cba-4a08-4397-84a5-22ac125ed2f6/accounts/49544383-c19c-4c97-b8d1-5322d0faa6af,https://au-api.basiq.io/institutions/AU00000,,,
transaction,52a53eac-1306-4bc2-af63-19d0b35843c8,posted,WW PETROL 1790 BELC,-55.44,49544383-c19c-4c97-b8d1-5322d0faa6af,-5920.83,debit,payment,AU00000,5453f0a3-083c-43c6-9086-adfe94df9918,,,2022-07-12T00:00:00Z,,https://au-api.basiq.io/users/11103cba-4a08-4397-84a5-22ac125ed2f6/transactions/52a53eac-1306-4bc2-af63-19d0b35843c8,https://au-api.basiq.io/users/11103cba-4a08-4397-84a5-22ac125ed2f6/accounts/49544383-c19c-4c97-b8d1-5322d0faa6af,https://au-api.basiq.io/institutions/AU00000,,Fuel Retailing,400
transaction,850d66e3-2833-4691-9d9d-17431bc4282a,posted,OFARM ORGANIC GROCERS PTYBROO,-31.28,49544383-c19c-4c97-b8d1-5322d0faa6af,-5865.39,debit,payment,AU00000,5453f0a3-083c-43c6-9086-adfe94df9918,,,2022-07-12T00:00:00Z,,https://au-api.basiq.io/users/11103cba-4a08-4397-84a5-22ac125ed2f6/transactions/850d66e3-2833-4691-9d9d-17431bc4282a,https://au-api.basiq.io/users/11103cba-4a08-4397-84a5-22ac125ed2f6/accounts/49544383-c19c-4c97-b8d1-5322d0faa6af,https://au-api.basiq.io/institutions/AU00000,,Supermarket and Grocery Stores,411
transaction,069a881b-db5c-48a9-b6a6-9962cd39b7f9,posted,Dee Why Discount V&SS Dee,-178.70,49544383-c19c-4c97-b8d1-5322d0faa6af,-5834.11,debit,payment,AU00000,5453f0a3-083c-43c6-9086-adfe94df9918,,,2022-07-11T00:00:00Z,,https://au-api.basiq.io/users/11103cba-4a08-4397-84a5-22ac125ed2f6/transactions/069a881b-db5c-48a9-b6a6-9962cd39b7f9,https://au-api.basiq.io/users/11103cba-4a08-4397-84a5-22ac125ed2f6/accounts/49544383-c19c-4c97-b8d1-5322d0faa6af,https://au-api.basiq.io/institutions/AU00000,,Specialised Food Retailing,412
transaction,463ad099-2b41-4036-aa64-0342353e1eed,posted,WOOLWORTHS 1056 NA NARR,-96.44,49544383-c19c-4c97-b8d1-5322d0faa6af,-5655.41,debit,payment,AU00000,5453f0a3-083c-43c6-9086-adfe94df9918,,,2022-07-11T00:00:00Z,,https://au-api.basiq.io/users/11103cba-4a08-4397-84a5-22ac125ed2f6/transactions/463ad099-2b41-4036-aa64-0342353e1eed,https://au-api.basiq.io/users/11103cba-4a08-4397-84a5-22ac125ed2f6/accounts/49544383-c19c-4c97-b8d1-5322d0faa6af,https://au-api.basiq.io/institutions/AU00000,,Supermarket and Grocery Stores,411
transaction,8438b6aa-726d-412b-938e-91bbe7483e4f,posted,TARGET 5078 BROO,-76.00,49544383-c19c-4c97-b8d1-5322d0faa6af,-5558.97,debit,payment,AU00000,5453f0a3-083c-43c6-9086-adfe94df9918,,,2022-07-11T00:00:00Z,,https://au-api.basiq.io/users/11103cba-4a08-4397-84a5-22ac125ed2f6/transactions/8438b6aa-726d-412b-938e-91bbe7483e4f,https://au-api.basiq.io/users/11103cba-4a08-4397-84a5-22ac125ed2f6/accounts/49544383-c19c-4c97-b8d1-5322d0faa6af,https://au-api.basiq.io/institutions/AU00000,,Department Stores,426
transaction,7f740422-ca63-4f97-8863-63d35554f8ff,posted,Venture Health Manly Manl,-25.66,49544383-c19c-4c97-b8d1-5322d0faa6af,-5482.97,debit,payment,AU00000,5453f0a3-083c-43c6-9086-adfe94df9918,,,2022-07-11T00:00:00Z,,https://au-api.basiq.io/users/11103cba-4a08-4397-84a5-22ac125ed2f6/transactions/7f740422-ca63-4f97-8863-63d35554f8ff,https://au-api.basiq.io/users/11103cba-4a08-4397-84a5-22ac125ed2f6/accounts/49544383-c19c-4c97-b8d1-5322d0faa6af,https://au-api.basiq.io/institutions/AU00000,,Specialised Food Retailing,412
transaction,3d80d015-62fa-4850-96c7-7c299407ba01,posted,WOOLWORTHS 1282 BROO,-24.50,49544383-c19c-4c97-b8d1-5322d0faa6af,-5457.31,debit,payment,AU00000,5453f0a3-083c-43c6-9086-adfe94df9918,,,2022-07-11T00:00:00Z,,https://au-api.basiq.io/users/11103cba-4a08-4397-84a5-22ac125ed2f6/transactions/3d80d015-62fa-4850-96c7-7c299407ba01,https://au-api.basiq.io/users/11103cba-4a08-4397-84a5-22ac125ed2f6/accounts/49544383-c19c-4c97-b8d1-5322d0faa6af,https://au-api.basiq.io/institutions/AU00000,,Supermarket and Grocery Stores,411
transaction,33459ca5-0b57-428b-b94a-6bc768d32c0b,posted,WOOLWORTHS 1063 FR FREN,-19.30,49544383-c19c-4c97-b8d1-5322d0faa6af,-5432.81,debit,payment,AU00000,5453f0a3-083c-43c6-9086-adfe94df9918,,,2022-07-11T00:00:00Z,,https://au-api.basiq.io/users/11103cba-4a08-4397-84a5-22ac125ed2f6/transactions/33459ca5-0b57-428b-b94a-6bc768d32c0b,https://au-api.basiq.io/users/11103cba-4a08-4397-84a5-22ac125ed2f6/accounts/49544383-c19c-4c97-b8d1-5322d0faa6af,https://au-api.basiq.io/institutions/AU00000,,Supermarket and Grocery Stores,411
transaction,ad4831b1-7a98-4d39-91db-488e9c48bc9c,posted,MRCHT ACC VENUE TCKTS BALL,-72.00,49544383-c19c-4c97-b8d1-5322d0faa6af,-5413.51,debit,payment,AU00000,5453f0a3-083c-43c6-9086-adfe94df9918,,,2022-07-10T00:00:00Z,,https://au-api.basiq.io/users/11103cba-4a08-4397-84a5-22ac125ed2f6/transactions/ad4831b1-7a98-4d39-91db-488e9c48bc9c,https://au-api.basiq.io/users/11103cba-4a08-4397-84a5-22ac125ed2f6/accounts/49544383-c19c-4c97-b8d1-5322d0faa6af,https://au-api.basiq.io/institutions/AU00000,,Unknown,0
transaction,7c7b8206-9c55-416c-84e0-c35108a071c1,posted,HFM MANLY MANLY AU,-34.86,49544383-c19c-4c97-b8d1-5322d0faa6af,-5341.51,debit,payment,AU00000,5453f0a3-083c-43c6-9086-adfe94df9918,,,2022-07-10T00:00:00Z,,https://au-api.basiq.io/users/11103cba-4a08-4397-84a5-22ac125ed2f6/transactions/7c7b8206-9c55-416c-84e0-c35108a071c1,https://au-api.basiq.io/users/11103cba-4a08-4397-84a5-22ac125ed2f6/accounts/49544383-c19c-4c97-b8d1-5322d0faa6af,https://au-api.basiq.io/institutions/AU00000,,Supermarket and Grocery Stores,411
transaction,a5f1ecec-ed9d-46d7-9082-5b9305be9908,posted,Pure Wholefood549949 MANLY2 AU,-16.50,49544383-c19c-4c97-b8d1-5322d0faa6af,-5306.65,debit,payment,AU00000,5453f0a3-083c-43c6-9086-adfe94df9918,,,2022-07-10T00:00:00Z,,https://au-api.basiq.io/users/11103cba-4a08-4397-84a5-22ac125ed2f6/transactions/a5f1ecec-ed9d-46d7-9082-5b9305be9908,https://au-api.basiq.io/users/11103cba-4a08-4397-84a5-22ac125ed2f6/accounts/49544383-c19c-4c97-b8d1-5322d0faa6af,https://au-api.basiq.io/institutions/AU00000,,"Cafes, Restaurants and Takeaway Food Services",451
transaction,2e1dcf44-921a-42e8-8ccc-2aa64a411116,posted,Pure Wholefood549949 MANLY2 AU,-142.00,49544383-c19c-4c97-b8d1-5322d0faa6af,-5290.15,debit,payment,AU00000,5453f0a3-083c-43c6-9086-adfe94df9918,,,2022-07-10T00:00:00Z,,https://au-api.basiq.io/users/11103cba-4a08-4397-84a5-22ac125ed2f6/transactions/2e1dcf44-921a-42e8-8ccc-2aa64a411116,https://au-api.basiq.io/users/11103cba-4a08-4397-84a5-22ac125ed2f6/accounts/49544383-c19c-4c97-b8d1-5322d0faa6af,https://au-api.basiq.io/institutions/AU00000,,"Cafes, Restaurants and Takeaway Food Services",451
transaction,909f50af-6376-4dcb-a975-7adf2e351541,posted,GINSENG HEALTH FOODS FREN,-30.00,49544383-c19c-4c97-b8d1-5322d0faa6af,-5148.15,debit,payment,AU00000,5453f0a3-083c-43c6-9086-adfe94df9918,,,2022-07-07T00:00:00Z,,https://au-api.basiq.io/users/11103cba-4a08-4397-84a5-22ac125ed2f6/transactions/909f50af-6376-4dcb-a975-7adf2e351541,https://au-api.basiq.io/users/11103cba-4a08-4397-84a5-22ac125ed2f6/accounts/49544383-c19c-4c97-b8d1-5322d0faa6af,https://au-api.basiq.io/institutions/AU00000,,Specialised Food Retailing,412
transaction,f190cb49-0d3a-4543-8dd9-05570ece584d,posted,Only About Children Seaforth 1244301,-157.00,49544383-c19c-4c97-b8d1-5322d0faa6af,-5118.15,debit,payment,AU00000,5453f0a3-083c-43c6-9086-adfe94df9918,,,2022-07-07T00:00:00Z,,https://au-api.basiq.io/users/11103cba-4a08-4397-84a5-22ac125ed2f6/transactions/f190cb49-0d3a-4543-8dd9-05570ece584d,https://au-api.basiq.io/users/11103cba-4a08-4397-84a5-22ac125ed2f6/accounts/49544383-c19c-4c97-b8d1-5322d0faa6af,https://au-api.basiq.io/institutions/AU00000,,Other Health Care Services,859
transaction,5722ea26-3975-4877-aa4c-76eabe934637,posted,WOOLWORTHS 1262 BELR,-201.00,49544383-c19c-4c97-b8d1-5322d0faa6af,-4961.15,debit,payment,AU00000,5453f0a3-083c-43c6-9086-adfe94df9918,,,2022-07-07T00:00:00Z,,https://au-api.basiq.io/users/11103cba-4a08-4397-84a5-22ac125ed2f6/transactions/5722ea26-3975-4877-aa4c-76eabe934637,https://au-api.basiq.io/users/11103cba-4a08-4397-84a5-22ac125ed2f6/accounts/49544383-c19c-4c97-b8d1-5322d0faa6af,https://au-api.basiq.io/institutions/AU00000,,Supermarket and Grocery Stores,411
transaction,22c74425-d0a4-450c-8f9d-8014da9c93eb,posted,WOOLWORTHS 1262 BELR,-123.73,49544383-c19c-4c97-b8d1-5322d0faa6af,-4760.15,debit,payment,AU00000,5453f0a3-083c-43c6-9086-adfe94df9918,,,2022-07-07T00:00:00Z,,https://au-api.basiq.io/users/11103cba-4a08-4397-84a5-22ac125ed2f6/transactions/22c74425-d0a4-450c-8f9d-8014da9c93eb,https://au-api.basiq.io/users/11103cba-4a08-4397-84a5-22ac125ed2f6/accounts/49544383-c19c-4c97-b8d1-5322d0faa6af,https://au-api.basiq.io/institutions/AU00000,,Supermarket and Grocery Stores,411
transaction,62755d2a-6553-4e6c-b7ca-c75b4a735525,posted,NRMA LIMITED - 3 NORT,-111.00,49544383-c19c-4c97-b8d1-5322d0faa6af,-4636.42,debit,payment,AU00000,5453f0a3-083c-43c6-9086-adfe94df9918,,,2022-07-06T00:00:00Z,,https://au-api.basiq.io/users/11103cba-4a08-4397-84a5-22ac125ed2f6/transactions/62755d2a-6553-4e6c-b7ca-c75b4a735525,https://au-api.basiq.io/users/11103cba-4a08-4397-84a5-22ac125ed2f6/accounts/49544383-c19c-4c97-b8d1-5322d0faa6af,https://au-api.basiq.io/institutions/AU00000,,Health and General Insurance,632
transaction,ced88d28-d677-4dd1-9054-7257b0e76a9a,posted,FOREST THERAPEUTIC MAS FREN,-91.00,49544383-c19c-4c97-b8d1-5322d0faa6af,-4525.42,debit,payment,AU00000,5453f0a3-083c-43c6-9086-adfe94df9918,,,2022-07-06T00:00:00Z,,https://au-api.basiq.io/users/11103cba-4a08-4397-84a5-22ac125ed2f6/transactions/ced88d28-d677-4dd1-9054-7257b0e76a9a,https://au-api.basiq.io/users/11103cba-4a08-4397-84a5-22ac125ed2f6/accounts/49544383-c19c-4c97-b8d1-5322d0faa6af,https://au-api.basiq.io/institutions/AU00000,,Other Health Care Services,859
transaction,24186e1d-c2d9-40f4-94e3-4a53dcec0df8,posted,TERREY HILLS TAVERN TERR,-53.00,49544383-c19c-4c97-b8d1-5322d0faa6af,-4434.42,debit,payment,AU00000,5453f0a3-083c-43c6-9086-adfe94df9918,,,2022-07-05T00:00:00Z,,https://au-api.basiq.io/users/11103cba-4a08-4397-84a5-22ac125ed2f6/transactions/24186e1d-c2d9-40f4-94e3-4a53dcec0df8,https://au-api.basiq.io/users/11103cba-4a08-4397-84a5-22ac125ed2f6/accounts/49544383-c19c-4c97-b8d1-5322d0faa6af,https://au-api.basiq.io/institutions/AU00000,,"Pubs, Taverns and Bars",452
transaction,ec0e5a47-b56e-4b41-a69a-9d4d8b613c3f,posted,MRCHT ACC VENUE TCKTS BALL,-45.00,49544383-c19c-4c97-b8d1-5322d0faa6af,-4381.42,debit,payment,AU00000,5453f0a3-083c-43c6-9086-adfe94df9918,,,2022-07-05T00:00:00Z,,https://au-api.basiq.io/users/11103cba-4a08-4397-84a5-22ac125ed2f6/transactions/ec0e5a47-b56e-4b41-a69a-9d4d8b613c3f,https://au-api.basiq.io/users/11103cba-4a08-4397-84a5-22ac125ed2f6/accounts/49544383-c19c-4c97-b8d1-5322d0faa6af,https://au-api.basiq.io/institutions/AU00000,,Unknown,0
transaction,2cb57408-31d8-41a5-83ce-bbafa7cd6f29,posted,TASTE BAGUETTE GLNRS BELR,-10.50,49544383-c19c-4c97-b8d1-5322d0faa6af,-4336.42,debit,payment,AU00000,5453f0a3-083c-43c6-9086-adfe94df9918,,,2022-07-05T00:00:00Z,,https://au-api.basiq.io/users/11103cba-4a08-4397-84a5-22ac125ed2f6/transactions/2cb57408-31d8-41a5-83ce-bbafa7cd6f29,https://au-api.basiq.io/users/11103cba-4a08-4397-84a5-22ac125ed2f6/accounts/49544383-c19c-4c97-b8d1-5322d0faa6af,https://au-api.basiq.io/institutions/AU00000,,"Cafes, Restaurants and Takeaway Food Services",451
transaction,9d12a24a-d941-479f-8ff4-46daecc2c5b5,posted,HOYTS CORP PTY LTD CHATSWOOD NSWAU,-40.00,49544383-c19c-4c97-b8d1-5322d0faa6af,-4325.92,debit,payment,AU00000,5453f0a3-083c-43c6-9086-adfe94df9918,,,2022-07-05T00:00:00Z,,https://au-api.basiq.io/users/11103cba-4a08-4397-84a5-22ac125ed2f6/transactions/9d12a24a-d941-479f-8ff4-46daecc2c5b5,https://au-api.basiq.io/users/11103cba-4a08-4397-84a5-22ac125ed2f6/accounts/49544383-c19c-4c97-b8d1-5322d0faa6af,https://au-api.basiq.io/institutions/AU00000,,Motion Picture and Video Activities,551
transaction,5c116c33-dec8-4aa7-aa84-e24bfddc9237,posted,WOOLWORTHS 1063 FRENCHS FRST NSW AU,-115.17,49544383-c19c-4c97-b8d1-5322d0faa6af,-4285.92,debit,payment,AU00000,5453f0a3-083c-43c6-9086-adfe94df9918,,,2022-07-05T00:00:00Z,,https://au-api.basiq.io/users/11103cba-4a08-4397-84a5-22ac125ed2f6/transactions/5c116c33-dec8-4aa7-aa84-e24bfddc9237,https://au-api.basiq.io/users/11103cba-4a08-4397-84a5-22ac125ed2f6/accounts/49544383-c19c-4c97-b8d1-5322d0faa6af,https://au-api.basiq.io/institutions/AU00000,,Supermarket and Grocery Stores,411
transaction,f06ae4fa-d710-4314-87d1-07ab08acc124,posted,Cash Wdr  T    FRENCHS FR2  AU,-223.00,49544383-c19c-4c97-b8d1-5322d0faa6af,-4170.75,debit,cash-withdrawal,AU00000,5453f0a3-083c-43c6-9086-adfe94df9918,,,2022-07-04T00:00:00Z,,https://au-api.basiq.io/users/11103cba-4a08-4397-84a5-22ac125ed2f6/transactions/f06ae4fa-d710-4314-87d1-07ab08acc124,https://au-api.basiq.io/users/11103cba-4a08-4397-84a5-22ac125ed2f6/accounts/49544383-c19c-4c97-b8d1-5322d0faa6af,https://au-api.basiq.io/institutions/AU00000,,,
transaction,8c79ed73-0355-4e1d-a191-d4ffcab8beed,posted,BATTERY WORLD BROOKV AL BROOKVALE AU,-216.00,49544383-c19c-4c97-b8d1-5322d0faa6af,-3947.75,debit,payment,AU00000,5453f0a3-083c-43c6-9086-adfe94df9918,,,2022-07-04T00:00:00Z,,https://au-api.basiq.io/users/11103cba-4a08-4397-84a5-22ac125ed2f6/transactions/8c79ed73-0355-4e1d-a191-d4ffcab8beed,https://au-api.basiq.io/users/11103cba-4a08-4397-84a5-22ac125ed2f6/accounts/49544383-c19c-4c97-b8d1-5322d0faa6af,https://au-api.basiq.io/institutions/AU00000,,Motor Vehicle and Motor Vehicle Parts Wholesaling,350
transaction,b3462f68-7a36-4556-9d63-d5f54e26b181,posted,SERVICE NSW SYDN,-304.33,49544383-c19c-4c97-b8d1-5322d0faa6af,-3731.75,debit,payment,AU00000,5453f0a3-083c-43c6-9086-adfe94df9918,,,2022-07-04T00:00:00Z,,https://au-api.basiq.io/users/11103cba-4a08-4397-84a5-22ac125ed2f6/transactions/b3462f68-7a36-4556-9d63-d5f54e26b181,https://au-api.basiq.io/users/11103cba-4a08-4397-84a5-22ac125ed2f6/accounts/49544383-c19c-4c97-b8d1-5322d0faa6af,https://au-api.basiq.io/institutions/AU00000,,Regulatory Services,772
transaction,162033d8-3bcc-4dee-9a45-89ed081d5009,posted,RMS ETOLL PH 131865 PARR,-51.22,49544383-c19c-4c97-b8d1-5322d0faa6af,-3427.42,debit,payment,AU00000,5453f0a3-083c-43c6-9086-adfe94df9918,,,2022-07-04T00:00:00Z,,https://au-api.basiq.io/users/11103cba-4a08-4397-84a5-22ac125ed2f6/transactions/162033d8-3bcc-4dee-9a45-89ed081d5009,https://au-api.basiq.io/users/11103cba-4a08-4397-84a5-22ac125ed2f6/accounts/49544383-c19c-4c97-b8d1-5322d0faa6af,https://au-api.basiq.io/institutions/AU00000,,Unknown,0
transaction,4731e89e-5086-4704-a272-900ac84d1fa8,posted,THE ORGANIC FOOD NET HORN,-46.68,49544383-c19c-4c97-b8d1-5322d0faa6af,-3376.20,debit,payment,AU00000,5453f0a3-083c-43c6-9086-adfe94df9918,,,2022-07-04T00:00:00Z,,https://au-api.basiq.io/users/11103cba-4a08-4397-84a5-22ac125ed2f6/transactions/4731e89e-5086-4704-a272-900ac84d1fa8,https://au-api.basiq.io/users/11103cba-4a08-4397-84a5-22ac125ed2f6/accounts/49544383-c19c-4c97-b8d1-5322d0faa6af,https://au-api.basiq.io/institutions/AU00000,,Supermarket and Grocery Stores,411
transaction,8dc92e5a-1120-4096-acaf-fedf164e4a51,posted,GROUP ORGANICS PTY L BROO,-46.20,49544383-c19c-4c97-b8d1-5322d0faa6af,-3329.52,debit,payment,AU00000,5453f0a3-083c-43c6-9086-adfe94df9918,,,2022-07-04T00:00:00Z,,https://au-api.basiq.io/users/11103cba-4a08-4397-84a5-22ac125ed2f6/transactions/8dc92e5a-1120-4096-acaf-fedf164e4a51,https://au-api.basiq.io/users/11103cba-4a08-4397-84a5-22ac125ed2f6/accounts/49544383-c19c-4c97-b8d1-5322d0faa6af,https://au-api.basiq.io/institutions/AU00000,,Specialised Food Retailing,412
transaction,65abb458-85a5-4b3d-9d19-de248bf2bc57,posted,GROUPON AUSTRALIA SYDN,-34.00,49544383-c19c-4c97-b8d1-5322d0faa6af,-3283.32,debit,payment,AU00000,5453f0a3-083c-43c6-9086-adfe94df9918,,,2022-07-04T00:00:00Z,,https://au-api.basiq.io/users/11103cba-4a08-4397-84a5-22ac125ed2f6/transactions/65abb458-85a5-4b3d-9d19-de248bf2bc57,https://au-api.basiq.io/users/11103cba-4a08-4397-84a5-22ac125ed2f6/accounts/49544383-c19c-4c97-b8d1-5322d0faa6af,https://au-api.basiq.io/institutions/AU00000,,Non-Store Retailing,431
transaction,b376aef0-926d-4736-956a-b87ccd6e1c90,posted,FREE RANGE BUTCHERS PTY LMONA,-23.00,49544383-c19c-4c97-b8d1-5322d0faa6af,-3249.32,debit,payment,AU00000,5453f0a3-083c-43c6-9086-adfe94df9918,,,2022-07-04T00:00:00Z,,https://au-api.basiq.io/users/11103cba-4a08-4397-84a5-22ac125ed2f6/transactions/b376aef0-926d-4736-956a-b87ccd6e1c90,https://au-api.basiq.io/users/11103cba-4a08-4397-84a5-22ac125ed2f6/accounts/49544383-c19c-4c97-b8d1-5322d0faa6af,https://au-api.basiq.io/institutions/AU00000,,Specialised Food Retailing,412
transaction,1fa83702-c91a-49e7-b61a-f6dafb4558aa,posted,PP*SEANLAURENC OXFO,-16.00,49544383-c19c-4c97-b8d1-5322d0faa6af,-3226.32,debit,payment,AU00000,5453f0a3-083c-43c6-9086-adfe94df9918,,,2022-07-04T00:00:00Z,,https://au-api.basiq.io/users/11103cba-4a08-4397-84a5-22ac125ed2f6/transactions/1fa83702-c91a-49e7-b61a-f6dafb4558aa,https://au-api.basiq.io/users/11103cba-4a08-4397-84a5-22ac125ed2f6/accounts/49544383-c19c-4c97-b8d1-5322d0faa6af,https://au-api.basiq.io/institutions/AU00000,,"Hardware, Building and Garden Supplies Retailing",423
transaction,c03910ed-f1e3-4d11-a824-aafc4ada3a2e,posted,CITYOFSYDNEY PARKING SYDN,-6.90,49544383-c19c-4c97-b8d1-5322d0faa6af,-3210.32,debit,payment,AU00000,5453f0a3-083c-43c6-9086-adfe94df9918,,,2022-07-03T00:00:00Z,,https://au-api.basiq.io/users/11103cba-4a08-4397-84a5-22ac125ed2f6/transactions/c03910ed-f1e3-4d11-a824-aafc4ada3a2e,https://au-api.basiq.io/users/11103cba-4a08-4397-84a5-22ac125ed2f6/accounts/49544383-c19c-4c97-b8d1-5322d0faa6af,https://au-api.basiq.io/institutions/AU00000,,Other Personal Services,953
transaction,479f6407-1288-40c5-8584-856bba9e5ffd,posted,TERREY HILLS TAVERN TERREY HILLS NSWAU,-43.50,49544383-c19c-4c97-b8d1-5322d0faa6af,-3203.42,debit,payment,AU00000,5453f0a3-083c-43c6-9086-adfe94df9918,,,2022-07-02T00:00:00Z,,https://au-api.basiq.io/users/11103cba-4a08-4397-84a5-22ac125ed2f6/transactions/479f6407-1288-40c5-8584-856bba9e5ffd,https://au-api.basiq.io/users/11103cba-4a08-4397-84a5-22ac125ed2f6/accounts/49544383-c19c-4c97-b8d1-5322d0faa6af,https://au-api.basiq.io/institutions/AU00000,,"Pubs, Taverns and Bars",452
transaction,2038c4b2-9f8d-4d5f-9851-3615e1ce14f0,posted,MYER WARRINGAH BROOKVALE AU,-105.96,49544383-c19c-4c97-b8d1-5322d0faa6af,-3159.92,debit,payment,AU00000,5453f0a3-083c-43c6-9086-adfe94df9918,,,2022-07-02T00:00:00Z,,https://au-api.basiq.io/users/11103cba-4a08-4397-84a5-22ac125ed2f6/transactions/2038c4b2-9f8d-4d5f-9851-3615e1ce14f0,https://au-api.basiq.io/users/11103cba-4a08-4397-84a5-22ac125ed2f6/accounts/49544383-c19c-4c97-b8d1-5322d0faa6af,https://au-api.basiq.io/institutions/AU00000,,Department Stores,426
transaction,78cd2215-6158-4428-9136-3a45c7ba0246,posted,Cash Wdr  MONA VALE    NS,-503.00,49544383-c19c-4c97-b8d1-5322d0faa6af,-3053.96,debit,cash-withdrawal,AU00000,5453f0a3-083c-43c6-9086-adfe94df9918,,,2022-07-01T00:00:00Z,,https://au-api.basiq.io/users/11103cba-4a08-4397-84a5-22ac125ed2f6/transactions/78cd2215-6158-4428-9136-3a45c7ba0246,https://au-api.basiq.io/users/11103cba-4a08-4397-84a5-22ac125ed2f6/accounts/49544383-c19c-4c97-b8d1-5322d0faa6af,https://au-api.basiq.io/institutions/AU00000,,,
transaction,021969db-2613-4768-9b0f-f70a7ce8ffd6,posted,Savings Interest CR Bal @0%%,108.03,b2360b69-e3f3-49f3-bbc4-65d04865db02,25167.43,credit,interest,AU00000,5453f0a3-083c-43c6-9086-adfe94df9918,,,2022-09-28T00:00:00Z,,https://au-api.basiq.io/users/11103cba-4a08-4397-84a5-22ac125ed2f6/transactions/021969db-2613-4768-9b0f-f70a7ce8ffd6,https://au-api.basiq.io/users/11103cba-4a08-4397-84a5-22ac125ed2f6/accounts/b2360b69-e3f3-49f3-bbc4-65d04865db02,https://au-api.basiq.io/institutions/AU00000,,,
transaction,b151aa25-3c29-4308-8dd9-b2bf998f10af,posted,TFR Acc14000 TO 12389,500.00,b2360b69-e3f3-49f3-bbc4-65d04865db02,25059.40,credit,transfer,AU00000,5453f0a3-083c-43c6-9086-adfe94df9918,,,2022-09-11T00:00:00Z,,https://au-api.basiq.io/users/11103cba-4a08-4397-84a5-22ac125ed2f6/transactions/b151aa25-3c29-4308-8dd9-b2bf998f10af,https://au-api.basiq.io/users/11103cba-4a08-4397-84a5-22ac125ed2f6/accounts/b2360b69-e3f3-49f3-bbc4-65d04865db02,https://au-api.basiq.io/institutions/AU00000,,,
transaction,947fa446-1f36-417a-9fdd-fe6e3f02d499,posted,Savings Interest CR Bal @0%%,106.15,b2360b69-e3f3-49f3-bbc4-65d04865db02,24559.40,credit,interest,AU00000,5453f0a3-083c-43c6-9086-adfe94df9918,,,2022-08-28T00:00:00Z,,https://au-api.basiq.io/users/11103cba-4a08-4397-84a5-22ac125ed2f6/transactions/947fa446-1f36-417a-9fdd-fe6e3f02d499,https://au-api.basiq.io/users/11103cba-4a08-4397-84a5-22ac125ed2f6/accounts/b2360b69-e3f3-49f3-bbc4-65d04865db02,https://au-api.basiq.io/institutions/AU00000,,,
transaction,b8c37fc4-21af-455f-a865-4f35cb7e74b0,posted,TFR Acc14000 TO 12389,500.00,b2360b69-e3f3-49f3-bbc4-65d04865db02,24453.25,credit,transfer,AU00000,5453f0a3-083c-43c6-9086-adfe94df9918,,,2022-08-12T00:00:00Z,,https://au-api.basiq.io/users/11103cba-4a08-4397-84a5-22ac125ed2f6/transactions/b8c37fc4-21af-455f-a865-4f35cb7e74b0,https://au-api.basiq.io/users/11103cba-4a08-4397-84a5-22ac125ed2f6/accounts/b2360b69-e3f3-49f3-bbc4-65d04865db02,https://au-api.basiq.io/institutions/AU00000,,,
transaction,9b46141d-4ee2-4067-ab28-7aa7cc94f8a4,posted,Savings Interest CR Bal @0%%,89.63,b2360b69-e3f3-49f3-bbc4-65d04865db02,23953.25,credit,interest,AU00000,5453f0a3-083c-43c6-9086-adfe94df9918,,,2022-07-29T00:00:00Z,,https://au-api.basiq.io/users/11103cba-4a08-4397-84a5-22ac125ed2f6/transactions/9b46141d-4ee2-4067-ab28-7aa7cc94f8a4,https://au-api.basiq.io/users/11103cba-4a08-4397-84a5-22ac125ed2f6/accounts/b2360b69-e3f3-49f3-bbc4-65d04865db02,https://au-api.basiq.io/institutions/AU00000,,,
transaction,d31e41fe-f2f9-4a98-8cf4-0d88d318ee19,posted,TFR Acc14000 TO 12389,500.00,b2360b69-e3f3-49f3-bbc4-65d04865db02,23863.62,credit,transfer,AU00000,5453f0a3-083c-43c6-9086-adfe94df9918,,,2022-07-12T00:00:00Z,,https://au-api.basiq.io/users/11103cba-4a08-4397-84a5-22ac125ed2f6/transactions/d31e41fe-f2f9-4a98-8cf4-0d88d318ee19,https://au-api.basiq.io/users/11103cba-4a08-4397-84a5-22ac125ed2f6/accounts/b2360b69-e3f3-49f3-bbc4-65d04865db02,https://au-api.basiq.io/institutions/AU00000,,,
