type,id,status,description,amount,account,balance,direction,class,institution,connection,enrich,transactionDate,postDate,subClass,links.self,links.account,links.institution,links.connection,subClass.title,subClass.code
transaction,b3a90231-6489-45e0-9a5a-213d4e71937f,posted,Transfer Platnm Homeloan 346454,-3950.00,0b107c33-e858-4bbd-abba-f757ae4da1fc,10515.03,debit,transfer,AU00000,5453f0a3-083c-43c6-9086-adfe94df9918,,,2022-06-28T00:00:00Z,,https://au-api.basiq.io/users/11103cba-4a08-4397-84a5-22ac125ed2f6/transactions/b3a90231-6489-45e0-9a5a-213d4e71937f,https://au-api.basiq.io/users/11103cba-4a08-4397-84a5-22ac125ed2f6/accounts/0b107c33-e858-4bbd-abba-f757ae4da1fc,https://au-api.basiq.io/institutions/AU00000,,,
transaction,15e9b5ee-8ce0-457c-911f-5718f0041dca,posted,TFR From Transaction to CC Acc 13,-9308.50,0b107c33-e858-4bbd-abba-f757ae4da1fc,14465.03,debit,transfer,AU00000,5453f0a3-083c-43c6-9086-adfe94df9918,,,2022-06-27T00:00:00Z,,https://au-api.basiq.io/users/11103cba-4a08-4397-84a5-22ac125ed2f6/transactions/15e9b5ee-8ce0-457c-911f-5718f0041dca,https://au-api.basiq.io/users/11103cba-4a08-4397-84a5-22ac125ed2f6/accounts/0b107c33-e858-4bbd-abba-f757ae4da1fc,https://au-api.basiq.io/institutions/AU00000,,,
transaction,26e336e2-1739-4c4a-ae99-ba6e6c0e434f,posted,Payroll WFRMS 15439393,15985.00,0b107c33-e858-4bbd-abba-f757ae4da1fc,23773.53,credit,transfer,AU00000,5453f0a3-083c-43c6-9086-adfe94df9918,,,2022-06-27T00:00:00Z,,https://au-api.basiq.io/users/11103cba-4a08-4397-84a5-22ac125ed2f6/transactions/26e336e2-1739-4c4a-ae99-ba6e6c0e434f,https://au-api.basiq.io/users/11103cba-4a08-4397-84a5-22ac125ed2f6/accounts/0b107c33-e858-4bbd-abba-f757ae4da1fc,https://au-api.basiq.io/institutions/AU00000,,,
transaction,ee818488-a1ef-4400-9025-edbab2102e0c,posted,MANLY WEST SCHOOL,-2533.56,0b107c33-e858-4bbd-abba-f757ae4da1fc,7788.53,debit,payment,AU00000,5453f0a3-083c-43c6-9086-adfe94df9918,,,2022-06-27T00:00:00Z,,https://au-api.basiq.io/users/11103cba-4a08-4397-84a5-22ac125ed2f6/transactions/ee818488-a1ef-4400-9025-edbab2102e0c,https://au-api.basiq.io/users/11103cba-4a08-4397-84a5-22ac125ed2f6/accounts/0b107c33-e858-4bbd-abba-f757ae4da1fc,https://au-api.basiq.io/institutions/AU00000,,School Education,802
transaction,641b79c7-0a60-40d1-96bf-6c85e71c8eba,posted,MANLY WEST SCHOOL,-103.75,0b107c33-e858-4bbd-abba-f757ae4da1fc,10322.09,debit,payment,AU00000,5453f0a3-083c-43c6-9086-adfe94df9918,,,2022-06-27T00:00:00Z,,https://au-api.basiq.io/users/11103cba-4a08-4397-84a5-22ac125ed2f6/transactions/641b79c7-0a60-40d1-96bf-6c85e71c8eba,https://au-api.basiq.io/users/11103cba-4a08-4397-84a5-22ac125ed2f6/accounts/0b107c33-e858-4bbd-abba-f757ae4da1fc,https://au-api.basiq.io/institutions/AU00000,,School Education,802
transaction,1c8b673d-5d96-4a28-8114-d1d1e6a69814,posted,Manly Maths Tutor Wages,201.00,0b107c33-e858-4bbd-abba-f757ae4da1fc,10425.84,credit,transfer,AU00000,5453f0a3-083c-43c6-9086-adfe94df9918,,,2022-06-19T00:00:00Z,,https://au-api.basiq.io/users/11103cba-4a08-4397-84a5-22ac125ed2f6/transactions/1c8b673d-5d96-4a28-8114-d1d1e6a69814,https://au-api.basiq.io/users/11103cba-4a08-4397-84a5-22ac125ed2f6/accounts/0b107c33-e858-4bbd-abba-f757ae4da1fc,https://au-api.basiq.io/institutions/AU00000,,,
transaction,7a1b4d73-c8ac-4a10-b6ff-b2dd01a47b30,posted,Manly Maths Tutor Wages,201.00,0b107c33-e858-4bbd-abba-f757ae4da1fc,10224.84,credit,transfer,AU00000,5453f0a3-083c-43c6-9086-adfe94df9918,,,2022-06-15T00:00:00Z,,https://au-api.basiq.io/users/11103cba-4a08-4397-84a5-22ac125ed2f6/transactions/7a1b4d73-c8ac-4a10-b6ff-b2dd01a47b30,https://au-api.basiq.io/users/11103cba-4a08-4397-84a5-22ac125ed2f6/accounts/0b107c33-e858-4bbd-abba-f757ae4da1fc,https://au-api.basiq.io/institutions/AU00000,,,
transaction,b7a7c76b-116e-46c0-9733-f3dcdf9ee8f8,posted,TFR Acc14000 TO 12389,-500.00,0b107c33-e858-4bbd-abba-f757ae4da1fc,10023.84,debit,transfer,AU00000,5453f0a3-083c-43c6-9086-adfe94df9918,,,2022-06-14T00:00:00Z,,https://au-api.basiq.io/users/11103cba-4a08-4397-84a5-22ac125ed2f6/transactions/b7a7c76b-116e-46c0-9733-f3dcdf9ee8f8,https://au-api.basiq.io/users/11103cba-4a08-4397-84a5-22ac125ed2f6/accounts/0b107c33-e858-4bbd-abba-f757ae4da1fc,https://au-api.basiq.io/institutions/AU00000,,,
transaction,b75472ae-0e20-4b61-ac29-cde7c35aa0f7,posted,AGL RETAIL ENERGY LTD,-160.00,0b107c33-e858-4bbd-abba-f757ae4da1fc,10523.84,debit,payment,AU00000,5453f0a3-083c-43c6-9086-adfe94df9918,,,2022-06-13T00:00:00Z,,https://au-api.basiq.io/users/11103cba-4a08-4397-84a5-22ac125ed2f6/transactions/b75472ae-0e20-4b61-ac29-cde7c35aa0f7,https://au-api.basiq.io/users/11103cba-4a08-4397-84a5-22ac125ed2f6/accounts/0b107c33-e858-4bbd-abba-f757ae4da1fc,https://au-api.basiq.io/institutions/AU00000,,Electricity Distribution,263
transaction,eccf0bee-5ace-4ab8-a71b-52e8ad5a90a4,posted,AGL RETAIL ENERGY LTD (GAS),-69.00,0b107c33-e858-4bbd-abba-f757ae4da1fc,10683.84,debit,payment,AU00000,5453f0a3-083c-43c6-9086-adfe94df9918,,,2022-06-13T00:00:00Z,,https://au-api.basiq.io/users/11103cba-4a08-4397-84a5-22ac125ed2f6/transactions/eccf0bee-5ace-4ab8-a71b-52e8ad5a90a4,https://au-api.basiq.io/users/11103cba-4a08-4397-84a5-22ac125ed2f6/accounts/0b107c33-e858-4bbd-abba-f757ae4da1fc,https://au-api.basiq.io/institutions/AU00000,,Electricity Distribution,263
transaction,d8162a0d-9bfc-4fd8-8d2b-4f07209cf188,posted,CTRLINK CARERS Ref: 998R6789201610974V,752.40,0b107c33-e858-4bbd-abba-f757ae4da1fc,10752.84,credit,transfer,AU00000,5453f0a3-083c-43c6-9086-adfe94df9918,,,2022-06-09T00:00:00Z,,https://au-api.basiq.io/users/11103cba-4a08-4397-84a5-22ac125ed2f6/transactions/d8162a0d-9bfc-4fd8-8d2b-4f07209cf188,https://au-api.basiq.io/users/11103cba-4a08-4397-84a5-22ac125ed2f6/accounts/0b107c33-e858-4bbd-abba-f757ae4da1fc,https://au-api.basiq.io/institutions/AU00000,,,
transaction,e34fe7db-5f59-454c-a9b1-bbd01190abf9,posted,Transfer Platnm Homeloan 346454,-3957.50,0b107c33-e858-4bbd-abba-f757ae4da1fc,10000.44,debit,transfer,AU00000,5453f0a3-083c-43c6-9086-adfe94df9918,,,2022-05-31T00:00:00Z,,https://au-api.basiq.io/users/11103cba-4a08-4397-84a5-22ac125ed2f6/transactions/e34fe7db-5f59-454c-a9b1-bbd01190abf9,https://au-api.basiq.io/users/11103cba-4a08-4397-84a5-22ac125ed2f6/accounts/0b107c33-e858-4bbd-abba-f757ae4da1fc,https://au-api.basiq.io/institutions/AU00000,,,
transaction,749e1fd8-dba9-4aa9-bc4b-7190b0560d2c,posted,CTRLINK CARERS Ref: 998R6789201610974V,261.78,0b107c33-e858-4bbd-abba-f757ae4da1fc,13957.94,credit,transfer,AU00000,5453f0a3-083c-43c6-9086-adfe94df9918,,,2022-05-31T00:00:00Z,,https://au-api.basiq.io/users/11103cba-4a08-4397-84a5-22ac125ed2f6/transactions/749e1fd8-dba9-4aa9-bc4b-7190b0560d2c,https://au-api.basiq.io/users/11103cba-4a08-4397-84a5-22ac125ed2f6/accounts/0b107c33-e858-4bbd-abba-f757ae4da1fc,https://au-api.basiq.io/institutions/AU00000,,,
transaction,67a9bc6e-8afb-4fee-a180-e02291fbc4f2,posted,TFR From Transaction to CC Acc 13,-9301.00,0b107c33-e858-4bbd-abba-f757ae4da1fc,13696.16,debit,transfer,AU00000,5453f0a3-083c-43c6-9086-adfe94df9918,,,2022-05-30T00:00:00Z,,https://au-api.basiq.io/users/11103cba-4a08-4397-84a5-22ac125ed2f6/transactions/67a9bc6e-8afb-4fee-a180-e02291fbc4f2,https://au-api.basiq.io/users/11103cba-4a08-4397-84a5-22ac125ed2f6/accounts/0b107c33-e858-4bbd-abba-f757ae4da1fc,https://au-api.basiq.io/institutions/AU00000,,,
transaction,3ee2384d-bd8e-4908-9d0c-78924880d4b0,posted,Payroll WFRMS 15439393,15985.00,0b107c33-e858-4bbd-abba-f757ae4da1fc,22997.16,credit,transfer,AU00000,5453f0a3-083c-43c6-9086-adfe94df9918,,,2022-05-30T00:00:00Z,,https://au-api.basiq.io/users/11103cba-4a08-4397-84a5-22ac125ed2f6/transactions/3ee2384d-bd8e-4908-9d0c-78924880d4b0,https://au-api.basiq.io/users/11103cba-4a08-4397-84a5-22ac125ed2f6/accounts/0b107c33-e858-4bbd-abba-f757ae4da1fc,https://au-api.basiq.io/institutions/AU00000,,,
transaction,b7b4c90a-97db-49c1-b737-3b0e2bd3ce39,posted,Manly Maths Tutor Wages,201.00,0b107c33-e858-4bbd-abba-f757ae4da1fc,7012.16,credit,transfer,AU00000,5453f0a3-083c-43c6-9086-adfe94df9918,,,2022-05-17T00:00:00Z,,https://au-api.basiq.io/users/11103cba-4a08-4397-84a5-22ac125ed2f6/transactions/b7b4c90a-97db-49c1-b737-3b0e2bd3ce39,https://au-api.basiq.io/users/11103cba-4a08-4397-84a5-22ac125ed2f6/accounts/0b107c33-e858-4bbd-abba-f757ae4da1fc,https://au-api.basiq.io/institutions/AU00000,,,
transaction,5c35f3c8-e256-4b4d-8f34-374902a17e05,posted,Manly Maths Tutor Wages,201.00,0b107c33-e858-4bbd-abba-f757ae4da1fc,6811.16,credit,transfer,AU00000,5453f0a3-083c-43c6-9086-adfe94df9918,,,2022-05-15T00:00:00Z,,https://au-api.basiq.io/users/11103cba-4a08-4397-84a5-22ac125ed2f6/transactions/5c35f3c8-e256-4b4d-8f34-374902a17e05,https://au-api.basiq.io/users/11103cba-4a08-4397-84a5-22ac125ed2f6/accounts/0b107c33-e858-4bbd-abba-f757ae4da1fc,https://au-api.basiq.io/institutions/AU00000,,,
transaction,1e6dfecc-487e-4769-a589-2ec22d0e7a69,posted,TFR Acc14000 TO 12389,-500.00,0b107c33-e858-4bbd-abba-f757ae4da1fc,6610.16,debit,transfer,AU00000,5453f0a3-083c-43c6-9086-adfe94df9918,,,2022-05-14T00:00:00Z,,https://au-api.basiq.io/users/11103cba-4a08-4397-84a5-22ac125ed2f6/transactions/1e6dfecc-487e-4769-a589-2ec22d0e7a69,https://au-api.basiq.io/users/11103cba-4a08-4397-84a5-22ac125ed2f6/accounts/0b107c33-e858-4bbd-abba-f757ae4da1fc,https://au-api.basiq.io/institutions/AU00000,,,
transaction,63566e5b-e521-4cfe-a785-885e2a962b0d,posted,AGL RETAIL ENERGY LTD,-160.00,0b107c33-e858-4bbd-abba-f757ae4da1fc,7110.16,debit,payment,AU00000,5453f0a3-083c-43c6-9086-adfe94df9918,,,2022-05-11T00:00:00Z,,https://au-api.basiq.io/users/11103cba-4a08-4397-84a5-22ac125ed2f6/transactions/63566e5b-e521-4cfe-a785-885e2a962b0d,https://au-api.basiq.io/users/11103cba-4a08-4397-84a5-22ac125ed2f6/accounts/0b107c33-e858-4bbd-abba-f757ae4da1fc,https://au-api.basiq.io/institutions/AU00000,,Electricity Distribution,263
transaction,d2a3fe85-f937-43e7-bf24-949356f562cf,posted,AGL RETAIL ENERGY LTD (GAS),-69.00,0b107c33-e858-4bbd-abba-f757ae4da1fc,7270.16,debit,payment,AU00000,5453f0a3-083c-43c6-9086-adfe94df9918,,,2022-05-11T00:00:00Z,,https://au-api.basiq.io/users/11103cba-4a08-4397-84a5-22ac125ed2f6/transactions/d2a3fe85-f937-43e7-bf24-949356f562cf,https://au-api.basiq.io/users/11103cba-4a08-4397-84a5-22ac125ed2f6/accounts/0b107c33-e858-4bbd-abba-f757ae4da1fc,https://au-api.basiq.io/institutions/AU00000,,Electricity Distribution,263
transaction,c24ab81b-2867-49a4-ad18-99388a8cf72e,posted,Transfer Platnm Homeloan 346454,-3965.00,0b107c33-e858-4bbd-abba-f757ae4da1fc,7339.16,debit,transfer,AU00000,5453f0a3-083c-43c6-9086-adfe94df9918,,,2022-04-30T00:00:00Z,,https://au-api.basiq.io/users/11103cba-4a08-4397-84a5-22ac125ed2f6/transactions/c24ab81b-2867-49a4-ad18-99388a8cf72e,https://au-api.basiq.io/users/11103cba-4a08-4397-84a5-22ac125ed2f6/accounts/0b107c33-e858-4bbd-abba-f757ae4da1fc,https://au-api.basiq.io/institutions/AU00000,,,
transaction,d32c9c29-3132-4738-a649-aca2da02c69b,posted,TFR From Transaction to CC Acc 13,-9293.50,0b107c33-e858-4bbd-abba-f757ae4da1fc,11304.16,debit,transfer,AU00000,5453f0a3-083c-43c6-9086-adfe94df9918,,,2022-04-29T00:00:00Z,,https://au-api.basiq.io/users/11103cba-4a08-4397-84a5-22ac125ed2f6/transactions/d32c9c29-3132-4738-a649-aca2da02c69b,https://au-api.basiq.io/users/11103cba-4a08-4397-84a5-22ac125ed2f6/accounts/0b107c33-e858-4bbd-abba-f757ae4da1fc,https://au-api.basiq.io/institutions/AU00000,,,
transaction,100d6e9b-18cd-49fc-8cf7-7c790e7b57e8,posted,Payroll WFRMS 15439393,15985.00,0b107c33-e858-4bbd-abba-f757ae4da1fc,20597.66,credit,transfer,AU00000,5453f0a3-083c-43c6-9086-adfe94df9918,,,2022-04-29T00:00:00Z,,https://au-api.basiq.io/users/11103cba-4a08-4397-84a5-22ac125ed2f6/transactions/100d6e9b-18cd-49fc-8cf7-7c790e7b57e8,https://au-api.basiq.io/users/11103cba-4a08-4397-84a5-22ac125ed2f6/accounts/0b107c33-e858-4bbd-abba-f757ae4da1fc,https://au-api.basiq.io/institutions/AU00000,,,
transaction,5eb35e39-e5f0-4b44-8347-e39505962662,posted,Manly Maths Tutor Wages,201.00,0b107c33-e858-4bbd-abba-f757ae4da1fc,4612.66,credit,transfer,AU00000,5453f0a3-083c-43c6-9086-adfe94df9918,,,2022-04-18T00:00:00Z,,https://au-api.basiq.io/users/11103cba-4a08-4397-84a5-22ac125ed2f6/transactions/5eb35e39-e5f0-4b44-8347-e39505962662,https://au-api.basiq.io/users/11103cba-4a08-4397-84a5-22ac125ed2f6/accounts/0b107c33-e858-4bbd-abba-f757ae4da1fc,https://au-api.basiq.io/institutions/AU00000,,,
transaction,af960d6c-bf9d-4746-98e4-03aa54e9de0c,posted,Manly Maths Tutor Wages,201.00,0b107c33-e858-4bbd-abba-f757ae4da1fc,4411.66,credit,transfer,AU00000,5453f0a3-083c-43c6-9086-adfe94df9918,,,2022-04-14T00:00:00Z,,https://au-api.basiq.io/users/11103cba-4a08-4397-84a5-22ac125ed2f6/transactions/af960d6c-bf9d-4746-98e4-03aa54e9de0c,https://au-api.basiq.io/users/11103cba-4a08-4397-84a5-22ac125ed2f6/accounts/0b107c33-e858-4bbd-abba-f757ae4da1fc,https://au-api.basiq.io/institutions/AU00000,,,
transaction,8912aa5c-532b-45b7-8234-2e751e8f5907,posted,TFR Acc14000 TO 12389,-500.00,0b107c33-e858-4bbd-abba-f757ae4da1fc,4210.66,debit,transfer,AU00000,5453f0a3-083c-43c6-9086-adfe94df9918,,,2022-04-13T00:00:00Z,,https://au-api.basiq.io/users/11103cba-4a08-4397-84a5-22ac125ed2f6/transactions/8912aa5c-532b-45b7-8234-2e751e8f5907,https://au-api.basiq.io/users/11103cba-4a08-4397-84a5-22ac125ed2f6/accounts/0b107c33-e858-4bbd-abba-f757ae4da1fc,https://au-api.basiq.io/institutions/AU00000,,,
transaction,adfdfd4f-2a10-46a1-b65a-7f4ad45ac25f,posted,AGL RETAIL ENERGY LTD,-160.00,0b107c33-e858-4bbd-abba-f757ae4da1fc,4710.66,debit,payment,AU00000,5453f0a3-083c-43c6-9086-adfe94df9918,,,2022-04-11T00:00:00Z,,https://au-api.basiq.io/users/11103cba-4a08-4397-84a5-22ac125ed2f6/transactions/adfdfd4f-2a10-46a1-b65a-7f4ad45ac25f,https://au-api.basiq.io/users/11103cba-4a08-4397-84a5-22ac125ed2f6/accounts/0b107c33-e858-4bbd-abba-f757ae4da1fc,https://au-api.basiq.io/institutions/AU00000,,Electricity Distribution,263
transaction,df23acd0-b269-439c-b453-b2e06af236d1,posted,AGL RETAIL ENERGY LTD (GAS),-69.00,0b107c33-e858-4bbd-abba-f757ae4da1fc,4870.66,debit,payment,AU00000,5453f0a3-083c-43c6-9086-adfe94df9918,,,2022-04-11T00:00:00Z,,https://au-api.basiq.io/users/11103cba-4a08-4397-84a5-22ac125ed2f6/transactions/df23acd0-b269-439c-b453-b2e06af236d1,https://au-api.basiq.io/users/11103cba-4a08-4397-84a5-22ac125ed2f6/accounts/0b107c33-e858-4bbd-abba-f757ae4da1fc,https://au-api.basiq.io/institutions/AU00000,,Electricity Distribution,263
transaction,84771b03-8594-406b-94b9-b487bc36e9d5,posted,Wdl ATM WESTPAC IGA BALGOWLAH  BALGOWL        AU,-200.00,0b107c33-e858-4bbd-abba-f757ae4da1fc,4939.66,debit,cash-withdrawal,AU00000,5453f0a3-083c-43c6-9086-adfe94df9918,,,2022-04-07T00:00:00Z,,https://au-api.basiq.io/users/11103cba-4a08-4397-84a5-22ac125ed2f6/transactions/84771b03-8594-406b-94b9-b487bc36e9d5,https://au-api.basiq.io/users/11103cba-4a08-4397-84a5-22ac125ed2f6/accounts/0b107c33-e858-4bbd-abba-f757ae4da1fc,https://au-api.basiq.io/institutions/AU00000,,,
transaction,364be2dc-95d8-475b-aaf2-b6d25dc9a517,posted,Non Hooli ATM Withdrawal Fee,-2.50,0b107c33-e858-4bbd-abba-f757ae4da1fc,5139.66,debit,bank-fee,AU00000,5453f0a3-083c-43c6-9086-adfe94df9918,,,2022-04-07T00:00:00Z,,https://au-api.basiq.io/users/11103cba-4a08-4397-84a5-22ac125ed2f6/transactions/364be2dc-95d8-475b-aaf2-b6d25dc9a517,https://au-api.basiq.io/users/11103cba-4a08-4397-84a5-22ac125ed2f6/accounts/0b107c33-e858-4bbd-abba-f757ae4da1fc,https://au-api.basiq.io/institutions/AU00000,,,
transaction,8c2363fd-0608-4a12-b7b2-9804b5b32351,posted,Wdl ATM WESTPAC IGA BALGOWLAH  BALGOWL        AU,-200.00,0b107c33-e858-4bbd-abba-f757ae4da1fc,5142.16,debit,cash-withdrawal,AU00000,5453f0a3-083c-43c6-9086-adfe94df9918,,,2022-04-07T00:00:00Z,,https://au-api.basiq.io/users/11103cba-4a08-4397-84a5-22ac125ed2f6/transactions/8c2363fd-0608-4a12-b7b2-9804b5b32351,https://au-api.basiq.io/users/11103cba-4a08-4397-84a5-22ac125ed2f6/accounts/0b107c33-e858-4bbd-abba-f757ae4da1fc,https://au-api.basiq.io/institutions/AU00000,,,
transaction,614d0f7a-f6b3-4569-b1cc-799d43872843,posted,Non Hooli ATM Withdrawal Fee,-2.50,0b107c33-e858-4bbd-abba-f757ae4da1fc,5342.16,debit,bank-fee,AU00000,5453f0a3-083c-43c6-9086-adfe94df9918,,,2022-04-07T00:00:00Z,,https://au-api.basiq.io/users/11103cba-4a08-4397-84a5-22ac125ed2f6/transactions/614d0f7a-f6b3-4569-b1cc-799d43872843,https://au-api.basiq.io/users/11103cba-4a08-4397-84a5-22ac125ed2f6/accounts/0b107c33-e858-4bbd-abba-f757ae4da1fc,https://au-api.basiq.io/institutions/AU00000,,,
transaction,a2c170bd-82cc-4e1d-bad5-a3d132068345,posted,Wdl ATM WESTPAC IGA BALGOWLAH  BALGOWL        AU,-200.00,0b107c33-e858-4bbd-abba-f757ae4da1fc,5344.66,debit,cash-withdrawal,AU00000,5453f0a3-083c-43c6-9086-adfe94df9918,,,2022-04-07T00:00:00Z,,https://au-api.basiq.io/users/11103cba-4a08-4397-84a5-22ac125ed2f6/transactions/a2c170bd-82cc-4e1d-bad5-a3d132068345,https://au-api.basiq.io/users/11103cba-4a08-4397-84a5-22ac125ed2f6/accounts/0b107c33-e858-4bbd-abba-f757ae4da1fc,https://au-api.basiq.io/institutions/AU00000,,,
transaction,3339f84e-cc53-4669-9ba4-a1aee48b0477,posted,Non Hooli ATM Withdrawal Fee,-2.50,0b107c33-e858-4bbd-abba-f757ae4da1fc,5544.66,debit,bank-fee,AU00000,5453f0a3-083c-43c6-9086-adfe94df9918,,,2022-04-07T00:00:00Z,,https://au-api.basiq.io/users/11103cba-4a08-4397-84a5-22ac125ed2f6/transactions/3339f84e-cc53-4669-9ba4-a1aee48b0477,https://au-api.basiq.io/users/11103cba-4a08-4397-84a5-22ac125ed2f6/accounts/0b107c33-e858-4bbd-abba-f757ae4da1fc,https://au-api.basiq.io/institutions/AU00000,,,
transaction,a4228629-1096-45be-892d-b0984d5ff44a,posted,Wdl ATM WESTPAC IGA BALGOWLAH  BALGOWL        AU,-450.00,0b107c33-e858-4bbd-abba-f757ae4da1fc,5547.16,debit,cash-withdrawal,AU00000,5453f0a3-083c-43c6-9086-adfe94df9918,,,2022-04-04T00:00:00Z,,https://au-api.basiq.io/users/11103cba-4a08-4397-84a5-22ac125ed2f6/transactions/a4228629-1096-45be-892d-b0984d5ff44a,https://au-api.basiq.io/users/11103cba-4a08-4397-84a5-22ac125ed2f6/accounts/0b107c33-e858-4bbd-abba-f757ae4da1fc,https://au-api.basiq.io/institutions/AU00000,,,
transaction,e31cbe72-f8a1-49a5-bc10-3e70cf7e6270,posted,Non Hooli ATM Withdrawal Fee,-2.50,0b107c33-e858-4bbd-abba-f757ae4da1fc,5997.16,debit,bank-fee,AU00000,5453f0a3-083c-43c6-9086-adfe94df9918,,,2022-04-04T00:00:00Z,,https://au-api.basiq.io/users/11103cba-4a08-4397-84a5-22ac125ed2f6/transactions/e31cbe72-f8a1-49a5-bc10-3e70cf7e6270,https://au-api.basiq.io/users/11103cba-4a08-4397-84a5-22ac125ed2f6/accounts/0b107c33-e858-4bbd-abba-f757ae4da1fc,https://au-api.basiq.io/institutions/AU00000,,,
transaction,e4d937d7-a059-4409-8bae-7fde4d99bbb6,posted,Wdl ATM WESTPAC IGA BALGOWLAH  BALGOWL        AU,-300.00,0b107c33-e858-4bbd-abba-f757ae4da1fc,5999.66,debit,cash-withdrawal,AU00000,5453f0a3-083c-43c6-9086-adfe94df9918,,,2022-04-04T00:00:00Z,,https://au-api.basiq.io/users/11103cba-4a08-4397-84a5-22ac125ed2f6/transactions/e4d937d7-a059-4409-8bae-7fde4d99bbb6,https://au-api.basiq.io/users/11103cba-4a08-4397-84a5-22ac125ed2f6/accounts/0b107c33-e858-4bbd-abba-f757ae4da1fc,https://au-api.basiq.io/institutions/AU00000,,,
transaction,b0760801-91a8-460c-b04b-a0512306bc73,posted,Non Hooli ATM Withdrawal Fee,-2.50,0b107c33-e858-4bbd-abba-f757ae4da1fc,6299.66,debit,bank-fee,AU00000,5453f0a3-083c-43c6-9086-adfe94df9918,,,2022-04-04T00:00:00Z,,https://au-api.basiq.io/users/11103cba-4a08-4397-84a5-22ac125ed2f6/transactions/b0760801-91a8-460c-b04b-a0512306bc73,https://au-api.basiq.io/users/11103cba-4a08-4397-84a5-22ac125ed2f6/accounts/0b107c33-e858-4bbd-abba-f757ae4da1fc,https://au-api.basiq.io/institutions/AU00000,,,
transaction,9c147466-f1af-4bdc-ba2a-114dc80b3911,posted,Wdl ATM CBA ATM  BALGOWLAH A    NSW 210901   AUS,-200.00,0b107c33-e858-4bbd-abba-f757ae4da1fc,6302.16,debit,cash-withdrawal,AU00000,5453f0a3-083c-43c6-9086-adfe94df9918,,,2022-04-04T00:00:00Z,,https://au-api.basiq.io/users/11103cba-4a08-4397-84a5-22ac125ed2f6/transactions/9c147466-f1af-4bdc-ba2a-114dc80b3911,https://au-api.basiq.io/users/11103cba-4a08-4397-84a5-22ac125ed2f6/accounts/0b107c33-e858-4bbd-abba-f757ae4da1fc,https://au-api.basiq.io/institutions/AU00000,,,
transaction,3e8064a6-a6eb-4f9d-9508-8b41c223b4fc,posted,Transfer Platnm Homeloan 346454,3950.00,2df58481-c77a-40b1-8249-949cb3ea9670,-354783.25,credit,loan-repayment,AU00000,5453f0a3-083c-43c6-9086-adfe94df9918,,,2022-06-28T00:00:00Z,,https://au-api.basiq.io/users/11103cba-4a08-4397-84a5-22ac125ed2f6/transactions/3e8064a6-a6eb-4f9d-9508-8b41c223b4fc,https://au-api.basiq.io/users/11103cba-4a08-4397-84a5-22ac125ed2f6/accounts/2df58481-c77a-40b1-8249-949cb3ea9670,https://au-api.basiq.io/institutions/AU00000,,,
transaction,48559015-fe47-4c77-9fa9-040d91c6467c,posted,Mortgage Interest Payment 746833,-3661.50,2df58481-c77a-40b1-8249-949cb3ea9670,-358733.25,debit,loan-interest,AU00000,5453f0a3-083c-43c6-9086-adfe94df9918,,,2022-06-19T00:00:00Z,,https://au-api.basiq.io/users/11103cba-4a08-4397-84a5-22ac125ed2f6/transactions/48559015-fe47-4c77-9fa9-040d91c6467c,https://au-api.basiq.io/users/11103cba-4a08-4397-84a5-22ac125ed2f6/accounts/2df58481-c77a-40b1-8249-949cb3ea9670,https://au-api.basiq.io/institutions/AU00000,,,
transaction,e7a4faf2-4e74-41aa-a1f7-89fc32c83ae1,posted,Transfer Platnm Homeloan 346454,3957.50,2df58481-c77a-40b1-8249-949cb3ea9670,-355071.75,credit,loan-repayment,AU00000,5453f0a3-083c-43c6-9086-adfe94df9918,,,2022-05-31T00:00:00Z,,https://au-api.basiq.io/users/11103cba-4a08-4397-84a5-22ac125ed2f6/transactions/e7a4faf2-4e74-41aa-a1f7-89fc32c83ae1,https://au-api.basiq.io/users/11103cba-4a08-4397-84a5-22ac125ed2f6/accounts/2df58481-c77a-40b1-8249-949cb3ea9670,https://au-api.basiq.io/institutions/AU00000,,,
transaction,3a658461-f71f-4228-9ca0-ccccb900f61f,posted,Mortgage Interest Payment 746833,-3653.25,2df58481-c77a-40b1-8249-949cb3ea9670,-359029.25,debit,loan-interest,AU00000,5453f0a3-083c-43c6-9086-adfe94df9918,,,2022-05-19T00:00:00Z,,https://au-api.basiq.io/users/11103cba-4a08-4397-84a5-22ac125ed2f6/transactions/3a658461-f71f-4228-9ca0-ccccb900f61f,https://au-api.basiq.io/users/11103cba-4a08-4397-84a5-22ac125ed2f6/accounts/2df58481-c77a-40b1-8249-949cb3ea9670,https://au-api.basiq.io/institutions/AU00000,,,
transaction,a2999797-2d7f-4e65-8743-437203f9e650,posted,Transfer Platnm Homeloan 346454,3965.00,2df58481-c77a-40b1-8249-949cb3ea9670,-355376.00,credit,loan-repayment,AU00000,5453f0a3-083c-43c6-9086-adfe94df9918,,,2022-04-30T00:00:00Z,,https://au-api.basiq.io/users/11103cba-4a08-4397-84a5-22ac125ed2f6/transactions/a2999797-2d7f-4e65-8743-437203f9e650,https://au-api.basiq.io/users/11103cba-4a08-4397-84a5-22ac125ed2f6/accounts/2df58481-c77a-40b1-8249-949cb3ea9670,https://au-api.basiq.io/institutions/AU00000,,,
transaction,eddd173a-a30a-4699-a2d3-5a7d2898b418,posted,Mortgage Interest Payment 746833,-3645.75,2df58481-c77a-40b1-8249-949cb3ea9670,-359341.00,debit,loan-interest,AU00000,5453f0a3-083c-43c6-9086-adfe94df9918,,,2022-04-18T00:00:00Z,,https://au-api.basiq.io/users/11103cba-4a08-4397-84a5-22ac125ed2f6/transactions/eddd173a-a30a-4699-a2d3-5a7d2898b418,https://au-api.basiq.io/users/11103cba-4a08-4397-84a5-22ac125ed2f6/accounts/2df58481-c77a-40b1-8249-949cb3ea9670,https://au-api.basiq.io/institutions/AU00000,,,
transaction,ecb39838-f2ff-47f0-9d26-2c8c470e9b22,posted,Only About Children Seaforth 1244301,-839.00,49544383-c19c-4c97-b8d1-5322d0faa6af,-2550.96,debit,payment,AU00000,5453f0a3-083c-43c6-9086-adfe94df9918,,,2022-06-30T00:00:00Z,,https://au-api.basiq.io/users/11103cba-4a08-4397-84a5-22ac125ed2f6/transactions/ecb39838-f2ff-47f0-9d26-2c8c470e9b22,https://au-api.basiq.io/users/11103cba-4a08-4397-84a5-22ac125ed2f6/accounts/49544383-c19c-4c97-b8d1-5322d0faa6af,https://au-api.basiq.io/institutions/AU00000,,Other Health Care Services,859
transaction,00454e4a-8077-4762-99d4-934a6469db60,posted,WHOLISTIC MEDICAL CE NTRSURRY HILLS,-223.00,49544383-c19c-4c97-b8d1-5322d0faa6af,-1711.96,debit,payment,AU00000,5453f0a3-083c-43c6-9086-adfe94df9918,,,2022-06-30T00:00:00Z,,https://au-api.basiq.io/users/11103cba-4a08-4397-84a5-22ac125ed2f6/transactions/00454e4a-8077-4762-99d4-934a6469db60,https://au-api.basiq.io/users/11103cba-4a08-4397-84a5-22ac125ed2f6/accounts/49544383-c19c-4c97-b8d1-5322d0faa6af,https://au-api.basiq.io/institutions/AU00000,,Other Health Care Services,859
transaction,5e2d96e8-87ee-47a2-be61-1ed4df820763,posted,WOOLWORTHS 1063 FRENCHS FRST NSW AU,-201.00,49544383-c19c-4c97-b8d1-5322d0faa6af,-1488.96,debit,payment,AU00000,5453f0a3-083c-43c6-9086-adfe94df9918,,,2022-06-29T00:00:00Z,,https://au-api.basiq.io/users/11103cba-4a08-4397-84a5-22ac125ed2f6/transactions/5e2d96e8-87ee-47a2-be61-1ed4df820763,https://au-api.basiq.io/users/11103cba-4a08-4397-84a5-22ac125ed2f6/accounts/49544383-c19c-4c97-b8d1-5322d0faa6af,https://au-api.basiq.io/institutions/AU00000,,Supermarket and Grocery Stores,411
transaction,7a3ccb95-46ac-47a3-9736-14a0a2afed07,posted,WOOLWORTHS 1262 BELR,-19.56,49544383-c19c-4c97-b8d1-5322d0faa6af,-1287.96,debit,payment,AU00000,5453f0a3-083c-43c6-9086-adfe94df9918,,,2022-06-28T00:00:00Z,,https://au-api.basiq.io/users/11103cba-4a08-4397-84a5-22ac125ed2f6/transactions/7a3ccb95-46ac-47a3-9736-14a0a2afed07,https://au-api.basiq.io/users/11103cba-4a08-4397-84a5-22ac125ed2f6/accounts/49544383-c19c-4c97-b8d1-5322d0faa6af,https://au-api.basiq.io/institutions/AU00000,,Supermarket and Grocery Stores,411
transaction,fef5ee5c-9659-4d81-ac62-2ebb3de1860a,posted,TASTE BAGUETTE GLNRS BELR,-13.50,49544383-c19c-4c97-b8d1-5322d0faa6af,-1268.40,debit,payment,AU00000,5453f0a3-083c-43c6-9086-adfe94df9918,,,2022-06-28T00:00:00Z,,https://au-api.basiq.io/users/11103cba-4a08-4397-84a5-22ac125ed2f6/transactions/fef5ee5c-9659-4d81-ac62-2ebb3de1860a,https://au-api.basiq.io/users/11103cba-4a08-4397-84a5-22ac125ed2f6/accounts/49544383-c19c-4c97-b8d1-5322d0faa6af,https://au-api.basiq.io/institutions/AU00000,,"Cafes, Restaurants and Takeaway Food Services",451
transaction,02622d50-cacd-4ed3-930c-5c59c5cd00e2,posted,WOOLWORTHS 1262 BELR,-320.88,49544383-c19c-4c97-b8d1-5322d0faa6af,-1254.90,debit,payment,AU00000,5453f0a3-083c-43c6-9086-adfe94df9918,,,2022-06-27T00:00:00Z,,https://au-api.basiq.io/users/11103cba-4a08-4397-84a5-22ac125ed2f6/transactions/02622d50-cacd-4ed3-930c-5c59c5cd00e2,https://au-api.basiq.io/users/11103cba-4a08-4397-84a5-22ac125ed2f6/accounts/49544383-c19c-4c97-b8d1-5322d0faa6af,https://au-api.basiq.io/institutions/AU00000,,Supermarket and Grocery Stores,411
transaction,8ae30bb5-cf0e-4ddb-bcb2-f7c44e586ea9,posted,TRANSPORT FOR NSW-OPAL CHIP,-41.00,49544383-c19c-4c97-b8d1-5322d0faa6af,-934.02,debit,payment,AU00000,5453f0a3-083c-43c6-9086-adfe94df9918,,,2022-06-27T00:00:00Z,,https://au-api.basiq.io/users/11103cba-4a08-4397-84a5-22ac125ed2f6/transactions/8ae30bb5-cf0e-4ddb-bcb2-f7c44e586ea9,https://au-api.basiq.io/users/11103cba-4a08-4397-84a5-22ac125ed2f6/accounts/49544383-c19c-4c97-b8d1-5322d0faa6af,https://au-api.basiq.io/institutions/AU00000,,Pipeline and Other Transport,502
transaction,36558603-86d8-4d7b-aaf2-a6cb53b34e31,posted,TFR From Transaction to CC Acc 13,9308.50,49544383-c19c-4c97-b8d1-5322d0faa6af,-893.02,credit,transfer,AU00000,5453f0a3-083c-43c6-9086-adfe94df9918,,,2022-06-27T00:00:00Z,,https://au-api.basiq.io/users/11103cba-4a08-4397-84a5-22ac125ed2f6/transactions/36558603-86d8-4d7b-aaf2-a6cb53b34e31,https://au-api.basiq.io/users/11103cba-4a08-4397-84a5-22ac125ed2f6/accounts/49544383-c19c-4c97-b8d1-5322d0faa6af,https://au-api.basiq.io/institutions/AU00000,,,
transaction,294618d1-1b30-4ed9-8284-c356da43a5be,posted,WOOLWORTHS 1262 BELR,-14.45,49544383-c19c-4c97-b8d1-5322d0faa6af,-10201.52,debit,payment,AU00000,5453f0a3-083c-43c6-9086-adfe94df9918,,,2022-06-27T00:00:00Z,,https://au-api.basiq.io/users/11103cba-4a08-4397-84a5-22ac125ed2f6/transactions/294618d1-1b30-4ed9-8284-c356da43a5be,https://au-api.basiq.io/users/11103cba-4a08-4397-84a5-22ac125ed2f6/accounts/49544383-c19c-4c97-b8d1-5322d0faa6af,https://au-api.basiq.io/institutions/AU00000,,Supermarket and Grocery Stores,411
transaction,c58f58cc-3208-4641-99b4-fd61784e9fcd,posted,OFARM ORGANIC GROCER BROOKVALE AU,-81.89,49544383-c19c-4c97-b8d1-5322d0faa6af,-10187.07,debit,payment,AU00000,5453f0a3-083c-43c6-9086-adfe94df9918,,,2022-06-27T00:00:00Z,,https://au-api.basiq.io/users/11103cba-4a08-4397-84a5-22ac125ed2f6/transactions/c58f58cc-3208-4641-99b4-fd61784e9fcd,https://au-api.basiq.io/users/11103cba-4a08-4397-84a5-22ac125ed2f6/accounts/49544383-c19c-4c97-b8d1-5322d0faa6af,https://au-api.basiq.io/institutions/AU00000,,Supermarket and Grocery Stores,411
transaction,99fc13d5-e269-48b0-b23d-4a6195646fde,posted,WW PETROL 1789 GLENROSE NSW AU,-60.42,49544383-c19c-4c97-b8d1-5322d0faa6af,-10105.18,debit,payment,AU00000,5453f0a3-083c-43c6-9086-adfe94df9918,,,2022-06-27T00:00:00Z,,https://au-api.basiq.io/users/11103cba-4a08-4397-84a5-22ac125ed2f6/transactions/99fc13d5-e269-48b0-b23d-4a6195646fde,https://au-api.basiq.io/users/11103cba-4a08-4397-84a5-22ac125ed2f6/accounts/49544383-c19c-4c97-b8d1-5322d0faa6af,https://au-api.basiq.io/institutions/AU00000,,Fuel Retailing,400
transaction,60d8e7b1-8a0f-4899-bf29-537a6c52f9fe,posted,SQ *FRATELLI POLITO PR Warr,-36.00,49544383-c19c-4c97-b8d1-5322d0faa6af,-10044.76,debit,payment,AU00000,5453f0a3-083c-43c6-9086-adfe94df9918,,,2022-06-26T00:00:00Z,,https://au-api.basiq.io/users/11103cba-4a08-4397-84a5-22ac125ed2f6/transactions/60d8e7b1-8a0f-4899-bf29-537a6c52f9fe,https://au-api.basiq.io/users/11103cba-4a08-4397-84a5-22ac125ed2f6/accounts/49544383-c19c-4c97-b8d1-5322d0faa6af,https://au-api.basiq.io/institutions/AU00000,,Specialised Food Retailing,412
transaction,a3b5c067-a20b-4822-8fa8-26ec55620b8a,posted,FREE RANGE BUTCHERS MONA VALE AU,-57.09,49544383-c19c-4c97-b8d1-5322d0faa6af,-10008.76,debit,payment,AU00000,5453f0a3-083c-43c6-9086-adfe94df9918,,,2022-06-25T00:00:00Z,,https://au-api.basiq.io/users/11103cba-4a08-4397-84a5-22ac125ed2f6/transactions/a3b5c067-a20b-4822-8fa8-26ec55620b8a,https://au-api.basiq.io/users/11103cba-4a08-4397-84a5-22ac125ed2f6/accounts/49544383-c19c-4c97-b8d1-5322d0faa6af,https://au-api.basiq.io/institutions/AU00000,,Specialised Food Retailing,412
transaction,72cb9c62-5e4f-4a28-aa71-bf36a0cb3d95,posted,Cash Wdr  41   SYNDEY       AU,-204.50,49544383-c19c-4c97-b8d1-5322d0faa6af,-9951.67,debit,cash-withdrawal,AU00000,5453f0a3-083c-43c6-9086-adfe94df9918,,,2022-06-25T00:00:00Z,,https://au-api.basiq.io/users/11103cba-4a08-4397-84a5-22ac125ed2f6/transactions/72cb9c62-5e4f-4a28-aa71-bf36a0cb3d95,https://au-api.basiq.io/users/11103cba-4a08-4397-84a5-22ac125ed2f6/accounts/49544383-c19c-4c97-b8d1-5322d0faa6af,https://au-api.basiq.io/institutions/AU00000,,,
transaction,44f77c9e-5c9e-4b71-8295-896c9e2740c4,posted,NAILCARE BEAUTY BROOKVALE AU,-41.80,49544383-c19c-4c97-b8d1-5322d0faa6af,-9747.17,debit,payment,AU00000,5453f0a3-083c-43c6-9086-adfe94df9918,,,2022-06-25T00:00:00Z,,https://au-api.basiq.io/users/11103cba-4a08-4397-84a5-22ac125ed2f6/transactions/44f77c9e-5c9e-4b71-8295-896c9e2740c4,https://au-api.basiq.io/users/11103cba-4a08-4397-84a5-22ac125ed2f6/accounts/49544383-c19c-4c97-b8d1-5322d0faa6af,https://au-api.basiq.io/institutions/AU00000,,Personal Care Services,951
transaction,bfc859dd-c13a-4599-a476-3f4d09b8fc1d,posted,WW PETROL 1789 GLENROSE NSW AU,-106.41,49544383-c19c-4c97-b8d1-5322d0faa6af,-9705.37,debit,payment,AU00000,5453f0a3-083c-43c6-9086-adfe94df9918,,,2022-06-24T00:00:00Z,,https://au-api.basiq.io/users/11103cba-4a08-4397-84a5-22ac125ed2f6/transactions/bfc859dd-c13a-4599-a476-3f4d09b8fc1d,https://au-api.basiq.io/users/11103cba-4a08-4397-84a5-22ac125ed2f6/accounts/49544383-c19c-4c97-b8d1-5322d0faa6af,https://au-api.basiq.io/institutions/AU00000,,Fuel Retailing,400
transaction,760a456d-d17e-4091-8fbc-d04774bc7570,posted,ECLIPSE ORANGICS RICHMOND AU,-11.00,49544383-c19c-4c97-b8d1-5322d0faa6af,-9598.96,debit,payment,AU00000,5453f0a3-083c-43c6-9086-adfe94df9918,,,2022-06-23T00:00:00Z,,https://au-api.basiq.io/users/11103cba-4a08-4397-84a5-22ac125ed2f6/transactions/760a456d-d17e-4091-8fbc-d04774bc7570,https://au-api.basiq.io/users/11103cba-4a08-4397-84a5-22ac125ed2f6/accounts/49544383-c19c-4c97-b8d1-5322d0faa6af,https://au-api.basiq.io/institutions/AU00000,,Pharmaceutical and Other Store-Based Retailing,427
transaction,ce609f12-128f-4b83-b02b-f37cccc3d569,posted,ABC SHOP MAIL ORDER CENTRARTA,-51.48,49544383-c19c-4c97-b8d1-5322d0faa6af,-9587.96,debit,payment,AU00000,5453f0a3-083c-43c6-9086-adfe94df9918,,,2022-06-23T00:00:00Z,,https://au-api.basiq.io/users/11103cba-4a08-4397-84a5-22ac125ed2f6/transactions/ce609f12-128f-4b83-b02b-f37cccc3d569,https://au-api.basiq.io/users/11103cba-4a08-4397-84a5-22ac125ed2f6/accounts/49544383-c19c-4c97-b8d1-5322d0faa6af,https://au-api.basiq.io/institutions/AU00000,,Retail Commission-Based Buying and/or Selling,432
transaction,074e5f76-902e-488f-a73f-3d12a50043b9,posted,LL*Etihad G 1001204695 Swit,-13.15,49544383-c19c-4c97-b8d1-5322d0faa6af,-9536.48,debit,payment,AU00000,5453f0a3-083c-43c6-9086-adfe94df9918,,,2022-06-23T00:00:00Z,,https://au-api.basiq.io/users/11103cba-4a08-4397-84a5-22ac125ed2f6/transactions/074e5f76-902e-488f-a73f-3d12a50043b9,https://au-api.basiq.io/users/11103cba-4a08-4397-84a5-22ac125ed2f6/accounts/49544383-c19c-4c97-b8d1-5322d0faa6af,https://au-api.basiq.io/institutions/AU00000,,Unknown,0
transaction,82606268-c309-49de-b730-9c3cf2d18609,posted,ALDI STORES FRENCHS FORESNSWAU,-188.95,49544383-c19c-4c97-b8d1-5322d0faa6af,-9523.33,debit,payment,AU00000,5453f0a3-083c-43c6-9086-adfe94df9918,,,2022-06-21T00:00:00Z,,https://au-api.basiq.io/users/11103cba-4a08-4397-84a5-22ac125ed2f6/transactions/82606268-c309-49de-b730-9c3cf2d18609,https://au-api.basiq.io/users/11103cba-4a08-4397-84a5-22ac125ed2f6/accounts/49544383-c19c-4c97-b8d1-5322d0faa6af,https://au-api.basiq.io/institutions/AU00000,,Supermarket and Grocery Stores,411
transaction,251a8773-7027-40e5-ae9c-d0f7f5d8a9d1,posted,ALDI STORES BROOKVALE NSWAU,-26.10,49544383-c19c-4c97-b8d1-5322d0faa6af,-9334.38,debit,payment,AU00000,5453f0a3-083c-43c6-9086-adfe94df9918,,,2022-06-21T00:00:00Z,,https://au-api.basiq.io/users/11103cba-4a08-4397-84a5-22ac125ed2f6/transactions/251a8773-7027-40e5-ae9c-d0f7f5d8a9d1,https://au-api.basiq.io/users/11103cba-4a08-4397-84a5-22ac125ed2f6/accounts/49544383-c19c-4c97-b8d1-5322d0faa6af,https://au-api.basiq.io/institutions/AU00000,,Supermarket and Grocery Stores,411
transaction,f2bd4321-7b8b-487f-8ac2-4492a576a561,posted,SUNBURN CO PTY LTD - MANLY AU,-160.95,49544383-c19c-4c97-b8d1-5322d0faa6af,-9308.28,debit,payment,AU00000,5453f0a3-083c-43c6-9086-adfe94df9918,,,2022-06-21T00:00:00Z,,https://au-api.basiq.io/users/11103cba-4a08-4397-84a5-22ac125ed2f6/transactions/f2bd4321-7b8b-487f-8ac2-4492a576a561,https://au-api.basiq.io/users/11103cba-4a08-4397-84a5-22ac125ed2f6/accounts/49544383-c19c-4c97-b8d1-5322d0faa6af,https://au-api.basiq.io/institutions/AU00000,,"Clothing, Footwear and Personal Accessory Retailing",425
transaction,8881a49d-6f79-48b0-89e4-978214e55de2,posted,NTH BEACHES CNL- SOU TH MANLY AU,-47.00,49544383-c19c-4c97-b8d1-5322d0faa6af,-9147.33,debit,payment,AU00000,5453f0a3-083c-43c6-9086-adfe94df9918,,,2022-06-21T00:00:00Z,,https://au-api.basiq.io/users/11103cba-4a08-4397-84a5-22ac125ed2f6/transactions/8881a49d-6f79-48b0-89e4-978214e55de2,https://au-api.basiq.io/users/11103cba-4a08-4397-84a5-22ac125ed2f6/accounts/49544383-c19c-4c97-b8d1-5322d0faa6af,https://au-api.basiq.io/institutions/AU00000,,Regulatory Services,772
transaction,dfeaaeb2-497f-4f6d-9a03-e09d1333b55f,posted,OFARM ORGANIC GROCER MANLY AU,-66.25,49544383-c19c-4c97-b8d1-5322d0faa6af,-9100.33,debit,payment,AU00000,5453f0a3-083c-43c6-9086-adfe94df9918,,,2022-06-21T00:00:00Z,,https://au-api.basiq.io/users/11103cba-4a08-4397-84a5-22ac125ed2f6/transactions/dfeaaeb2-497f-4f6d-9a03-e09d1333b55f,https://au-api.basiq.io/users/11103cba-4a08-4397-84a5-22ac125ed2f6/accounts/49544383-c19c-4c97-b8d1-5322d0faa6af,https://au-api.basiq.io/institutions/AU00000,,Supermarket and Grocery Stores,411
transaction,4e552fc6-70db-43b7-a873-0d45d1f41eda,posted,Cash Wdr  NSW 219701   AUS,-103.00,49544383-c19c-4c97-b8d1-5322d0faa6af,-9034.08,debit,cash-withdrawal,AU00000,5453f0a3-083c-43c6-9086-adfe94df9918,,,2022-06-20T00:00:00Z,,https://au-api.basiq.io/users/11103cba-4a08-4397-84a5-22ac125ed2f6/transactions/4e552fc6-70db-43b7-a873-0d45d1f41eda,https://au-api.basiq.io/users/11103cba-4a08-4397-84a5-22ac125ed2f6/accounts/49544383-c19c-4c97-b8d1-5322d0faa6af,https://au-api.basiq.io/institutions/AU00000,,,
transaction,6ba77b96-a41f-4393-8130-2145cf8e87d1,posted,HUMPHREYS NEWSAGENCY MANLY NSWAU,-14.99,49544383-c19c-4c97-b8d1-5322d0faa6af,-8931.08,debit,payment,AU00000,5453f0a3-083c-43c6-9086-adfe94df9918,,,2022-06-20T00:00:00Z,,https://au-api.basiq.io/users/11103cba-4a08-4397-84a5-22ac125ed2f6/transactions/6ba77b96-a41f-4393-8130-2145cf8e87d1,https://au-api.basiq.io/users/11103cba-4a08-4397-84a5-22ac125ed2f6/accounts/49544383-c19c-4c97-b8d1-5322d0faa6af,https://au-api.basiq.io/institutions/AU00000,,Recreational Goods Retailing,424
transaction,242e4179-0128-42b0-8b1b-7ace66d2ad9e,posted,WOOLWORTHS 1282 WRINGAH MALL NSW AU,-87.17,49544383-c19c-4c97-b8d1-5322d0faa6af,-8916.09,debit,payment,AU00000,5453f0a3-083c-43c6-9086-adfe94df9918,,,2022-06-20T00:00:00Z,,https://au-api.basiq.io/users/11103cba-4a08-4397-84a5-22ac125ed2f6/transactions/242e4179-0128-42b0-8b1b-7ace66d2ad9e,https://au-api.basiq.io/users/11103cba-4a08-4397-84a5-22ac125ed2f6/accounts/49544383-c19c-4c97-b8d1-5322d0faa6af,https://au-api.basiq.io/institutions/AU00000,,Supermarket and Grocery Stores,411
transaction,0a2bfd04-9b2d-4413-a233-e5f6f1730dcc,posted,BIG W 0145 WARINGAH MAL NSW AU,-346.00,49544383-c19c-4c97-b8d1-5322d0faa6af,-8828.92,debit,payment,AU00000,5453f0a3-083c-43c6-9086-adfe94df9918,,,2022-06-20T00:00:00Z,,https://au-api.basiq.io/users/11103cba-4a08-4397-84a5-22ac125ed2f6/transactions/0a2bfd04-9b2d-4413-a233-e5f6f1730dcc,https://au-api.basiq.io/users/11103cba-4a08-4397-84a5-22ac125ed2f6/accounts/49544383-c19c-4c97-b8d1-5322d0faa6af,https://au-api.basiq.io/institutions/AU00000,,Department Stores,426
transaction,241c8f34-22f8-49fc-a312-77915a88a9ad,posted,Australian Sailing St L,-146.00,49544383-c19c-4c97-b8d1-5322d0faa6af,-8482.92,debit,payment,AU00000,5453f0a3-083c-43c6-9086-adfe94df9918,,,2022-06-19T00:00:00Z,,https://au-api.basiq.io/users/11103cba-4a08-4397-84a5-22ac125ed2f6/transactions/241c8f34-22f8-49fc-a312-77915a88a9ad,https://au-api.basiq.io/users/11103cba-4a08-4397-84a5-22ac125ed2f6/accounts/49544383-c19c-4c97-b8d1-5322d0faa6af,https://au-api.basiq.io/institutions/AU00000,,Recreational Goods Retailing,424
transaction,58334837-9190-4440-b759-089a01e5a736,posted,COLLAROY AIRPORT TRA COLL,-55.00,49544383-c19c-4c97-b8d1-5322d0faa6af,-8336.92,debit,payment,AU00000,5453f0a3-083c-43c6-9086-adfe94df9918,,,2022-06-19T00:00:00Z,,https://au-api.basiq.io/users/11103cba-4a08-4397-84a5-22ac125ed2f6/transactions/58334837-9190-4440-b759-089a01e5a736,https://au-api.basiq.io/users/11103cba-4a08-4397-84a5-22ac125ed2f6/accounts/49544383-c19c-4c97-b8d1-5322d0faa6af,https://au-api.basiq.io/institutions/AU00000,,Airport Operations and Other Air Transport Support Services,522
transaction,83104bfa-d057-4c9e-969a-0a19b42448bc,posted,NORTHERN BEACHES COUNC DEE,-9.00,49544383-c19c-4c97-b8d1-5322d0faa6af,-8281.92,debit,payment,AU00000,5453f0a3-083c-43c6-9086-adfe94df9918,,,2022-06-19T00:00:00Z,,https://au-api.basiq.io/users/11103cba-4a08-4397-84a5-22ac125ed2f6/transactions/83104bfa-d057-4c9e-969a-0a19b42448bc,https://au-api.basiq.io/users/11103cba-4a08-4397-84a5-22ac125ed2f6/accounts/49544383-c19c-4c97-b8d1-5322d0faa6af,https://au-api.basiq.io/institutions/AU00000,,Local Government Administration,753
transaction,7bc33be5-fdfa-4f1b-9480-22bfb10f91c6,posted,WOOLWORTHS 1282 WRINGAH MALL NSW AU,-18.00,49544383-c19c-4c97-b8d1-5322d0faa6af,-8272.92,debit,payment,AU00000,5453f0a3-083c-43c6-9086-adfe94df9918,,,2022-06-19T00:00:00Z,,https://au-api.basiq.io/users/11103cba-4a08-4397-84a5-22ac125ed2f6/transactions/7bc33be5-fdfa-4f1b-9480-22bfb10f91c6,https://au-api.basiq.io/users/11103cba-4a08-4397-84a5-22ac125ed2f6/accounts/49544383-c19c-4c97-b8d1-5322d0faa6af,https://au-api.basiq.io/institutions/AU00000,,Supermarket and Grocery Stores,411
transaction,3709410f-b962-42ca-9984-81bb723bbe2a,posted,BLOCH BROOKVALE AU,-32.96,49544383-c19c-4c97-b8d1-5322d0faa6af,-8254.92,debit,payment,AU00000,5453f0a3-083c-43c6-9086-adfe94df9918,,,2022-06-19T00:00:00Z,,https://au-api.basiq.io/users/11103cba-4a08-4397-84a5-22ac125ed2f6/transactions/3709410f-b962-42ca-9984-81bb723bbe2a,https://au-api.basiq.io/users/11103cba-4a08-4397-84a5-22ac125ed2f6/accounts/49544383-c19c-4c97-b8d1-5322d0faa6af,https://au-api.basiq.io/institutions/AU00000,,"Clothing, Footwear and Personal Accessory Retailing",425
transaction,da2ccab0-2235-4f58-8407-855b47001e4d,posted,TARGET 5078 BROOKVALE AU,-11.99,49544383-c19c-4c97-b8d1-5322d0faa6af,-8221.96,debit,payment,AU00000,5453f0a3-083c-43c6-9086-adfe94df9918,,,2022-06-18T00:00:00Z,,https://au-api.basiq.io/users/11103cba-4a08-4397-84a5-22ac125ed2f6/transactions/da2ccab0-2235-4f58-8407-855b47001e4d,https://au-api.basiq.io/users/11103cba-4a08-4397-84a5-22ac125ed2f6/accounts/49544383-c19c-4c97-b8d1-5322d0faa6af,https://au-api.basiq.io/institutions/AU00000,,Department Stores,426
transaction,782630c9-a567-4f47-8a54-530a4b8a0492,posted,DYMOCKS BROOKVALE BROOKVALE AU,-16.99,49544383-c19c-4c97-b8d1-5322d0faa6af,-8209.97,debit,payment,AU00000,5453f0a3-083c-43c6-9086-adfe94df9918,,,2022-06-18T00:00:00Z,,https://au-api.basiq.io/users/11103cba-4a08-4397-84a5-22ac125ed2f6/transactions/782630c9-a567-4f47-8a54-530a4b8a0492,https://au-api.basiq.io/users/11103cba-4a08-4397-84a5-22ac125ed2f6/accounts/49544383-c19c-4c97-b8d1-5322d0faa6af,https://au-api.basiq.io/institutions/AU00000,,Recreational Goods Retailing,424
transaction,9113b42e-fefa-4143-8ab8-dda24967bedd,posted,BUNNINGS 551000 WARRINGAH MALAU,-10.46,49544383-c19c-4c97-b8d1-5322d0faa6af,-8192.98,debit,payment,AU00000,5453f0a3-083c-43c6-9086-adfe94df9918,,,2022-06-18T00:00:00Z,,https://au-api.basiq.io/users/11103cba-4a08-4397-84a5-22ac125ed2f6/transactions/9113b42e-fefa-4143-8ab8-dda24967bedd,https://au-api.basiq.io/users/11103cba-4a08-4397-84a5-22ac125ed2f6/accounts/49544383-c19c-4c97-b8d1-5322d0faa6af,https://au-api.basiq.io/institutions/AU00000,,"Hardware, Building and Garden Supplies Retailing",423
transaction,5a6392d5-d42b-4210-8d24-ea97c7928d36,posted,REFUND  WARRINGAH MALAU,66.80,49544383-c19c-4c97-b8d1-5322d0faa6af,-8182.52,credit,refund,AU00000,5453f0a3-083c-43c6-9086-adfe94df9918,,,2022-06-18T00:00:00Z,,https://au-api.basiq.io/users/11103cba-4a08-4397-84a5-22ac125ed2f6/transactions/5a6392d5-d42b-4210-8d24-ea97c7928d36,https://au-api.basiq.io/users/11103cba-4a08-4397-84a5-22ac125ed2f6/accounts/49544383-c19c-4c97-b8d1-5322d0faa6af,https://au-api.basiq.io/institutions/AU00000,,,
transaction,3d3ba8dd-cc08-4d5e-9a3c-ed6b8bebb7ea,posted,WOOLWORTHS 1262 BELR,-78.89,49544383-c19c-4c97-b8d1-5322d0faa6af,-8249.32,debit,payment,AU00000,5453f0a3-083c-43c6-9086-adfe94df9918,,,2022-06-18T00:00:00Z,,https://au-api.basiq.io/users/11103cba-4a08-4397-84a5-22ac125ed2f6/transactions/3d3ba8dd-cc08-4d5e-9a3c-ed6b8bebb7ea,https://au-api.basiq.io/users/11103cba-4a08-4397-84a5-22ac125ed2f6/accounts/49544383-c19c-4c97-b8d1-5322d0faa6af,https://au-api.basiq.io/institutions/AU00000,,Supermarket and Grocery Stores,411
transaction,41ac1863-4d66-4da8-9d1d-11217fd73fe5,posted,WOOLWORTHS 1262 BELR,-41.99,49544383-c19c-4c97-b8d1-5322d0faa6af,-8170.43,debit,payment,AU00000,5453f0a3-083c-43c6-9086-adfe94df9918,,,2022-06-17T00:00:00Z,,https://au-api.basiq.io/users/11103cba-4a08-4397-84a5-22ac125ed2f6/transactions/41ac1863-4d66-4da8-9d1d-11217fd73fe5,https://au-api.basiq.io/users/11103cba-4a08-4397-84a5-22ac125ed2f6/accounts/49544383-c19c-4c97-b8d1-5322d0faa6af,https://au-api.basiq.io/institutions/AU00000,,Supermarket and Grocery Stores,411
transaction,0b4d94e3-e7a2-4929-9bc3-57fc87db610b,posted,Mail Redirection Serv MELB,-47.35,49544383-c19c-4c97-b8d1-5322d0faa6af,-8128.44,debit,payment,AU00000,5453f0a3-083c-43c6-9086-adfe94df9918,,,2022-06-16T00:00:00Z,,https://au-api.basiq.io/users/11103cba-4a08-4397-84a5-22ac125ed2f6/transactions/0b4d94e3-e7a2-4929-9bc3-57fc87db610b,https://au-api.basiq.io/users/11103cba-4a08-4397-84a5-22ac125ed2f6/accounts/49544383-c19c-4c97-b8d1-5322d0faa6af,https://au-api.basiq.io/institutions/AU00000,,Postal and Courier Pick-up and Delivery Services,510
transaction,c152dd28-6cef-412d-b547-8e072f590d4f,posted,METRO PETROLEUM FR FORESTVILLE AU,-101.58,49544383-c19c-4c97-b8d1-5322d0faa6af,-8081.09,debit,payment,AU00000,5453f0a3-083c-43c6-9086-adfe94df9918,,,2022-06-16T00:00:00Z,,https://au-api.basiq.io/users/11103cba-4a08-4397-84a5-22ac125ed2f6/transactions/c152dd28-6cef-412d-b547-8e072f590d4f,https://au-api.basiq.io/users/11103cba-4a08-4397-84a5-22ac125ed2f6/accounts/49544383-c19c-4c97-b8d1-5322d0faa6af,https://au-api.basiq.io/institutions/AU00000,,Fuel Retailing,400
transaction,219fcd10-2837-4a64-9b23-7ff1308cdab2,posted,BAR DIA SERVICES DY DEE WHY AU,-212.00,49544383-c19c-4c97-b8d1-5322d0faa6af,-7979.51,debit,payment,AU00000,5453f0a3-083c-43c6-9086-adfe94df9918,,,2022-06-16T00:00:00Z,,https://au-api.basiq.io/users/11103cba-4a08-4397-84a5-22ac125ed2f6/transactions/219fcd10-2837-4a64-9b23-7ff1308cdab2,https://au-api.basiq.io/users/11103cba-4a08-4397-84a5-22ac125ed2f6/accounts/49544383-c19c-4c97-b8d1-5322d0faa6af,https://au-api.basiq.io/institutions/AU00000,,"Cafes, Restaurants and Takeaway Food Services",451
transaction,190f9e89-fac7-422a-9a59-6cb4dd5289d7,posted,WOOLWORTHS 1063 FRENCHS FRST NSW AU,-107.30,49544383-c19c-4c97-b8d1-5322d0faa6af,-7767.51,debit,payment,AU00000,5453f0a3-083c-43c6-9086-adfe94df9918,,,2022-06-15T00:00:00Z,,https://au-api.basiq.io/users/11103cba-4a08-4397-84a5-22ac125ed2f6/transactions/190f9e89-fac7-422a-9a59-6cb4dd5289d7,https://au-api.basiq.io/users/11103cba-4a08-4397-84a5-22ac125ed2f6/accounts/49544383-c19c-4c97-b8d1-5322d0faa6af,https://au-api.basiq.io/institutions/AU00000,,Supermarket and Grocery Stores,411
transaction,293d081c-303a-409e-a501-bdd28809b4b2,posted,OFARM ORGANIC GROCER MANLY AU,-46.10,49544383-c19c-4c97-b8d1-5322d0faa6af,-7660.21,debit,payment,AU00000,5453f0a3-083c-43c6-9086-adfe94df9918,,,2022-06-15T00:00:00Z,,https://au-api.basiq.io/users/11103cba-4a08-4397-84a5-22ac125ed2f6/transactions/293d081c-303a-409e-a501-bdd28809b4b2,https://au-api.basiq.io/users/11103cba-4a08-4397-84a5-22ac125ed2f6/accounts/49544383-c19c-4c97-b8d1-5322d0faa6af,https://au-api.basiq.io/institutions/AU00000,,Supermarket and Grocery Stores,411
transaction,87d051eb-b316-4fec-99dc-d392fac970f0,posted,Sushi Plus Man823658 MANLY2 AU,-25.00,49544383-c19c-4c97-b8d1-5322d0faa6af,-7614.11,debit,payment,AU00000,5453f0a3-083c-43c6-9086-adfe94df9918,,,2022-06-15T00:00:00Z,,https://au-api.basiq.io/users/11103cba-4a08-4397-84a5-22ac125ed2f6/transactions/87d051eb-b316-4fec-99dc-d392fac970f0,https://au-api.basiq.io/users/11103cba-4a08-4397-84a5-22ac125ed2f6/accounts/49544383-c19c-4c97-b8d1-5322d0faa6af,https://au-api.basiq.io/institutions/AU00000,,"Cafes, Restaurants and Takeaway Food Services",451
transaction,94b4ac21-c284-486a-9877-d23bb49454c9,posted,DNT CARPET & UPHOLST BEACON HILL AU,-141.00,49544383-c19c-4c97-b8d1-5322d0faa6af,-7589.11,debit,payment,AU00000,5453f0a3-083c-43c6-9086-adfe94df9918,,,2022-06-14T00:00:00Z,,https://au-api.basiq.io/users/11103cba-4a08-4397-84a5-22ac125ed2f6/transactions/94b4ac21-c284-486a-9877-d23bb49454c9,https://au-api.basiq.io/users/11103cba-4a08-4397-84a5-22ac125ed2f6/accounts/49544383-c19c-4c97-b8d1-5322d0faa6af,https://au-api.basiq.io/institutions/AU00000,,Other Personal Services,953
transaction,017a9cb8-8c06-4c18-8138-2a7235a67a24,posted,TERRI SCHEER INSURANCE ADEL,-486.45,49544383-c19c-4c97-b8d1-5322d0faa6af,-7448.11,debit,payment,AU00000,5453f0a3-083c-43c6-9086-adfe94df9918,,,2022-06-14T00:00:00Z,,https://au-api.basiq.io/users/11103cba-4a08-4397-84a5-22ac125ed2f6/transactions/017a9cb8-8c06-4c18-8138-2a7235a67a24,https://au-api.basiq.io/users/11103cba-4a08-4397-84a5-22ac125ed2f6/accounts/49544383-c19c-4c97-b8d1-5322d0faa6af,https://au-api.basiq.io/institutions/AU00000,,Health and General Insurance,632
transaction,7154d0be-3bcd-4a6a-934f-aa1a2ea99108,posted,COLES 0869 MANLY AU,-4.64,49544383-c19c-4c97-b8d1-5322d0faa6af,-6961.66,debit,payment,AU00000,5453f0a3-083c-43c6-9086-adfe94df9918,,,2022-06-14T00:00:00Z,,https://au-api.basiq.io/users/11103cba-4a08-4397-84a5-22ac125ed2f6/transactions/7154d0be-3bcd-4a6a-934f-aa1a2ea99108,https://au-api.basiq.io/users/11103cba-4a08-4397-84a5-22ac125ed2f6/accounts/49544383-c19c-4c97-b8d1-5322d0faa6af,https://au-api.basiq.io/institutions/AU00000,,Supermarket and Grocery Stores,411
transaction,8966014f-15b0-4ec9-92bc-6d328e705946,posted,SYDNEY WATER,-169.38,49544383-c19c-4c97-b8d1-5322d0faa6af,-6957.02,debit,payment,AU00000,5453f0a3-083c-43c6-9086-adfe94df9918,,,2022-06-14T00:00:00Z,,https://au-api.basiq.io/users/11103cba-4a08-4397-84a5-22ac125ed2f6/transactions/8966014f-15b0-4ec9-92bc-6d328e705946,https://au-api.basiq.io/users/11103cba-4a08-4397-84a5-22ac125ed2f6/accounts/49544383-c19c-4c97-b8d1-5322d0faa6af,https://au-api.basiq.io/institutions/AU00000,,"Water Supply, Sewerage and Drainage Services",281
transaction,de435295-72ee-4614-a08b-d0ab96ed56f8,posted,BUNNINGS 551000 WARRINGAH MALAU,-12.38,49544383-c19c-4c97-b8d1-5322d0faa6af,-6787.64,debit,payment,AU00000,5453f0a3-083c-43c6-9086-adfe94df9918,,,2022-06-14T00:00:00Z,,https://au-api.basiq.io/users/11103cba-4a08-4397-84a5-22ac125ed2f6/transactions/de435295-72ee-4614-a08b-d0ab96ed56f8,https://au-api.basiq.io/users/11103cba-4a08-4397-84a5-22ac125ed2f6/accounts/49544383-c19c-4c97-b8d1-5322d0faa6af,https://au-api.basiq.io/institutions/AU00000,,"Hardware, Building and Garden Supplies Retailing",423
transaction,b3bee031-fb16-42bf-90d3-6aecae5959f0,posted,COLES 0869 MANLY AU,-19.00,49544383-c19c-4c97-b8d1-5322d0faa6af,-6775.26,debit,payment,AU00000,5453f0a3-083c-43c6-9086-adfe94df9918,,,2022-06-14T00:00:00Z,,https://au-api.basiq.io/users/11103cba-4a08-4397-84a5-22ac125ed2f6/transactions/b3bee031-fb16-42bf-90d3-6aecae5959f0,https://au-api.basiq.io/users/11103cba-4a08-4397-84a5-22ac125ed2f6/accounts/49544383-c19c-4c97-b8d1-5322d0faa6af,https://au-api.basiq.io/institutions/AU00000,,Supermarket and Grocery Stores,411
transaction,47a1c16d-be47-4684-b8cc-c16c03a595e3,posted,BUNNINGS 551000 WARRINGAH MALAU,-104.40,49544383-c19c-4c97-b8d1-5322d0faa6af,-6756.26,debit,payment,AU00000,5453f0a3-083c-43c6-9086-adfe94df9918,,,2022-06-13T00:00:00Z,,https://au-api.basiq.io/users/11103cba-4a08-4397-84a5-22ac125ed2f6/transactions/47a1c16d-be47-4684-b8cc-c16c03a595e3,https://au-api.basiq.io/users/11103cba-4a08-4397-84a5-22ac125ed2f6/accounts/49544383-c19c-4c97-b8d1-5322d0faa6af,https://au-api.basiq.io/institutions/AU00000,,"Hardware, Building and Garden Supplies Retailing",423
transaction,5e401b56-98ea-488b-ad46-4e3e4016fd6e,posted,QBE INSURANCE AUSTRALIA LGLEN,-292.60,49544383-c19c-4c97-b8d1-5322d0faa6af,-6651.86,debit,payment,AU00000,5453f0a3-083c-43c6-9086-adfe94df9918,,,2022-06-13T00:00:00Z,,https://au-api.basiq.io/users/11103cba-4a08-4397-84a5-22ac125ed2f6/transactions/5e401b56-98ea-488b-ad46-4e3e4016fd6e,https://au-api.basiq.io/users/11103cba-4a08-4397-84a5-22ac125ed2f6/accounts/49544383-c19c-4c97-b8d1-5322d0faa6af,https://au-api.basiq.io/institutions/AU00000,,Health and General Insurance,632
transaction,05267c56-e567-4ad4-9b03-c25c6219972c,posted,THE ITALIAN ROOM PL MANLY VALE NSWAU,-41.00,49544383-c19c-4c97-b8d1-5322d0faa6af,-6359.26,debit,payment,AU00000,5453f0a3-083c-43c6-9086-adfe94df9918,,,2022-06-13T00:00:00Z,,https://au-api.basiq.io/users/11103cba-4a08-4397-84a5-22ac125ed2f6/transactions/05267c56-e567-4ad4-9b03-c25c6219972c,https://au-api.basiq.io/users/11103cba-4a08-4397-84a5-22ac125ed2f6/accounts/49544383-c19c-4c97-b8d1-5322d0faa6af,https://au-api.basiq.io/institutions/AU00000,,"Cafes, Restaurants and Takeaway Food Services",451
transaction,4bfbcdee-630f-453c-b099-6b2441e132fc,posted,BUNNINGS 551000 WARRINGAH MALAU,-77.30,49544383-c19c-4c97-b8d1-5322d0faa6af,-6318.26,debit,payment,AU00000,5453f0a3-083c-43c6-9086-adfe94df9918,,,2022-06-13T00:00:00Z,,https://au-api.basiq.io/users/11103cba-4a08-4397-84a5-22ac125ed2f6/transactions/4bfbcdee-630f-453c-b099-6b2441e132fc,https://au-api.basiq.io/users/11103cba-4a08-4397-84a5-22ac125ed2f6/accounts/49544383-c19c-4c97-b8d1-5322d0faa6af,https://au-api.basiq.io/institutions/AU00000,,"Hardware, Building and Garden Supplies Retailing",423
transaction,ec033447-dceb-48f1-979c-6285aae586cc,posted,Pure Wholefood549949 MANLY2 AU,-9.50,49544383-c19c-4c97-b8d1-5322d0faa6af,-6240.96,debit,payment,AU00000,5453f0a3-083c-43c6-9086-adfe94df9918,,,2022-06-13T00:00:00Z,,https://au-api.basiq.io/users/11103cba-4a08-4397-84a5-22ac125ed2f6/transactions/ec033447-dceb-48f1-979c-6285aae586cc,https://au-api.basiq.io/users/11103cba-4a08-4397-84a5-22ac125ed2f6/accounts/49544383-c19c-4c97-b8d1-5322d0faa6af,https://au-api.basiq.io/institutions/AU00000,,"Cafes, Restaurants and Takeaway Food Services",451
transaction,fd0e7c79-d9f0-436d-867f-733cd687085f,posted,OPTUS PREPAID MELBOURN,-40.00,49544383-c19c-4c97-b8d1-5322d0faa6af,-6231.46,debit,payment,AU00000,5453f0a3-083c-43c6-9086-adfe94df9918,,,2022-06-13T00:00:00Z,,https://au-api.basiq.io/users/11103cba-4a08-4397-84a5-22ac125ed2f6/transactions/fd0e7c79-d9f0-436d-867f-733cd687085f,https://au-api.basiq.io/users/11103cba-4a08-4397-84a5-22ac125ed2f6/accounts/49544383-c19c-4c97-b8d1-5322d0faa6af,https://au-api.basiq.io/institutions/AU00000,,Telecommunications Services,580
transaction,5180f960-714e-4323-9dfb-4ee1ac047c8a,posted,LIQUORLAND 3513 FRENCHS FRST AU,-64.00,49544383-c19c-4c97-b8d1-5322d0faa6af,-6191.46,debit,payment,AU00000,5453f0a3-083c-43c6-9086-adfe94df9918,,,2022-06-12T00:00:00Z,,https://au-api.basiq.io/users/11103cba-4a08-4397-84a5-22ac125ed2f6/transactions/5180f960-714e-4323-9dfb-4ee1ac047c8a,https://au-api.basiq.io/users/11103cba-4a08-4397-84a5-22ac125ed2f6/accounts/49544383-c19c-4c97-b8d1-5322d0faa6af,https://au-api.basiq.io/institutions/AU00000,,Specialised Food Retailing,412
transaction,2328ed34-76ab-42ff-b4e6-38db9ab76bc4,posted,WOOLWORTHS 1063 FRENCHS FRST NSW AU,-185.20,49544383-c19c-4c97-b8d1-5322d0faa6af,-6127.46,debit,payment,AU00000,5453f0a3-083c-43c6-9086-adfe94df9918,,,2022-06-12T00:00:00Z,,https://au-api.basiq.io/users/11103cba-4a08-4397-84a5-22ac125ed2f6/transactions/2328ed34-76ab-42ff-b4e6-38db9ab76bc4,https://au-api.basiq.io/users/11103cba-4a08-4397-84a5-22ac125ed2f6/accounts/49544383-c19c-4c97-b8d1-5322d0faa6af,https://au-api.basiq.io/institutions/AU00000,,Supermarket and Grocery Stores,411
transaction,30a66166-5f86-4542-936a-f670064f117d,posted,BUNNINGS 588000 BELROSE AU,-20.84,49544383-c19c-4c97-b8d1-5322d0faa6af,-5942.26,debit,payment,AU00000,5453f0a3-083c-43c6-9086-adfe94df9918,,,2022-06-12T00:00:00Z,,https://au-api.basiq.io/users/11103cba-4a08-4397-84a5-22ac125ed2f6/transactions/30a66166-5f86-4542-936a-f670064f117d,https://au-api.basiq.io/users/11103cba-4a08-4397-84a5-22ac125ed2f6/accounts/49544383-c19c-4c97-b8d1-5322d0faa6af,https://au-api.basiq.io/institutions/AU00000,,"Hardware, Building and Garden Supplies Retailing",423
transaction,908d649c-4b81-4a36-92a8-f046fb308d02,posted,WOOLWORTHS 1063 FRENCHS FRST NSW AU,-146.73,49544383-c19c-4c97-b8d1-5322d0faa6af,-5921.42,debit,payment,AU00000,5453f0a3-083c-43c6-9086-adfe94df9918,,,2022-06-11T00:00:00Z,,https://au-api.basiq.io/users/11103cba-4a08-4397-84a5-22ac125ed2f6/transactions/908d649c-4b81-4a36-92a8-f046fb308d02,https://au-api.basiq.io/users/11103cba-4a08-4397-84a5-22ac125ed2f6/accounts/49544383-c19c-4c97-b8d1-5322d0faa6af,https://au-api.basiq.io/institutions/AU00000,,Supermarket and Grocery Stores,411
transaction,4324d889-f159-40e1-a219-4d784d6c3ce7,posted,BUNNINGS 551000 WARRINGAH MALAU,-58.68,49544383-c19c-4c97-b8d1-5322d0faa6af,-5774.69,debit,payment,AU00000,5453f0a3-083c-43c6-9086-adfe94df9918,,,2022-06-11T00:00:00Z,,https://au-api.basiq.io/users/11103cba-4a08-4397-84a5-22ac125ed2f6/transactions/4324d889-f159-40e1-a219-4d784d6c3ce7,https://au-api.basiq.io/users/11103cba-4a08-4397-84a5-22ac125ed2f6/accounts/49544383-c19c-4c97-b8d1-5322d0faa6af,https://au-api.basiq.io/institutions/AU00000,,"Hardware, Building and Garden Supplies Retailing",423
transaction,41cc60c5-b2d4-4098-aadb-7835ab6d0ca8,posted,BP NTH MANLY 9546 NORTH MANLY AU,-106.76,49544383-c19c-4c97-b8d1-5322d0faa6af,-5716.01,debit,payment,AU00000,5453f0a3-083c-43c6-9086-adfe94df9918,,,2022-06-11T00:00:00Z,,https://au-api.basiq.io/users/11103cba-4a08-4397-84a5-22ac125ed2f6/transactions/41cc60c5-b2d4-4098-aadb-7835ab6d0ca8,https://au-api.basiq.io/users/11103cba-4a08-4397-84a5-22ac125ed2f6/accounts/49544383-c19c-4c97-b8d1-5322d0faa6af,https://au-api.basiq.io/institutions/AU00000,,Fuel Retailing,400
transaction,29726170-0c0d-4310-87a8-e1c8afe8d086,posted,COLES 0854 FORESTVILLE AU,-5.00,49544383-c19c-4c97-b8d1-5322d0faa6af,-5609.25,debit,payment,AU00000,5453f0a3-083c-43c6-9086-adfe94df9918,,,2022-06-10T00:00:00Z,,https://au-api.basiq.io/users/11103cba-4a08-4397-84a5-22ac125ed2f6/transactions/29726170-0c0d-4310-87a8-e1c8afe8d086,https://au-api.basiq.io/users/11103cba-4a08-4397-84a5-22ac125ed2f6/accounts/49544383-c19c-4c97-b8d1-5322d0faa6af,https://au-api.basiq.io/institutions/AU00000,,Supermarket and Grocery Stores,411
transaction,12a2675b-723d-4528-94c4-f5819074269c,posted,Cash Wdr  NUMBER # 1\MANLY AU,-403.80,49544383-c19c-4c97-b8d1-5322d0faa6af,-5604.25,debit,cash-withdrawal,AU00000,5453f0a3-083c-43c6-9086-adfe94df9918,,,2022-06-10T00:00:00Z,,https://au-api.basiq.io/users/11103cba-4a08-4397-84a5-22ac125ed2f6/transactions/12a2675b-723d-4528-94c4-f5819074269c,https://au-api.basiq.io/users/11103cba-4a08-4397-84a5-22ac125ed2f6/accounts/49544383-c19c-4c97-b8d1-5322d0faa6af,https://au-api.basiq.io/institutions/AU00000,,,
transaction,540b5dfb-700c-4322-92ad-b96187ce771d,posted,CALTEX WOOLWORTHS BE AC BEACON HILL AU,-18.95,49544383-c19c-4c97-b8d1-5322d0faa6af,-5200.45,debit,payment,AU00000,5453f0a3-083c-43c6-9086-adfe94df9918,,,2022-06-10T00:00:00Z,,https://au-api.basiq.io/users/11103cba-4a08-4397-84a5-22ac125ed2f6/transactions/540b5dfb-700c-4322-92ad-b96187ce771d,https://au-api.basiq.io/users/11103cba-4a08-4397-84a5-22ac125ed2f6/accounts/49544383-c19c-4c97-b8d1-5322d0faa6af,https://au-api.basiq.io/institutions/AU00000,,Fuel Retailing,400
transaction,4fea528b-bee5-4a5d-856c-873481092e70,posted,WOOLWORTHS 1063 FRENCHS FRST NSW AU,-10.78,49544383-c19c-4c97-b8d1-5322d0faa6af,-5181.50,debit,payment,AU00000,5453f0a3-083c-43c6-9086-adfe94df9918,,,2022-06-10T00:00:00Z,,https://au-api.basiq.io/users/11103cba-4a08-4397-84a5-22ac125ed2f6/transactions/4fea528b-bee5-4a5d-856c-873481092e70,https://au-api.basiq.io/users/11103cba-4a08-4397-84a5-22ac125ed2f6/accounts/49544383-c19c-4c97-b8d1-5322d0faa6af,https://au-api.basiq.io/institutions/AU00000,,Supermarket and Grocery Stores,411
transaction,9b2d5804-5514-4fe2-b9d1-183984d9d526,posted,Cash Wdr  T A NSW 229501   AUS,-603.00,49544383-c19c-4c97-b8d1-5322d0faa6af,-5170.72,debit,cash-withdrawal,AU00000,5453f0a3-083c-43c6-9086-adfe94df9918,,,2022-06-10T00:00:00Z,,https://au-api.basiq.io/users/11103cba-4a08-4397-84a5-22ac125ed2f6/transactions/9b2d5804-5514-4fe2-b9d1-183984d9d526,https://au-api.basiq.io/users/11103cba-4a08-4397-84a5-22ac125ed2f6/accounts/49544383-c19c-4c97-b8d1-5322d0faa6af,https://au-api.basiq.io/institutions/AU00000,,,
transaction,3cf472b0-efd3-45d0-9d4f-5c4b8e2b97f3,posted,KING HOISTS NARRAWEENA AU,-633.50,49544383-c19c-4c97-b8d1-5322d0faa6af,-4567.72,debit,payment,AU00000,5453f0a3-083c-43c6-9086-adfe94df9918,,,2022-06-09T00:00:00Z,,https://au-api.basiq.io/users/11103cba-4a08-4397-84a5-22ac125ed2f6/transactions/3cf472b0-efd3-45d0-9d4f-5c4b8e2b97f3,https://au-api.basiq.io/users/11103cba-4a08-4397-84a5-22ac125ed2f6/accounts/49544383-c19c-4c97-b8d1-5322d0faa6af,https://au-api.basiq.io/institutions/AU00000,,Other Personal Services,953
transaction,380e734f-dc83-4439-ae65-1e60ab26ff62,posted,HAVANA BEACH CAF&LNG MANLY NSWAU,-142.00,49544383-c19c-4c97-b8d1-5322d0faa6af,-3934.22,debit,payment,AU00000,5453f0a3-083c-43c6-9086-adfe94df9918,,,2022-06-09T00:00:00Z,,https://au-api.basiq.io/users/11103cba-4a08-4397-84a5-22ac125ed2f6/transactions/380e734f-dc83-4439-ae65-1e60ab26ff62,https://au-api.basiq.io/users/11103cba-4a08-4397-84a5-22ac125ed2f6/accounts/49544383-c19c-4c97-b8d1-5322d0faa6af,https://au-api.basiq.io/institutions/AU00000,,"Pubs, Taverns and Bars",452
transaction,737d6199-5b1c-47ce-a6aa-824aba7d261c,posted,COLES 0869 MANLY AU,-22.02,49544383-c19c-4c97-b8d1-5322d0faa6af,-3792.22,debit,payment,AU00000,5453f0a3-083c-43c6-9086-adfe94df9918,,,2022-06-09T00:00:00Z,,https://au-api.basiq.io/users/11103cba-4a08-4397-84a5-22ac125ed2f6/transactions/737d6199-5b1c-47ce-a6aa-824aba7d261c,https://au-api.basiq.io/users/11103cba-4a08-4397-84a5-22ac125ed2f6/accounts/49544383-c19c-4c97-b8d1-5322d0faa6af,https://au-api.basiq.io/institutions/AU00000,,Supermarket and Grocery Stores,411
transaction,18bb113e-ac5c-4cf8-aa4f-caa0997f2723,posted,OFARM ORGANIC GROCER MANLY AU,-18.23,49544383-c19c-4c97-b8d1-5322d0faa6af,-3770.20,debit,payment,AU00000,5453f0a3-083c-43c6-9086-adfe94df9918,,,2022-06-08T00:00:00Z,,https://au-api.basiq.io/users/11103cba-4a08-4397-84a5-22ac125ed2f6/transactions/18bb113e-ac5c-4cf8-aa4f-caa0997f2723,https://au-api.basiq.io/users/11103cba-4a08-4397-84a5-22ac125ed2f6/accounts/49544383-c19c-4c97-b8d1-5322d0faa6af,https://au-api.basiq.io/institutions/AU00000,,Supermarket and Grocery Stores,411
transaction,43956c59-d6e6-4f25-bed0-cd89a687c0c5,posted,QANTAS AIRWAYS LIMITED,-5209.50,49544383-c19c-4c97-b8d1-5322d0faa6af,-3751.97,debit,payment,AU00000,5453f0a3-083c-43c6-9086-adfe94df9918,,,2022-06-08T00:00:00Z,,https://au-api.basiq.io/users/11103cba-4a08-4397-84a5-22ac125ed2f6/transactions/43956c59-d6e6-4f25-bed0-cd89a687c0c5,https://au-api.basiq.io/users/11103cba-4a08-4397-84a5-22ac125ed2f6/accounts/49544383-c19c-4c97-b8d1-5322d0faa6af,https://au-api.basiq.io/institutions/AU00000,,Air and Space Transport,490
transaction,8e11bd7b-c88a-4552-aec2-06f14ee9518a,posted,OFARM ORGANIC GROCER MANLY AU,-57.46,49544383-c19c-4c97-b8d1-5322d0faa6af,1457.53,debit,payment,AU00000,5453f0a3-083c-43c6-9086-adfe94df9918,,,2022-06-08T00:00:00Z,,https://au-api.basiq.io/users/11103cba-4a08-4397-84a5-22ac125ed2f6/transactions/8e11bd7b-c88a-4552-aec2-06f14ee9518a,https://au-api.basiq.io/users/11103cba-4a08-4397-84a5-22ac125ed2f6/accounts/49544383-c19c-4c97-b8d1-5322d0faa6af,https://au-api.basiq.io/institutions/AU00000,,Supermarket and Grocery Stores,411
transaction,9b7079e7-5a12-4a6f-a0b7-b4ab87a497dc,posted,Sushi Plus Man823658 MANLY2 AU,-32.00,49544383-c19c-4c97-b8d1-5322d0faa6af,1514.99,debit,payment,AU00000,5453f0a3-083c-43c6-9086-adfe94df9918,,,2022-06-08T00:00:00Z,,https://au-api.basiq.io/users/11103cba-4a08-4397-84a5-22ac125ed2f6/transactions/9b7079e7-5a12-4a6f-a0b7-b4ab87a497dc,https://au-api.basiq.io/users/11103cba-4a08-4397-84a5-22ac125ed2f6/accounts/49544383-c19c-4c97-b8d1-5322d0faa6af,https://au-api.basiq.io/institutions/AU00000,,"Cafes, Restaurants and Takeaway Food Services",451
transaction,5b041341-76c9-47d4-94c3-f822378cd1ee,posted,Patagonia Manly AU,-84.94,49544383-c19c-4c97-b8d1-5322d0faa6af,1546.99,debit,payment,AU00000,5453f0a3-083c-43c6-9086-adfe94df9918,,,2022-06-08T00:00:00Z,,https://au-api.basiq.io/users/11103cba-4a08-4397-84a5-22ac125ed2f6/transactions/5b041341-76c9-47d4-94c3-f822378cd1ee,https://au-api.basiq.io/users/11103cba-4a08-4397-84a5-22ac125ed2f6/accounts/49544383-c19c-4c97-b8d1-5322d0faa6af,https://au-api.basiq.io/institutions/AU00000,,"Clothing, Footwear and Personal Accessory Retailing",425
transaction,0ede44ac-5c8f-4956-8f6f-dfaa294f50ae,posted,ALDI STORES MANLY NSWAU,-7.67,49544383-c19c-4c97-b8d1-5322d0faa6af,1631.93,debit,payment,AU00000,5453f0a3-083c-43c6-9086-adfe94df9918,,,2022-06-07T00:00:00Z,,https://au-api.basiq.io/users/11103cba-4a08-4397-84a5-22ac125ed2f6/transactions/0ede44ac-5c8f-4956-8f6f-dfaa294f50ae,https://au-api.basiq.io/users/11103cba-4a08-4397-84a5-22ac125ed2f6/accounts/49544383-c19c-4c97-b8d1-5322d0faa6af,https://au-api.basiq.io/institutions/AU00000,,Supermarket and Grocery Stores,411
transaction,a5bb4c65-99a8-4dc6-933c-e3929d1bb7ab,posted,NORTHERN BEACHES COUNCIL - SOUTH RATES,-369.00,49544383-c19c-4c97-b8d1-5322d0faa6af,1639.60,debit,payment,AU00000,5453f0a3-083c-43c6-9086-adfe94df9918,,,2022-06-06T00:00:00Z,,https://au-api.basiq.io/users/11103cba-4a08-4397-84a5-22ac125ed2f6/transactions/a5bb4c65-99a8-4dc6-933c-e3929d1bb7ab,https://au-api.basiq.io/users/11103cba-4a08-4397-84a5-22ac125ed2f6/accounts/49544383-c19c-4c97-b8d1-5322d0faa6af,https://au-api.basiq.io/institutions/AU00000,,Local Government Administration,753
transaction,b2c1836e-baf3-4fb5-ae8f-47868eac6641,posted,OFARM ORGANIC GROCER MANLY AU,-65.17,49544383-c19c-4c97-b8d1-5322d0faa6af,2008.60,debit,payment,AU00000,5453f0a3-083c-43c6-9086-adfe94df9918,,,2022-06-06T00:00:00Z,,https://au-api.basiq.io/users/11103cba-4a08-4397-84a5-22ac125ed2f6/transactions/b2c1836e-baf3-4fb5-ae8f-47868eac6641,https://au-api.basiq.io/users/11103cba-4a08-4397-84a5-22ac125ed2f6/accounts/49544383-c19c-4c97-b8d1-5322d0faa6af,https://au-api.basiq.io/institutions/AU00000,,Supermarket and Grocery Stores,411
transaction,fb6e5f83-fa87-49b3-99c6-3f10000f997a,posted,COLES 0815 MANLY AU,-28.96,49544383-c19c-4c97-b8d1-5322d0faa6af,2073.77,debit,payment,AU00000,5453f0a3-083c-43c6-9086-adfe94df9918,,,2022-06-05T00:00:00Z,,https://au-api.basiq.io/users/11103cba-4a08-4397-84a5-22ac125ed2f6/transactions/fb6e5f83-fa87-49b3-99c6-3f10000f997a,https://au-api.basiq.io/users/11103cba-4a08-4397-84a5-22ac125ed2f6/accounts/49544383-c19c-4c97-b8d1-5322d0faa6af,https://au-api.basiq.io/institutions/AU00000,,Supermarket and Grocery Stores,411
transaction,cd2974c5-7112-41a3-bf5a-657b6a7b8e67,posted,LIQUORLAND 3640 MANLY AU,-46.50,49544383-c19c-4c97-b8d1-5322d0faa6af,2102.73,debit,payment,AU00000,5453f0a3-083c-43c6-9086-adfe94df9918,,,2022-06-05T00:00:00Z,,https://au-api.basiq.io/users/11103cba-4a08-4397-84a5-22ac125ed2f6/transactions/cd2974c5-7112-41a3-bf5a-657b6a7b8e67,https://au-api.basiq.io/users/11103cba-4a08-4397-84a5-22ac125ed2f6/accounts/49544383-c19c-4c97-b8d1-5322d0faa6af,https://au-api.basiq.io/institutions/AU00000,,Specialised Food Retailing,412
transaction,9134e718-56fd-4848-b99e-a588a6c4ee2d,posted,V/CELLARS 3461 SEAFORTH AU,-17.66,49544383-c19c-4c97-b8d1-5322d0faa6af,2149.23,debit,payment,AU00000,5453f0a3-083c-43c6-9086-adfe94df9918,,,2022-06-04T00:00:00Z,,https://au-api.basiq.io/users/11103cba-4a08-4397-84a5-22ac125ed2f6/transactions/9134e718-56fd-4848-b99e-a588a6c4ee2d,https://au-api.basiq.io/users/11103cba-4a08-4397-84a5-22ac125ed2f6/accounts/49544383-c19c-4c97-b8d1-5322d0faa6af,https://au-api.basiq.io/institutions/AU00000,,Specialised Food Retailing,412
transaction,c06bfd83-741b-4321-9daf-265330fed722,posted,BP CONNECT 2245 BALGOWLAH AU,-94.01,49544383-c19c-4c97-b8d1-5322d0faa6af,2166.89,debit,payment,AU00000,5453f0a3-083c-43c6-9086-adfe94df9918,,,2022-06-04T00:00:00Z,,https://au-api.basiq.io/users/11103cba-4a08-4397-84a5-22ac125ed2f6/transactions/c06bfd83-741b-4321-9daf-265330fed722,https://au-api.basiq.io/users/11103cba-4a08-4397-84a5-22ac125ed2f6/accounts/49544383-c19c-4c97-b8d1-5322d0faa6af,https://au-api.basiq.io/institutions/AU00000,,Fuel Retailing,400
transaction,2f807305-39bf-471b-bddb-b9ae32d8535a,posted,Party Savers Brookvale AU,-15.00,49544383-c19c-4c97-b8d1-5322d0faa6af,2260.90,debit,payment,AU00000,5453f0a3-083c-43c6-9086-adfe94df9918,,,2022-06-04T00:00:00Z,,https://au-api.basiq.io/users/11103cba-4a08-4397-84a5-22ac125ed2f6/transactions/2f807305-39bf-471b-bddb-b9ae32d8535a,https://au-api.basiq.io/users/11103cba-4a08-4397-84a5-22ac125ed2f6/accounts/49544383-c19c-4c97-b8d1-5322d0faa6af,https://au-api.basiq.io/institutions/AU00000,,Pharmaceutical and Other Store-Based Retailing,427
transaction,f24b7fe4-e110-4431-b42f-85ee71c58846,posted,MANLY ABC SWIMMING C TR MANLY AU,-23.50,49544383-c19c-4c97-b8d1-5322d0faa6af,2275.90,debit,payment,AU00000,5453f0a3-083c-43c6-9086-adfe94df9918,,,2022-06-04T00:00:00Z,,https://au-api.basiq.io/users/11103cba-4a08-4397-84a5-22ac125ed2f6/transactions/f24b7fe4-e110-4431-b42f-85ee71c58846,https://au-api.basiq.io/users/11103cba-4a08-4397-84a5-22ac125ed2f6/accounts/49544383-c19c-4c97-b8d1-5322d0faa6af,https://au-api.basiq.io/institutions/AU00000,,Regulatory Services,772
transaction,d7aea716-eeb1-44dd-bf0c-2f2c352f2b09,posted,Sushi Plus Man823658 MANLY2 AU,-47.00,49544383-c19c-4c97-b8d1-5322d0faa6af,2299.40,debit,payment,AU00000,5453f0a3-083c-43c6-9086-adfe94df9918,,,2022-06-04T00:00:00Z,,https://au-api.basiq.io/users/11103cba-4a08-4397-84a5-22ac125ed2f6/transactions/d7aea716-eeb1-44dd-bf0c-2f2c352f2b09,https://au-api.basiq.io/users/11103cba-4a08-4397-84a5-22ac125ed2f6/accounts/49544383-c19c-4c97-b8d1-5322d0faa6af,https://au-api.basiq.io/institutions/AU00000,,"Cafes, Restaurants and Takeaway Food Services",451
transaction,0dcb77be-909d-4728-8935-9a076db04ec1,posted,COLES 0869 MANLY AU,-104.00,49544383-c19c-4c97-b8d1-5322d0faa6af,2346.40,debit,payment,AU00000,5453f0a3-083c-43c6-9086-adfe94df9918,,,2022-06-03T00:00:00Z,,https://au-api.basiq.io/users/11103cba-4a08-4397-84a5-22ac125ed2f6/transactions/0dcb77be-909d-4728-8935-9a076db04ec1,https://au-api.basiq.io/users/11103cba-4a08-4397-84a5-22ac125ed2f6/accounts/49544383-c19c-4c97-b8d1-5322d0faa6af,https://au-api.basiq.io/institutions/AU00000,,Supermarket and Grocery Stores,411
transaction,b57a5484-8f1c-4eea-bfc5-6c498ff62919,posted,BUNNINGS 341000 BALGOWLAH AU,-95.97,49544383-c19c-4c97-b8d1-5322d0faa6af,2450.40,debit,payment,AU00000,5453f0a3-083c-43c6-9086-adfe94df9918,,,2022-06-02T00:00:00Z,,https://au-api.basiq.io/users/11103cba-4a08-4397-84a5-22ac125ed2f6/transactions/b57a5484-8f1c-4eea-bfc5-6c498ff62919,https://au-api.basiq.io/users/11103cba-4a08-4397-84a5-22ac125ed2f6/accounts/49544383-c19c-4c97-b8d1-5322d0faa6af,https://au-api.basiq.io/institutions/AU00000,,"Hardware, Building and Garden Supplies Retailing",423
transaction,1323c9dd-1f8c-4ec1-a766-f1da2148fc98,posted,SEED 167 BROO,-40.95,49544383-c19c-4c97-b8d1-5322d0faa6af,2546.37,debit,payment,AU00000,5453f0a3-083c-43c6-9086-adfe94df9918,,,2022-06-01T00:00:00Z,,https://au-api.basiq.io/users/11103cba-4a08-4397-84a5-22ac125ed2f6/transactions/1323c9dd-1f8c-4ec1-a766-f1da2148fc98,https://au-api.basiq.io/users/11103cba-4a08-4397-84a5-22ac125ed2f6/accounts/49544383-c19c-4c97-b8d1-5322d0faa6af,https://au-api.basiq.io/institutions/AU00000,,"Clothing, Footwear and Personal Accessory Retailing",425
transaction,2532ce54-74ba-45b9-8dff-763fb232a55a,posted,AUSSIE SOX BROOKVALE BROO,-16.00,49544383-c19c-4c97-b8d1-5322d0faa6af,2587.32,debit,payment,AU00000,5453f0a3-083c-43c6-9086-adfe94df9918,,,2022-06-01T00:00:00Z,,https://au-api.basiq.io/users/11103cba-4a08-4397-84a5-22ac125ed2f6/transactions/2532ce54-74ba-45b9-8dff-763fb232a55a,https://au-api.basiq.io/users/11103cba-4a08-4397-84a5-22ac125ed2f6/accounts/49544383-c19c-4c97-b8d1-5322d0faa6af,https://au-api.basiq.io/institutions/AU00000,,"Clothing, Footwear and Personal Accessory Retailing",425
transaction,e6e15201-52de-47bf-8652-6e4d30c7ac4e,posted,Doug Smith Appliances Gran,-75.25,49544383-c19c-4c97-b8d1-5322d0faa6af,2603.32,debit,payment,AU00000,5453f0a3-083c-43c6-9086-adfe94df9918,,,2022-05-31T00:00:00Z,,https://au-api.basiq.io/users/11103cba-4a08-4397-84a5-22ac125ed2f6/transactions/e6e15201-52de-47bf-8652-6e4d30c7ac4e,https://au-api.basiq.io/users/11103cba-4a08-4397-84a5-22ac125ed2f6/accounts/49544383-c19c-4c97-b8d1-5322d0faa6af,https://au-api.basiq.io/institutions/AU00000,,Machinery and Equipment Repair and Maintenance,942
transaction,ffedcf7c-cabe-456c-b1a0-98f0d11e5a1e,posted,WOOLWORTHS 1262 BELR,-45.64,49544383-c19c-4c97-b8d1-5322d0faa6af,2678.57,debit,payment,AU00000,5453f0a3-083c-43c6-9086-adfe94df9918,,,2022-05-31T00:00:00Z,,https://au-api.basiq.io/users/11103cba-4a08-4397-84a5-22ac125ed2f6/transactions/ffedcf7c-cabe-456c-b1a0-98f0d11e5a1e,https://au-api.basiq.io/users/11103cba-4a08-4397-84a5-22ac125ed2f6/accounts/49544383-c19c-4c97-b8d1-5322d0faa6af,https://au-api.basiq.io/institutions/AU00000,,Supermarket and Grocery Stores,411
transaction,8d21af80-ac86-4e09-99e8-a19d563acdbb,posted,REFUND  BROOKVALE    NSWAU,17.00,49544383-c19c-4c97-b8d1-5322d0faa6af,2724.21,credit,refund,AU00000,5453f0a3-083c-43c6-9086-adfe94df9918,,,2022-05-31T00:00:00Z,,https://au-api.basiq.io/users/11103cba-4a08-4397-84a5-22ac125ed2f6/transactions/8d21af80-ac86-4e09-99e8-a19d563acdbb,https://au-api.basiq.io/users/11103cba-4a08-4397-84a5-22ac125ed2f6/accounts/49544383-c19c-4c97-b8d1-5322d0faa6af,https://au-api.basiq.io/institutions/AU00000,,,
transaction,b8d2540e-df16-445e-8073-144870073379,posted,OFARM ORGANIC GROCERS PTYMANL,-95.00,49544383-c19c-4c97-b8d1-5322d0faa6af,2707.21,debit,payment,AU00000,5453f0a3-083c-43c6-9086-adfe94df9918,,,2022-05-30T00:00:00Z,,https://au-api.basiq.io/users/11103cba-4a08-4397-84a5-22ac125ed2f6/transactions/b8d2540e-df16-445e-8073-144870073379,https://au-api.basiq.io/users/11103cba-4a08-4397-84a5-22ac125ed2f6/accounts/49544383-c19c-4c97-b8d1-5322d0faa6af,https://au-api.basiq.io/institutions/AU00000,,Supermarket and Grocery Stores,411
transaction,227e8ffb-e56c-4e82-b6e1-0ea921229995,posted,HUMPHREYS NEWSAGENCY MANLY,-19.98,49544383-c19c-4c97-b8d1-5322d0faa6af,2802.21,debit,payment,AU00000,5453f0a3-083c-43c6-9086-adfe94df9918,,,2022-05-30T00:00:00Z,,https://au-api.basiq.io/users/11103cba-4a08-4397-84a5-22ac125ed2f6/transactions/227e8ffb-e56c-4e82-b6e1-0ea921229995,https://au-api.basiq.io/users/11103cba-4a08-4397-84a5-22ac125ed2f6/accounts/49544383-c19c-4c97-b8d1-5322d0faa6af,https://au-api.basiq.io/institutions/AU00000,,Recreational Goods Retailing,424
transaction,d32cc123-d4e9-49a1-8e64-f1f5724a2b21,posted,COLES 0869 MANL,-19.76,49544383-c19c-4c97-b8d1-5322d0faa6af,2822.19,debit,payment,AU00000,5453f0a3-083c-43c6-9086-adfe94df9918,,,2022-05-30T00:00:00Z,,https://au-api.basiq.io/users/11103cba-4a08-4397-84a5-22ac125ed2f6/transactions/d32cc123-d4e9-49a1-8e64-f1f5724a2b21,https://au-api.basiq.io/users/11103cba-4a08-4397-84a5-22ac125ed2f6/accounts/49544383-c19c-4c97-b8d1-5322d0faa6af,https://au-api.basiq.io/institutions/AU00000,,Supermarket and Grocery Stores,411
transaction,8a235b70-3710-439e-b828-15f64e143982,posted,COLES 0897 BROO,-8.55,49544383-c19c-4c97-b8d1-5322d0faa6af,2841.95,debit,payment,AU00000,5453f0a3-083c-43c6-9086-adfe94df9918,,,2022-05-30T00:00:00Z,,https://au-api.basiq.io/users/11103cba-4a08-4397-84a5-22ac125ed2f6/transactions/8a235b70-3710-439e-b828-15f64e143982,https://au-api.basiq.io/users/11103cba-4a08-4397-84a5-22ac125ed2f6/accounts/49544383-c19c-4c97-b8d1-5322d0faa6af,https://au-api.basiq.io/institutions/AU00000,,Supermarket and Grocery Stores,411
transaction,989b32ee-5803-4c68-87a5-abfe52072230,posted,TFR From Transaction to CC Acc 13,9301.00,49544383-c19c-4c97-b8d1-5322d0faa6af,2850.50,credit,transfer,AU00000,5453f0a3-083c-43c6-9086-adfe94df9918,,,2022-05-30T00:00:00Z,,https://au-api.basiq.io/users/11103cba-4a08-4397-84a5-22ac125ed2f6/transactions/989b32ee-5803-4c68-87a5-abfe52072230,https://au-api.basiq.io/users/11103cba-4a08-4397-84a5-22ac125ed2f6/accounts/49544383-c19c-4c97-b8d1-5322d0faa6af,https://au-api.basiq.io/institutions/AU00000,,,
transaction,e772d3eb-a010-4869-b8ef-6ce724960c72,posted,WOOLWORTHS 1282 WRINGAH MALL NSW AU,-261.78,49544383-c19c-4c97-b8d1-5322d0faa6af,-6450.50,debit,payment,AU00000,5453f0a3-083c-43c6-9086-adfe94df9918,,,2022-05-30T00:00:00Z,,https://au-api.basiq.io/users/11103cba-4a08-4397-84a5-22ac125ed2f6/transactions/e772d3eb-a010-4869-b8ef-6ce724960c72,https://au-api.basiq.io/users/11103cba-4a08-4397-84a5-22ac125ed2f6/accounts/49544383-c19c-4c97-b8d1-5322d0faa6af,https://au-api.basiq.io/institutions/AU00000,,Supermarket and Grocery Stores,411
transaction,f85f5d4f-caaf-4a4e-a6ee-52c019175914,posted,WOOLWORTHS 1282 WRINGAH MALL NSW AU,-261.78,49544383-c19c-4c97-b8d1-5322d0faa6af,-6188.72,debit,payment,AU00000,5453f0a3-083c-43c6-9086-adfe94df9918,,,2022-05-30T00:00:00Z,,https://au-api.basiq.io/users/11103cba-4a08-4397-84a5-22ac125ed2f6/transactions/f85f5d4f-caaf-4a4e-a6ee-52c019175914,https://au-api.basiq.io/users/11103cba-4a08-4397-84a5-22ac125ed2f6/accounts/49544383-c19c-4c97-b8d1-5322d0faa6af,https://au-api.basiq.io/institutions/AU00000,,Supermarket and Grocery Stores,411
transaction,083a99b8-eeee-4b1a-a479-b78a03a9f2e4,posted,COLES 0869 MANL,-49.86,49544383-c19c-4c97-b8d1-5322d0faa6af,-5926.94,debit,payment,AU00000,5453f0a3-083c-43c6-9086-adfe94df9918,,,2022-05-29T00:00:00Z,,https://au-api.basiq.io/users/11103cba-4a08-4397-84a5-22ac125ed2f6/transactions/083a99b8-eeee-4b1a-a479-b78a03a9f2e4,https://au-api.basiq.io/users/11103cba-4a08-4397-84a5-22ac125ed2f6/accounts/49544383-c19c-4c97-b8d1-5322d0faa6af,https://au-api.basiq.io/institutions/AU00000,,Supermarket and Grocery Stores,411
transaction,72741e26-bd97-49f9-8f35-3e0abebf552c,posted,SEED 167 BROO,-21.96,49544383-c19c-4c97-b8d1-5322d0faa6af,-5877.08,debit,payment,AU00000,5453f0a3-083c-43c6-9086-adfe94df9918,,,2022-05-29T00:00:00Z,,https://au-api.basiq.io/users/11103cba-4a08-4397-84a5-22ac125ed2f6/transactions/72741e26-bd97-49f9-8f35-3e0abebf552c,https://au-api.basiq.io/users/11103cba-4a08-4397-84a5-22ac125ed2f6/accounts/49544383-c19c-4c97-b8d1-5322d0faa6af,https://au-api.basiq.io/institutions/AU00000,,"Clothing, Footwear and Personal Accessory Retailing",425
transaction,63adc543-07f9-4697-b142-61862bcf9ed1,posted,MLI HOLDINGS PTY LIMITED CHAT,-88.50,49544383-c19c-4c97-b8d1-5322d0faa6af,-5855.12,debit,payment,AU00000,5453f0a3-083c-43c6-9086-adfe94df9918,,,2022-05-26T00:00:00Z,,https://au-api.basiq.io/users/11103cba-4a08-4397-84a5-22ac125ed2f6/transactions/63adc543-07f9-4697-b142-61862bcf9ed1,https://au-api.basiq.io/users/11103cba-4a08-4397-84a5-22ac125ed2f6/accounts/49544383-c19c-4c97-b8d1-5322d0faa6af,https://au-api.basiq.io/institutions/AU00000,,"Cafes, Restaurants and Takeaway Food Services",451
transaction,43468801-63fe-4e28-b4f7-296e76323c25,posted,OFFICEWORKS 0204 DEE,-74.20,49544383-c19c-4c97-b8d1-5322d0faa6af,-5766.62,debit,payment,AU00000,5453f0a3-083c-43c6-9086-adfe94df9918,,,2022-05-26T00:00:00Z,,https://au-api.basiq.io/users/11103cba-4a08-4397-84a5-22ac125ed2f6/transactions/43468801-63fe-4e28-b4f7-296e76323c25,https://au-api.basiq.io/users/11103cba-4a08-4397-84a5-22ac125ed2f6/accounts/49544383-c19c-4c97-b8d1-5322d0faa6af,https://au-api.basiq.io/institutions/AU00000,,Pharmaceutical and Other Store-Based Retailing,427
transaction,3abb89bc-4243-422b-aff7-4dc0234dafbb,posted,LUSH WARRINGAH BROO,-54.85,49544383-c19c-4c97-b8d1-5322d0faa6af,-5692.42,debit,payment,AU00000,5453f0a3-083c-43c6-9086-adfe94df9918,,,2022-05-26T00:00:00Z,,https://au-api.basiq.io/users/11103cba-4a08-4397-84a5-22ac125ed2f6/transactions/3abb89bc-4243-422b-aff7-4dc0234dafbb,https://au-api.basiq.io/users/11103cba-4a08-4397-84a5-22ac125ed2f6/accounts/49544383-c19c-4c97-b8d1-5322d0faa6af,https://au-api.basiq.io/institutions/AU00000,,Pharmaceutical and Other Store-Based Retailing,427
transaction,f7958a21-f0cb-40bf-babc-ae6b4fbb5b04,posted,Venture Health Manly Manl,-30.80,49544383-c19c-4c97-b8d1-5322d0faa6af,-5637.57,debit,payment,AU00000,5453f0a3-083c-43c6-9086-adfe94df9918,,,2022-05-26T00:00:00Z,,https://au-api.basiq.io/users/11103cba-4a08-4397-84a5-22ac125ed2f6/transactions/f7958a21-f0cb-40bf-babc-ae6b4fbb5b04,https://au-api.basiq.io/users/11103cba-4a08-4397-84a5-22ac125ed2f6/accounts/49544383-c19c-4c97-b8d1-5322d0faa6af,https://au-api.basiq.io/institutions/AU00000,,Specialised Food Retailing,412
transaction,74872d0e-1227-4028-9943-df2d48153b56,posted,SMIGGLE S57 MANL,-25.95,49544383-c19c-4c97-b8d1-5322d0faa6af,-5606.77,debit,payment,AU00000,5453f0a3-083c-43c6-9086-adfe94df9918,,,2022-05-26T00:00:00Z,,https://au-api.basiq.io/users/11103cba-4a08-4397-84a5-22ac125ed2f6/transactions/74872d0e-1227-4028-9943-df2d48153b56,https://au-api.basiq.io/users/11103cba-4a08-4397-84a5-22ac125ed2f6/accounts/49544383-c19c-4c97-b8d1-5322d0faa6af,https://au-api.basiq.io/institutions/AU00000,,Pharmaceutical and Other Store-Based Retailing,427
transaction,1a9f0422-1134-4ca1-9d2e-a532b873f329,posted,GIRDLERS GRIND DEE,-25.90,49544383-c19c-4c97-b8d1-5322d0faa6af,-5580.82,debit,payment,AU00000,5453f0a3-083c-43c6-9086-adfe94df9918,,,2022-05-26T00:00:00Z,,https://au-api.basiq.io/users/11103cba-4a08-4397-84a5-22ac125ed2f6/transactions/1a9f0422-1134-4ca1-9d2e-a532b873f329,https://au-api.basiq.io/users/11103cba-4a08-4397-84a5-22ac125ed2f6/accounts/49544383-c19c-4c97-b8d1-5322d0faa6af,https://au-api.basiq.io/institutions/AU00000,,"Cafes, Restaurants and Takeaway Food Services",451
transaction,2925eddc-c0fc-4a5d-b595-8304556ddb64,posted,H AND M AUSTRALIA AU0017 BROO,-15.95,49544383-c19c-4c97-b8d1-5322d0faa6af,-5554.92,debit,payment,AU00000,5453f0a3-083c-43c6-9086-adfe94df9918,,,2022-05-26T00:00:00Z,,https://au-api.basiq.io/users/11103cba-4a08-4397-84a5-22ac125ed2f6/transactions/2925eddc-c0fc-4a5d-b595-8304556ddb64,https://au-api.basiq.io/users/11103cba-4a08-4397-84a5-22ac125ed2f6/accounts/49544383-c19c-4c97-b8d1-5322d0faa6af,https://au-api.basiq.io/institutions/AU00000,,"Clothing, Footwear and Personal Accessory Retailing",425
transaction,2cebd2ae-7ede-4d15-a9f2-d7efaf1c001f,posted,WESTFIELD WARRINGAH MALL BROO,-13.00,49544383-c19c-4c97-b8d1-5322d0faa6af,-5538.97,debit,payment,AU00000,5453f0a3-083c-43c6-9086-adfe94df9918,,,2022-05-26T00:00:00Z,,https://au-api.basiq.io/users/11103cba-4a08-4397-84a5-22ac125ed2f6/transactions/2cebd2ae-7ede-4d15-a9f2-d7efaf1c001f,https://au-api.basiq.io/users/11103cba-4a08-4397-84a5-22ac125ed2f6/accounts/49544383-c19c-4c97-b8d1-5322d0faa6af,https://au-api.basiq.io/institutions/AU00000,,Property Operators,671
transaction,94956af3-7926-4f63-98d8-d65d029bfd09,posted,CTX WOW NEUTRAL BAY NEUTRAL BAY AU,-108.78,49544383-c19c-4c97-b8d1-5322d0faa6af,-5525.97,debit,payment,AU00000,5453f0a3-083c-43c6-9086-adfe94df9918,,,2022-05-26T00:00:00Z,,https://au-api.basiq.io/users/11103cba-4a08-4397-84a5-22ac125ed2f6/transactions/94956af3-7926-4f63-98d8-d65d029bfd09,https://au-api.basiq.io/users/11103cba-4a08-4397-84a5-22ac125ed2f6/accounts/49544383-c19c-4c97-b8d1-5322d0faa6af,https://au-api.basiq.io/institutions/AU00000,,Fuel Retailing,400
transaction,a1ca6289-48ec-49c0-a2d5-4c556df32cd8,posted,TARGET 5078 BROO,-109.00,49544383-c19c-4c97-b8d1-5322d0faa6af,-5417.19,debit,payment,AU00000,5453f0a3-083c-43c6-9086-adfe94df9918,,,2022-05-24T00:00:00Z,,https://au-api.basiq.io/users/11103cba-4a08-4397-84a5-22ac125ed2f6/transactions/a1ca6289-48ec-49c0-a2d5-4c556df32cd8,https://au-api.basiq.io/users/11103cba-4a08-4397-84a5-22ac125ed2f6/accounts/49544383-c19c-4c97-b8d1-5322d0faa6af,https://au-api.basiq.io/institutions/AU00000,,Department Stores,426
transaction,a3b79d2f-9ed5-48ed-aca6-90d4a89d9147,posted,OFARM ORGANIC GROCERS PTYMANL,-64.96,49544383-c19c-4c97-b8d1-5322d0faa6af,-5308.19,debit,payment,AU00000,5453f0a3-083c-43c6-9086-adfe94df9918,,,2022-05-24T00:00:00Z,,https://au-api.basiq.io/users/11103cba-4a08-4397-84a5-22ac125ed2f6/transactions/a3b79d2f-9ed5-48ed-aca6-90d4a89d9147,https://au-api.basiq.io/users/11103cba-4a08-4397-84a5-22ac125ed2f6/accounts/49544383-c19c-4c97-b8d1-5322d0faa6af,https://au-api.basiq.io/institutions/AU00000,,Supermarket and Grocery Stores,411
transaction,9afeedc5-0661-4cfa-a691-62afa2709957,posted,RMS ETOLL PH 131865 PARR,-51.22,49544383-c19c-4c97-b8d1-5322d0faa6af,-5243.23,debit,payment,AU00000,5453f0a3-083c-43c6-9086-adfe94df9918,,,2022-05-24T00:00:00Z,,https://au-api.basiq.io/users/11103cba-4a08-4397-84a5-22ac125ed2f6/transactions/9afeedc5-0661-4cfa-a691-62afa2709957,https://au-api.basiq.io/users/11103cba-4a08-4397-84a5-22ac125ed2f6/accounts/49544383-c19c-4c97-b8d1-5322d0faa6af,https://au-api.basiq.io/institutions/AU00000,,Unknown,0
transaction,4b8787ea-30a3-4458-896e-47de93704ad1,posted,TARGET 5078 BROO,-13.00,49544383-c19c-4c97-b8d1-5322d0faa6af,-5192.01,debit,payment,AU00000,5453f0a3-083c-43c6-9086-adfe94df9918,,,2022-05-24T00:00:00Z,,https://au-api.basiq.io/users/11103cba-4a08-4397-84a5-22ac125ed2f6/transactions/4b8787ea-30a3-4458-896e-47de93704ad1,https://au-api.basiq.io/users/11103cba-4a08-4397-84a5-22ac125ed2f6/accounts/49544383-c19c-4c97-b8d1-5322d0faa6af,https://au-api.basiq.io/institutions/AU00000,,Department Stores,426
transaction,83640db1-3fcb-4227-9c50-ccf8ecace9ac,posted,WOOLWORTHS 1282 WRINGAH MALL NSW AU,-120.71,49544383-c19c-4c97-b8d1-5322d0faa6af,-5179.01,debit,payment,AU00000,5453f0a3-083c-43c6-9086-adfe94df9918,,,2022-05-24T00:00:00Z,,https://au-api.basiq.io/users/11103cba-4a08-4397-84a5-22ac125ed2f6/transactions/83640db1-3fcb-4227-9c50-ccf8ecace9ac,https://au-api.basiq.io/users/11103cba-4a08-4397-84a5-22ac125ed2f6/accounts/49544383-c19c-4c97-b8d1-5322d0faa6af,https://au-api.basiq.io/institutions/AU00000,,Supermarket and Grocery Stores,411
transaction,5ab02d92-3ac6-49e1-be97-ee1070dfefee,posted,IBIS STYLES EAGLEHAWK Sutt,-321.00,49544383-c19c-4c97-b8d1-5322d0faa6af,-5058.30,debit,payment,AU00000,5453f0a3-083c-43c6-9086-adfe94df9918,,,2022-05-23T00:00:00Z,,https://au-api.basiq.io/users/11103cba-4a08-4397-84a5-22ac125ed2f6/transactions/5ab02d92-3ac6-49e1-be97-ee1070dfefee,https://au-api.basiq.io/users/11103cba-4a08-4397-84a5-22ac125ed2f6/accounts/49544383-c19c-4c97-b8d1-5322d0faa6af,https://au-api.basiq.io/institutions/AU00000,,Accommodation,440
transaction,9ab1ed7b-4302-49d0-93d1-aa7028ac064e,posted,COLES 0869 MANL,-52.14,49544383-c19c-4c97-b8d1-5322d0faa6af,-4737.30,debit,payment,AU00000,5453f0a3-083c-43c6-9086-adfe94df9918,,,2022-05-23T00:00:00Z,,https://au-api.basiq.io/users/11103cba-4a08-4397-84a5-22ac125ed2f6/transactions/9ab1ed7b-4302-49d0-93d1-aa7028ac064e,https://au-api.basiq.io/users/11103cba-4a08-4397-84a5-22ac125ed2f6/accounts/49544383-c19c-4c97-b8d1-5322d0faa6af,https://au-api.basiq.io/institutions/AU00000,,Supermarket and Grocery Stores,411
transaction,1113e055-ce10-4def-a159-9ab4c0bd774c,posted,CAFE AND CATERING SO PARKES,-47.50,49544383-c19c-4c97-b8d1-5322d0faa6af,-4685.16,debit,payment,AU00000,5453f0a3-083c-43c6-9086-adfe94df9918,,,2022-05-23T00:00:00Z,,https://au-api.basiq.io/users/11103cba-4a08-4397-84a5-22ac125ed2f6/transactions/1113e055-ce10-4def-a159-9ab4c0bd774c,https://au-api.basiq.io/users/11103cba-4a08-4397-84a5-22ac125ed2f6/accounts/49544383-c19c-4c97-b8d1-5322d0faa6af,https://au-api.basiq.io/institutions/AU00000,,"Cafes, Restaurants and Takeaway Food Services",451
transaction,e4f4e257-dc27-4c67-b166-a2bc156be04f,posted,NATIONAL CAPITAL AUTH PARK,-11.00,49544383-c19c-4c97-b8d1-5322d0faa6af,-4637.66,debit,payment,AU00000,5453f0a3-083c-43c6-9086-adfe94df9918,,,2022-05-23T00:00:00Z,,https://au-api.basiq.io/users/11103cba-4a08-4397-84a5-22ac125ed2f6/transactions/e4f4e257-dc27-4c67-b166-a2bc156be04f,https://au-api.basiq.io/users/11103cba-4a08-4397-84a5-22ac125ed2f6/accounts/49544383-c19c-4c97-b8d1-5322d0faa6af,https://au-api.basiq.io/institutions/AU00000,,Other Personal Services,953
transaction,b22110fd-6af1-41b2-af15-fa648d0d796f,posted,NATIONAL CAPITAL AUTH PARK,-7.90,49544383-c19c-4c97-b8d1-5322d0faa6af,-4626.66,debit,payment,AU00000,5453f0a3-083c-43c6-9086-adfe94df9918,,,2022-05-23T00:00:00Z,,https://au-api.basiq.io/users/11103cba-4a08-4397-84a5-22ac125ed2f6/transactions/b22110fd-6af1-41b2-af15-fa648d0d796f,https://au-api.basiq.io/users/11103cba-4a08-4397-84a5-22ac125ed2f6/accounts/49544383-c19c-4c97-b8d1-5322d0faa6af,https://au-api.basiq.io/institutions/AU00000,,Other Personal Services,953
transaction,25df5627-082e-4007-938b-3318d271a034,posted,COLES 0869 MANLY AU,-89.37,49544383-c19c-4c97-b8d1-5322d0faa6af,-4618.76,debit,payment,AU00000,5453f0a3-083c-43c6-9086-adfe94df9918,,,2022-05-23T00:00:00Z,,https://au-api.basiq.io/users/11103cba-4a08-4397-84a5-22ac125ed2f6/transactions/25df5627-082e-4007-938b-3318d271a034,https://au-api.basiq.io/users/11103cba-4a08-4397-84a5-22ac125ed2f6/accounts/49544383-c19c-4c97-b8d1-5322d0faa6af,https://au-api.basiq.io/institutions/AU00000,,Supermarket and Grocery Stores,411
transaction,68e205a0-11ac-4297-b61e-18a3f37f73f3,posted,S&S BELCONNEN BELCONNEN ACTAU,-457.72,49544383-c19c-4c97-b8d1-5322d0faa6af,-4529.39,debit,payment,AU00000,5453f0a3-083c-43c6-9086-adfe94df9918,,,2022-05-20T00:00:00Z,,https://au-api.basiq.io/users/11103cba-4a08-4397-84a5-22ac125ed2f6/transactions/68e205a0-11ac-4297-b61e-18a3f37f73f3,https://au-api.basiq.io/users/11103cba-4a08-4397-84a5-22ac125ed2f6/accounts/49544383-c19c-4c97-b8d1-5322d0faa6af,https://au-api.basiq.io/institutions/AU00000,,"Clothing, Footwear and Personal Accessory Retailing",425
transaction,08a2a5be-8d94-44ec-98cb-196de0e0f11f,posted,SUSHI BAY ACT PL BELCONNEN AU,-116.50,49544383-c19c-4c97-b8d1-5322d0faa6af,-4071.67,debit,payment,AU00000,5453f0a3-083c-43c6-9086-adfe94df9918,,,2022-05-20T00:00:00Z,,https://au-api.basiq.io/users/11103cba-4a08-4397-84a5-22ac125ed2f6/transactions/08a2a5be-8d94-44ec-98cb-196de0e0f11f,https://au-api.basiq.io/users/11103cba-4a08-4397-84a5-22ac125ed2f6/accounts/49544383-c19c-4c97-b8d1-5322d0faa6af,https://au-api.basiq.io/institutions/AU00000,,"Cafes, Restaurants and Takeaway Food Services",451
transaction,d54f8b3a-6a82-496b-921d-aff4756ff0e9,posted,NATIONAL SCIENCE CTR PARKES ACTAU,-71.00,49544383-c19c-4c97-b8d1-5322d0faa6af,-3955.17,debit,payment,AU00000,5453f0a3-083c-43c6-9086-adfe94df9918,,,2022-05-19T00:00:00Z,,https://au-api.basiq.io/users/11103cba-4a08-4397-84a5-22ac125ed2f6/transactions/d54f8b3a-6a82-496b-921d-aff4756ff0e9,https://au-api.basiq.io/users/11103cba-4a08-4397-84a5-22ac125ed2f6/accounts/49544383-c19c-4c97-b8d1-5322d0faa6af,https://au-api.basiq.io/institutions/AU00000,,Amusement and Other Recreation Activities,913
transaction,fd62dade-71ff-4ad0-b04e-8f289cd2044a,posted,SYDNEY SURF SCHOOL MANL,-261.00,49544383-c19c-4c97-b8d1-5322d0faa6af,-3884.17,debit,payment,AU00000,5453f0a3-083c-43c6-9086-adfe94df9918,,,2022-05-19T00:00:00Z,,https://au-api.basiq.io/users/11103cba-4a08-4397-84a5-22ac125ed2f6/transactions/fd62dade-71ff-4ad0-b04e-8f289cd2044a,https://au-api.basiq.io/users/11103cba-4a08-4397-84a5-22ac125ed2f6/accounts/49544383-c19c-4c97-b8d1-5322d0faa6af,https://au-api.basiq.io/institutions/AU00000,,Amusement and Other Recreation Activities,913
transaction,1b4f6944-f8c6-45cb-a5a2-22b974f25716,posted,TVHR PTY LTD JIND,-81.00,49544383-c19c-4c97-b8d1-5322d0faa6af,-3623.17,debit,payment,AU00000,5453f0a3-083c-43c6-9086-adfe94df9918,,,2022-05-19T00:00:00Z,,https://au-api.basiq.io/users/11103cba-4a08-4397-84a5-22ac125ed2f6/transactions/1b4f6944-f8c6-45cb-a5a2-22b974f25716,https://au-api.basiq.io/users/11103cba-4a08-4397-84a5-22ac125ed2f6/accounts/49544383-c19c-4c97-b8d1-5322d0faa6af,https://au-api.basiq.io/institutions/AU00000,,Unknown,0
transaction,c58a84ec-54a3-4ea1-92dc-626c3dbee846,posted,ARIRANG FRESH FOOD P GUNGAHLIN AU,-104.50,49544383-c19c-4c97-b8d1-5322d0faa6af,-3542.17,debit,payment,AU00000,5453f0a3-083c-43c6-9086-adfe94df9918,,,2022-05-19T00:00:00Z,,https://au-api.basiq.io/users/11103cba-4a08-4397-84a5-22ac125ed2f6/transactions/c58a84ec-54a3-4ea1-92dc-626c3dbee846,https://au-api.basiq.io/users/11103cba-4a08-4397-84a5-22ac125ed2f6/accounts/49544383-c19c-4c97-b8d1-5322d0faa6af,https://au-api.basiq.io/institutions/AU00000,,"Cafes, Restaurants and Takeaway Food Services",451
transaction,6d455f81-d9dd-4ad4-9e36-f234472362ff,posted,NATIONAL DINOSAUR MU NICHOLLS AU,-46.00,49544383-c19c-4c97-b8d1-5322d0faa6af,-3437.67,debit,payment,AU00000,5453f0a3-083c-43c6-9086-adfe94df9918,,,2022-05-19T00:00:00Z,,https://au-api.basiq.io/users/11103cba-4a08-4397-84a5-22ac125ed2f6/transactions/6d455f81-d9dd-4ad4-9e36-f234472362ff,https://au-api.basiq.io/users/11103cba-4a08-4397-84a5-22ac125ed2f6/accounts/49544383-c19c-4c97-b8d1-5322d0faa6af,https://au-api.basiq.io/institutions/AU00000,,Amusement and Other Recreation Activities,913
transaction,b364f85c-171a-497e-bd60-f31eeed5df27,posted,Birchwood Cafe Jindabyne AU,-101.50,49544383-c19c-4c97-b8d1-5322d0faa6af,-3391.67,debit,payment,AU00000,5453f0a3-083c-43c6-9086-adfe94df9918,,,2022-05-19T00:00:00Z,,https://au-api.basiq.io/users/11103cba-4a08-4397-84a5-22ac125ed2f6/transactions/b364f85c-171a-497e-bd60-f31eeed5df27,https://au-api.basiq.io/users/11103cba-4a08-4397-84a5-22ac125ed2f6/accounts/49544383-c19c-4c97-b8d1-5322d0faa6af,https://au-api.basiq.io/institutions/AU00000,,"Cafes, Restaurants and Takeaway Food Services",451
transaction,352e264a-2fb5-4f20-85c9-065732c402f1,posted,ADVENTIST ALPINE VLG JINDABYNE NSWAU,-181.00,49544383-c19c-4c97-b8d1-5322d0faa6af,-3290.17,debit,payment,AU00000,5453f0a3-083c-43c6-9086-adfe94df9918,,,2022-05-18T00:00:00Z,,https://au-api.basiq.io/users/11103cba-4a08-4397-84a5-22ac125ed2f6/transactions/352e264a-2fb5-4f20-85c9-065732c402f1,https://au-api.basiq.io/users/11103cba-4a08-4397-84a5-22ac125ed2f6/accounts/49544383-c19c-4c97-b8d1-5322d0faa6af,https://au-api.basiq.io/institutions/AU00000,,Accommodation,440
transaction,a425e206-7161-4d73-a620-fa36928ee2ac,posted,WOOLWORTHS 1401 JIND,-7.05,49544383-c19c-4c97-b8d1-5322d0faa6af,-3109.17,debit,payment,AU00000,5453f0a3-083c-43c6-9086-adfe94df9918,,,2022-05-18T00:00:00Z,,https://au-api.basiq.io/users/11103cba-4a08-4397-84a5-22ac125ed2f6/transactions/a425e206-7161-4d73-a620-fa36928ee2ac,https://au-api.basiq.io/users/11103cba-4a08-4397-84a5-22ac125ed2f6/accounts/49544383-c19c-4c97-b8d1-5322d0faa6af,https://au-api.basiq.io/institutions/AU00000,,Supermarket and Grocery Stores,411
transaction,3ebc4073-93f6-4f5c-8000-70e354945ab9,posted,BACCO ITALIAN RESTAU JINDABYNE AU,-203.80,49544383-c19c-4c97-b8d1-5322d0faa6af,-3102.12,debit,payment,AU00000,5453f0a3-083c-43c6-9086-adfe94df9918,,,2022-05-18T00:00:00Z,,https://au-api.basiq.io/users/11103cba-4a08-4397-84a5-22ac125ed2f6/transactions/3ebc4073-93f6-4f5c-8000-70e354945ab9,https://au-api.basiq.io/users/11103cba-4a08-4397-84a5-22ac125ed2f6/accounts/49544383-c19c-4c97-b8d1-5322d0faa6af,https://au-api.basiq.io/institutions/AU00000,,"Cafes, Restaurants and Takeaway Food Services",451
transaction,73c95343-f69b-4045-8d17-fb2653847dd6,posted,THREDBO ALPINE HOTEL THREDBO AU,-19.00,49544383-c19c-4c97-b8d1-5322d0faa6af,-2898.32,debit,payment,AU00000,5453f0a3-083c-43c6-9086-adfe94df9918,,,2022-05-18T00:00:00Z,,https://au-api.basiq.io/users/11103cba-4a08-4397-84a5-22ac125ed2f6/transactions/73c95343-f69b-4045-8d17-fb2653847dd6,https://au-api.basiq.io/users/11103cba-4a08-4397-84a5-22ac125ed2f6/accounts/49544383-c19c-4c97-b8d1-5322d0faa6af,https://au-api.basiq.io/institutions/AU00000,,Accommodation,440
transaction,bcfb6817-cf76-4e68-883f-4f46ccc105dd,posted,KOSCIUSZKO THREDBO THREDBO AU,-216.00,49544383-c19c-4c97-b8d1-5322d0faa6af,-2879.32,debit,payment,AU00000,5453f0a3-083c-43c6-9086-adfe94df9918,,,2022-05-18T00:00:00Z,,https://au-api.basiq.io/users/11103cba-4a08-4397-84a5-22ac125ed2f6/transactions/bcfb6817-cf76-4e68-883f-4f46ccc105dd,https://au-api.basiq.io/users/11103cba-4a08-4397-84a5-22ac125ed2f6/accounts/49544383-c19c-4c97-b8d1-5322d0faa6af,https://au-api.basiq.io/institutions/AU00000,,Accommodation,440
transaction,18980173-91dd-41c0-b333-eea3ed4831ee,posted,Birchwood Cafe Jindabyne AU,-84.00,49544383-c19c-4c97-b8d1-5322d0faa6af,-2663.32,debit,payment,AU00000,5453f0a3-083c-43c6-9086-adfe94df9918,,,2022-05-18T00:00:00Z,,https://au-api.basiq.io/users/11103cba-4a08-4397-84a5-22ac125ed2f6/transactions/18980173-91dd-41c0-b333-eea3ed4831ee,https://au-api.basiq.io/users/11103cba-4a08-4397-84a5-22ac125ed2f6/accounts/49544383-c19c-4c97-b8d1-5322d0faa6af,https://au-api.basiq.io/institutions/AU00000,,"Cafes, Restaurants and Takeaway Food Services",451
transaction,4e3461b4-76eb-4175-a1bc-1cd0ae8bfa8b,posted,LAKES ENTRANCE FOOD LAKE,-70.50,49544383-c19c-4c97-b8d1-5322d0faa6af,-2579.32,debit,payment,AU00000,5453f0a3-083c-43c6-9086-adfe94df9918,,,2022-05-17T00:00:00Z,,https://au-api.basiq.io/users/11103cba-4a08-4397-84a5-22ac125ed2f6/transactions/4e3461b4-76eb-4175-a1bc-1cd0ae8bfa8b,https://au-api.basiq.io/users/11103cba-4a08-4397-84a5-22ac125ed2f6/accounts/49544383-c19c-4c97-b8d1-5322d0faa6af,https://au-api.basiq.io/institutions/AU00000,,Supermarket and Grocery Stores,411
transaction,a8f1ffff-5ea4-4422-a207-752476137460,posted,LAKES SQUASH& MOVIE LAKES E,-53.00,49544383-c19c-4c97-b8d1-5322d0faa6af,-2508.82,debit,payment,AU00000,5453f0a3-083c-43c6-9086-adfe94df9918,,,2022-05-17T00:00:00Z,,https://au-api.basiq.io/users/11103cba-4a08-4397-84a5-22ac125ed2f6/transactions/a8f1ffff-5ea4-4422-a207-752476137460,https://au-api.basiq.io/users/11103cba-4a08-4397-84a5-22ac125ed2f6/accounts/49544383-c19c-4c97-b8d1-5322d0faa6af,https://au-api.basiq.io/institutions/AU00000,,Motion Picture and Video Activities,551
transaction,4d7cfe2a-5f34-453b-84f3-3daf1061d071,posted,THREDBO ALPINE HOTEL THREDBO AU,-55.00,49544383-c19c-4c97-b8d1-5322d0faa6af,-2455.82,debit,payment,AU00000,5453f0a3-083c-43c6-9086-adfe94df9918,,,2022-05-17T00:00:00Z,,https://au-api.basiq.io/users/11103cba-4a08-4397-84a5-22ac125ed2f6/transactions/4d7cfe2a-5f34-453b-84f3-3daf1061d071,https://au-api.basiq.io/users/11103cba-4a08-4397-84a5-22ac125ed2f6/accounts/49544383-c19c-4c97-b8d1-5322d0faa6af,https://au-api.basiq.io/institutions/AU00000,,Accommodation,440
transaction,2e2474e7-c42a-4750-831f-722b65cc96b8,posted,THREDBO SUPERMARKET THREDBO NSWAU,-59.27,49544383-c19c-4c97-b8d1-5322d0faa6af,-2400.82,debit,payment,AU00000,5453f0a3-083c-43c6-9086-adfe94df9918,,,2022-05-17T00:00:00Z,,https://au-api.basiq.io/users/11103cba-4a08-4397-84a5-22ac125ed2f6/transactions/2e2474e7-c42a-4750-831f-722b65cc96b8,https://au-api.basiq.io/users/11103cba-4a08-4397-84a5-22ac125ed2f6/accounts/49544383-c19c-4c97-b8d1-5322d0faa6af,https://au-api.basiq.io/institutions/AU00000,,Supermarket and Grocery Stores,411
transaction,c833c757-5961-4f2d-adb9-84f8b2cec883,posted,THREDBO SUPERMARKET THREDBO NSWAU,-18.40,49544383-c19c-4c97-b8d1-5322d0faa6af,-2341.55,debit,payment,AU00000,5453f0a3-083c-43c6-9086-adfe94df9918,,,2022-05-17T00:00:00Z,,https://au-api.basiq.io/users/11103cba-4a08-4397-84a5-22ac125ed2f6/transactions/c833c757-5961-4f2d-adb9-84f8b2cec883,https://au-api.basiq.io/users/11103cba-4a08-4397-84a5-22ac125ed2f6/accounts/49544383-c19c-4c97-b8d1-5322d0faa6af,https://au-api.basiq.io/institutions/AU00000,,Supermarket and Grocery Stores,411
transaction,a3da8b82-ec85-4443-8d75-4c27077f38ed,posted,KOSCIUSZKO THREDBO THREDBO AU,-71.00,49544383-c19c-4c97-b8d1-5322d0faa6af,-2323.15,debit,payment,AU00000,5453f0a3-083c-43c6-9086-adfe94df9918,,,2022-05-16T00:00:00Z,,https://au-api.basiq.io/users/11103cba-4a08-4397-84a5-22ac125ed2f6/transactions/a3da8b82-ec85-4443-8d75-4c27077f38ed,https://au-api.basiq.io/users/11103cba-4a08-4397-84a5-22ac125ed2f6/accounts/49544383-c19c-4c97-b8d1-5322d0faa6af,https://au-api.basiq.io/institutions/AU00000,,Accommodation,440
transaction,4e67c172-8a30-4435-ae86-d56d8fe8f3f4,posted,THREDBO ALPINE HOTEL THREDBO AU,-18.00,49544383-c19c-4c97-b8d1-5322d0faa6af,-2252.15,debit,payment,AU00000,5453f0a3-083c-43c6-9086-adfe94df9918,,,2022-05-16T00:00:00Z,,https://au-api.basiq.io/users/11103cba-4a08-4397-84a5-22ac125ed2f6/transactions/4e67c172-8a30-4435-ae86-d56d8fe8f3f4,https://au-api.basiq.io/users/11103cba-4a08-4397-84a5-22ac125ed2f6/accounts/49544383-c19c-4c97-b8d1-5322d0faa6af,https://au-api.basiq.io/institutions/AU00000,,Accommodation,440
transaction,673e4db1-60d8-4939-b31d-6fb2ed9985d3,posted,WOOLWORTHS 1401 JIND,-114.17,49544383-c19c-4c97-b8d1-5322d0faa6af,-2234.15,debit,payment,AU00000,5453f0a3-083c-43c6-9086-adfe94df9918,,,2022-05-16T00:00:00Z,,https://au-api.basiq.io/users/11103cba-4a08-4397-84a5-22ac125ed2f6/transactions/673e4db1-60d8-4939-b31d-6fb2ed9985d3,https://au-api.basiq.io/users/11103cba-4a08-4397-84a5-22ac125ed2f6/accounts/49544383-c19c-4c97-b8d1-5322d0faa6af,https://au-api.basiq.io/institutions/AU00000,,Supermarket and Grocery Stores,411
transaction,7231e9a7-4c7b-4b15-9a29-d0aadc3aa47d,posted,Birchwood Cafe Jind,-92.00,49544383-c19c-4c97-b8d1-5322d0faa6af,-2119.98,debit,payment,AU00000,5453f0a3-083c-43c6-9086-adfe94df9918,,,2022-05-16T00:00:00Z,,https://au-api.basiq.io/users/11103cba-4a08-4397-84a5-22ac125ed2f6/transactions/7231e9a7-4c7b-4b15-9a29-d0aadc3aa47d,https://au-api.basiq.io/users/11103cba-4a08-4397-84a5-22ac125ed2f6/accounts/49544383-c19c-4c97-b8d1-5322d0faa6af,https://au-api.basiq.io/institutions/AU00000,,"Cafes, Restaurants and Takeaway Food Services",451
transaction,b28b48ed-9afc-4be0-9fb4-cb6b38b64ddc,posted,THE FUNKEY MONKEY BAKE LAKE,-73.00,49544383-c19c-4c97-b8d1-5322d0faa6af,-2027.98,debit,payment,AU00000,5453f0a3-083c-43c6-9086-adfe94df9918,,,2022-05-16T00:00:00Z,,https://au-api.basiq.io/users/11103cba-4a08-4397-84a5-22ac125ed2f6/transactions/b28b48ed-9afc-4be0-9fb4-cb6b38b64ddc,https://au-api.basiq.io/users/11103cba-4a08-4397-84a5-22ac125ed2f6/accounts/49544383-c19c-4c97-b8d1-5322d0faa6af,https://au-api.basiq.io/institutions/AU00000,,"Cafes, Restaurants and Takeaway Food Services",451
transaction,ca62a632-9387-469e-83cd-b6f1dbd35e2a,posted,ECHO BEACH TOURIST PAR LAKE,-60.00,49544383-c19c-4c97-b8d1-5322d0faa6af,-1954.98,debit,payment,AU00000,5453f0a3-083c-43c6-9086-adfe94df9918,,,2022-05-16T00:00:00Z,,https://au-api.basiq.io/users/11103cba-4a08-4397-84a5-22ac125ed2f6/transactions/ca62a632-9387-469e-83cd-b6f1dbd35e2a,https://au-api.basiq.io/users/11103cba-4a08-4397-84a5-22ac125ed2f6/accounts/49544383-c19c-4c97-b8d1-5322d0faa6af,https://au-api.basiq.io/institutions/AU00000,,Accommodation,440
transaction,1e5dca28-c55f-4025-a780-4b9690613767,posted,TARGETC 6503 LKS,-21.00,49544383-c19c-4c97-b8d1-5322d0faa6af,-1894.98,debit,payment,AU00000,5453f0a3-083c-43c6-9086-adfe94df9918,,,2022-05-16T00:00:00Z,,https://au-api.basiq.io/users/11103cba-4a08-4397-84a5-22ac125ed2f6/transactions/1e5dca28-c55f-4025-a780-4b9690613767,https://au-api.basiq.io/users/11103cba-4a08-4397-84a5-22ac125ed2f6/accounts/49544383-c19c-4c97-b8d1-5322d0faa6af,https://au-api.basiq.io/institutions/AU00000,,Department Stores,426
transaction,f31ce3d6-38b8-41b2-8aae-7dd07be5bdbb,posted,THE FUNKEY MONKEY BAKE LAKE,-6.50,49544383-c19c-4c97-b8d1-5322d0faa6af,-1873.98,debit,payment,AU00000,5453f0a3-083c-43c6-9086-adfe94df9918,,,2022-05-16T00:00:00Z,,https://au-api.basiq.io/users/11103cba-4a08-4397-84a5-22ac125ed2f6/transactions/f31ce3d6-38b8-41b2-8aae-7dd07be5bdbb,https://au-api.basiq.io/users/11103cba-4a08-4397-84a5-22ac125ed2f6/accounts/49544383-c19c-4c97-b8d1-5322d0faa6af,https://au-api.basiq.io/institutions/AU00000,,"Cafes, Restaurants and Takeaway Food Services",451
transaction,a3e72c91-3c61-40d9-bd97-d5b1ec197472,posted,WOOLWORTHS 1401 JINDABYNE NSW AU,-49.00,49544383-c19c-4c97-b8d1-5322d0faa6af,-1867.48,debit,payment,AU00000,5453f0a3-083c-43c6-9086-adfe94df9918,,,2022-05-16T00:00:00Z,,https://au-api.basiq.io/users/11103cba-4a08-4397-84a5-22ac125ed2f6/transactions/a3e72c91-3c61-40d9-bd97-d5b1ec197472,https://au-api.basiq.io/users/11103cba-4a08-4397-84a5-22ac125ed2f6/accounts/49544383-c19c-4c97-b8d1-5322d0faa6af,https://au-api.basiq.io/institutions/AU00000,,Supermarket and Grocery Stores,411
transaction,47146646-67c2-4813-864f-29be7c1b3e27,posted,OPTUS PREPAID MELBOURN,-40.00,49544383-c19c-4c97-b8d1-5322d0faa6af,-1818.48,debit,payment,AU00000,5453f0a3-083c-43c6-9086-adfe94df9918,,,2022-05-16T00:00:00Z,,https://au-api.basiq.io/users/11103cba-4a08-4397-84a5-22ac125ed2f6/transactions/47146646-67c2-4813-864f-29be7c1b3e27,https://au-api.basiq.io/users/11103cba-4a08-4397-84a5-22ac125ed2f6/accounts/49544383-c19c-4c97-b8d1-5322d0faa6af,https://au-api.basiq.io/institutions/AU00000,,Telecommunications Services,580
transaction,ccfd215f-628e-43b4-ab27-ce1c7286bd81,posted,RITCHIES SUPA IGA AND LIQBRIG,-14.10,49544383-c19c-4c97-b8d1-5322d0faa6af,-1778.48,debit,payment,AU00000,5453f0a3-083c-43c6-9086-adfe94df9918,,,2022-05-15T00:00:00Z,,https://au-api.basiq.io/users/11103cba-4a08-4397-84a5-22ac125ed2f6/transactions/ccfd215f-628e-43b4-ab27-ce1c7286bd81,https://au-api.basiq.io/users/11103cba-4a08-4397-84a5-22ac125ed2f6/accounts/49544383-c19c-4c97-b8d1-5322d0faa6af,https://au-api.basiq.io/institutions/AU00000,,Supermarket and Grocery Stores,411
transaction,8013b766-54d6-4e9a-9da4-a444faabeba1,posted,WOOLWORTHS 3126 LAKES ENTRNC VIC AU,-24.00,49544383-c19c-4c97-b8d1-5322d0faa6af,-1764.38,debit,payment,AU00000,5453f0a3-083c-43c6-9086-adfe94df9918,,,2022-05-15T00:00:00Z,,https://au-api.basiq.io/users/11103cba-4a08-4397-84a5-22ac125ed2f6/transactions/8013b766-54d6-4e9a-9da4-a444faabeba1,https://au-api.basiq.io/users/11103cba-4a08-4397-84a5-22ac125ed2f6/accounts/49544383-c19c-4c97-b8d1-5322d0faa6af,https://au-api.basiq.io/institutions/AU00000,,Supermarket and Grocery Stores,411
transaction,047234cf-24fd-47de-bb7c-a962866ab8f6,posted,CALTEX LAKES ENTRANC LAKES ENTRANCAU,-215.34,49544383-c19c-4c97-b8d1-5322d0faa6af,-1740.38,debit,payment,AU00000,5453f0a3-083c-43c6-9086-adfe94df9918,,,2022-05-15T00:00:00Z,,https://au-api.basiq.io/users/11103cba-4a08-4397-84a5-22ac125ed2f6/transactions/047234cf-24fd-47de-bb7c-a962866ab8f6,https://au-api.basiq.io/users/11103cba-4a08-4397-84a5-22ac125ed2f6/accounts/49544383-c19c-4c97-b8d1-5322d0faa6af,https://au-api.basiq.io/institutions/AU00000,,Fuel Retailing,400
transaction,b707789c-117d-42c9-9749-daf2038f1bcb,posted,FLOATING DRAGON LAKES ENTRANC AU,-174.50,49544383-c19c-4c97-b8d1-5322d0faa6af,-1525.04,debit,payment,AU00000,5453f0a3-083c-43c6-9086-adfe94df9918,,,2022-05-14T00:00:00Z,,https://au-api.basiq.io/users/11103cba-4a08-4397-84a5-22ac125ed2f6/transactions/b707789c-117d-42c9-9749-daf2038f1bcb,https://au-api.basiq.io/users/11103cba-4a08-4397-84a5-22ac125ed2f6/accounts/49544383-c19c-4c97-b8d1-5322d0faa6af,https://au-api.basiq.io/institutions/AU00000,,"Cafes, Restaurants and Takeaway Food Services",451
transaction,78d3afcb-2319-4095-92ab-7414bc8cc892,posted,ECHO BEACH TOURIST P AR LAKES ENTRANCAU,-51.00,49544383-c19c-4c97-b8d1-5322d0faa6af,-1350.54,debit,payment,AU00000,5453f0a3-083c-43c6-9086-adfe94df9918,,,2022-05-13T00:00:00Z,,https://au-api.basiq.io/users/11103cba-4a08-4397-84a5-22ac125ed2f6/transactions/78d3afcb-2319-4095-92ab-7414bc8cc892,https://au-api.basiq.io/users/11103cba-4a08-4397-84a5-22ac125ed2f6/accounts/49544383-c19c-4c97-b8d1-5322d0faa6af,https://au-api.basiq.io/institutions/AU00000,,Accommodation,440
transaction,33a0689e-131a-4b7b-a9d4-b7272ae668a9,posted,FROGGY'S BISTRO LAKES ENTRANCVICAU,-155.50,49544383-c19c-4c97-b8d1-5322d0faa6af,-1299.54,debit,payment,AU00000,5453f0a3-083c-43c6-9086-adfe94df9918,,,2022-05-13T00:00:00Z,,https://au-api.basiq.io/users/11103cba-4a08-4397-84a5-22ac125ed2f6/transactions/33a0689e-131a-4b7b-a9d4-b7272ae668a9,https://au-api.basiq.io/users/11103cba-4a08-4397-84a5-22ac125ed2f6/accounts/49544383-c19c-4c97-b8d1-5322d0faa6af,https://au-api.basiq.io/institutions/AU00000,,"Cafes, Restaurants and Takeaway Food Services",451
transaction,0084e23f-23d0-4189-86b9-e44e5e84821e,posted,MOUNTAIN KITCHEN PL DINNER PLAIN AU,-52.50,49544383-c19c-4c97-b8d1-5322d0faa6af,-1144.04,debit,payment,AU00000,5453f0a3-083c-43c6-9086-adfe94df9918,,,2022-05-13T00:00:00Z,,https://au-api.basiq.io/users/11103cba-4a08-4397-84a5-22ac125ed2f6/transactions/0084e23f-23d0-4189-86b9-e44e5e84821e,https://au-api.basiq.io/users/11103cba-4a08-4397-84a5-22ac125ed2f6/accounts/49544383-c19c-4c97-b8d1-5322d0faa6af,https://au-api.basiq.io/institutions/AU00000,,"Cafes, Restaurants and Takeaway Food Services",451
transaction,e88cd61c-70dd-42fc-9f2d-a0a9de266ce5,posted,RITCHIES SUPA IGA AND LIQBRIG,-13.98,49544383-c19c-4c97-b8d1-5322d0faa6af,-1091.54,debit,payment,AU00000,5453f0a3-083c-43c6-9086-adfe94df9918,,,2022-05-12T00:00:00Z,,https://au-api.basiq.io/users/11103cba-4a08-4397-84a5-22ac125ed2f6/transactions/e88cd61c-70dd-42fc-9f2d-a0a9de266ce5,https://au-api.basiq.io/users/11103cba-4a08-4397-84a5-22ac125ed2f6/accounts/49544383-c19c-4c97-b8d1-5322d0faa6af,https://au-api.basiq.io/institutions/AU00000,,Supermarket and Grocery Stores,411
transaction,e929515c-d547-413d-914c-d741f6bc5eb9,posted,Bright Brewery Bright AU,-86.20,49544383-c19c-4c97-b8d1-5322d0faa6af,-1077.56,debit,payment,AU00000,5453f0a3-083c-43c6-9086-adfe94df9918,,,2022-05-12T00:00:00Z,,https://au-api.basiq.io/users/11103cba-4a08-4397-84a5-22ac125ed2f6/transactions/e929515c-d547-413d-914c-d741f6bc5eb9,https://au-api.basiq.io/users/11103cba-4a08-4397-84a5-22ac125ed2f6/accounts/49544383-c19c-4c97-b8d1-5322d0faa6af,https://au-api.basiq.io/institutions/AU00000,,"Pubs, Taverns and Bars",452
transaction,5c1dd250-d58c-4e24-8e95-4601e07a3cad,posted,OUTDOOR CENTRE BRIG,-87.95,49544383-c19c-4c97-b8d1-5322d0faa6af,-991.36,debit,payment,AU00000,5453f0a3-083c-43c6-9086-adfe94df9918,,,2022-05-11T00:00:00Z,,https://au-api.basiq.io/users/11103cba-4a08-4397-84a5-22ac125ed2f6/transactions/5c1dd250-d58c-4e24-8e95-4601e07a3cad,https://au-api.basiq.io/users/11103cba-4a08-4397-84a5-22ac125ed2f6/accounts/49544383-c19c-4c97-b8d1-5322d0faa6af,https://au-api.basiq.io/institutions/AU00000,,Unknown,0
transaction,d76805ee-0f00-42b1-a33c-ffe9f8035563,posted,IGA MANSFIELD MANS,-33.36,49544383-c19c-4c97-b8d1-5322d0faa6af,-903.41,debit,payment,AU00000,5453f0a3-083c-43c6-9086-adfe94df9918,,,2022-05-11T00:00:00Z,,https://au-api.basiq.io/users/11103cba-4a08-4397-84a5-22ac125ed2f6/transactions/d76805ee-0f00-42b1-a33c-ffe9f8035563,https://au-api.basiq.io/users/11103cba-4a08-4397-84a5-22ac125ed2f6/accounts/49544383-c19c-4c97-b8d1-5322d0faa6af,https://au-api.basiq.io/institutions/AU00000,,Supermarket and Grocery Stores,411
transaction,a67e6602-615d-49ba-ae48-9e14db5aa466,posted,RITCHIES SUPA IGA & BRIGHT AU,-21.50,49544383-c19c-4c97-b8d1-5322d0faa6af,-870.05,debit,payment,AU00000,5453f0a3-083c-43c6-9086-adfe94df9918,,,2022-05-11T00:00:00Z,,https://au-api.basiq.io/users/11103cba-4a08-4397-84a5-22ac125ed2f6/transactions/a67e6602-615d-49ba-ae48-9e14db5aa466,https://au-api.basiq.io/users/11103cba-4a08-4397-84a5-22ac125ed2f6/accounts/49544383-c19c-4c97-b8d1-5322d0faa6af,https://au-api.basiq.io/institutions/AU00000,,Supermarket and Grocery Stores,411
transaction,fb3f3a92-546b-47c3-881f-99457c99fd5b,posted,JNB MCCABE PTY LTD FREEBURGH AU,-81.00,49544383-c19c-4c97-b8d1-5322d0faa6af,-848.55,debit,payment,AU00000,5453f0a3-083c-43c6-9086-adfe94df9918,,,2022-05-11T00:00:00Z,,https://au-api.basiq.io/users/11103cba-4a08-4397-84a5-22ac125ed2f6/transactions/fb3f3a92-546b-47c3-881f-99457c99fd5b,https://au-api.basiq.io/users/11103cba-4a08-4397-84a5-22ac125ed2f6/accounts/49544383-c19c-4c97-b8d1-5322d0faa6af,https://au-api.basiq.io/institutions/AU00000,,Accommodation,440
transaction,6d2f2e86-3927-4e58-892f-c1a50d880621,posted,Walhalla General Store WALH,-50.00,49544383-c19c-4c97-b8d1-5322d0faa6af,-767.55,debit,payment,AU00000,5453f0a3-083c-43c6-9086-adfe94df9918,,,2022-05-10T00:00:00Z,,https://au-api.basiq.io/users/11103cba-4a08-4397-84a5-22ac125ed2f6/transactions/6d2f2e86-3927-4e58-892f-c1a50d880621,https://au-api.basiq.io/users/11103cba-4a08-4397-84a5-22ac125ed2f6/accounts/49544383-c19c-4c97-b8d1-5322d0faa6af,https://au-api.basiq.io/institutions/AU00000,,Specialised Food Retailing,412
transaction,b2ffb5d5-26ca-4555-a79e-599b69aee8fe,posted,CHRISMONT WINES CHESHUNT AU,-110.00,49544383-c19c-4c97-b8d1-5322d0faa6af,-717.55,debit,payment,AU00000,5453f0a3-083c-43c6-9086-adfe94df9918,,,2022-05-10T00:00:00Z,,https://au-api.basiq.io/users/11103cba-4a08-4397-84a5-22ac125ed2f6/transactions/b2ffb5d5-26ca-4555-a79e-599b69aee8fe,https://au-api.basiq.io/users/11103cba-4a08-4397-84a5-22ac125ed2f6/accounts/49544383-c19c-4c97-b8d1-5322d0faa6af,https://au-api.basiq.io/institutions/AU00000,,"Cafes, Restaurants and Takeaway Food Services",451
transaction,ca635cf1-a6ce-4259-b312-a8e1daa6b039,posted,BP MANSFIELD 2474 MANSFIELD AU,-17.75,49544383-c19c-4c97-b8d1-5322d0faa6af,-607.55,debit,payment,AU00000,5453f0a3-083c-43c6-9086-adfe94df9918,,,2022-05-09T00:00:00Z,,https://au-api.basiq.io/users/11103cba-4a08-4397-84a5-22ac125ed2f6/transactions/ca635cf1-a6ce-4259-b312-a8e1daa6b039,https://au-api.basiq.io/users/11103cba-4a08-4397-84a5-22ac125ed2f6/accounts/49544383-c19c-4c97-b8d1-5322d0faa6af,https://au-api.basiq.io/institutions/AU00000,,Fuel Retailing,400
transaction,707ccd1d-09ed-42fd-90e9-9131841f3a64,posted,WALHALLA GOLDFIELDSRWY WALH,-51.00,49544383-c19c-4c97-b8d1-5322d0faa6af,-589.80,debit,payment,AU00000,5453f0a3-083c-43c6-9086-adfe94df9918,,,2022-05-09T00:00:00Z,,https://au-api.basiq.io/users/11103cba-4a08-4397-84a5-22ac125ed2f6/transactions/707ccd1d-09ed-42fd-90e9-9131841f3a64,https://au-api.basiq.io/users/11103cba-4a08-4397-84a5-22ac125ed2f6/accounts/49544383-c19c-4c97-b8d1-5322d0faa6af,https://au-api.basiq.io/institutions/AU00000,,Amusement and Other Recreation Activities,913
transaction,a65031f6-bc82-43aa-9ac1-80ec7c0966bf,posted,RAWSON CARAVAN PK RAWS,-37.50,49544383-c19c-4c97-b8d1-5322d0faa6af,-538.80,debit,payment,AU00000,5453f0a3-083c-43c6-9086-adfe94df9918,,,2022-05-09T00:00:00Z,,https://au-api.basiq.io/users/11103cba-4a08-4397-84a5-22ac125ed2f6/transactions/a65031f6-bc82-43aa-9ac1-80ec7c0966bf,https://au-api.basiq.io/users/11103cba-4a08-4397-84a5-22ac125ed2f6/accounts/49544383-c19c-4c97-b8d1-5322d0faa6af,https://au-api.basiq.io/institutions/AU00000,,Accommodation,440
transaction,e3722739-645e-4f38-babe-e8c54eb5b0fa,posted,SAFEWAY 3266 BALL,-36.50,49544383-c19c-4c97-b8d1-5322d0faa6af,-501.30,debit,payment,AU00000,5453f0a3-083c-43c6-9086-adfe94df9918,,,2022-05-09T00:00:00Z,,https://au-api.basiq.io/users/11103cba-4a08-4397-84a5-22ac125ed2f6/transactions/e3722739-645e-4f38-babe-e8c54eb5b0fa,https://au-api.basiq.io/users/11103cba-4a08-4397-84a5-22ac125ed2f6/accounts/49544383-c19c-4c97-b8d1-5322d0faa6af,https://au-api.basiq.io/institutions/AU00000,,Supermarket and Grocery Stores,411
transaction,543d92e1-0e5e-4121-8b0c-5938afa1fd09,posted,CAREFIELD PTY LTD SMYT,-20.20,49544383-c19c-4c97-b8d1-5322d0faa6af,-464.80,debit,payment,AU00000,5453f0a3-083c-43c6-9086-adfe94df9918,,,2022-05-09T00:00:00Z,,https://au-api.basiq.io/users/11103cba-4a08-4397-84a5-22ac125ed2f6/transactions/543d92e1-0e5e-4121-8b0c-5938afa1fd09,https://au-api.basiq.io/users/11103cba-4a08-4397-84a5-22ac125ed2f6/accounts/49544383-c19c-4c97-b8d1-5322d0faa6af,https://au-api.basiq.io/institutions/AU00000,,Specialised Food Retailing,412
transaction,5071ea12-0747-4b23-bca6-b38ff92a1a94,posted,SMYTHESDALE FOOD & LIQ SMYT,-15.46,49544383-c19c-4c97-b8d1-5322d0faa6af,-444.60,debit,payment,AU00000,5453f0a3-083c-43c6-9086-adfe94df9918,,,2022-05-09T00:00:00Z,,https://au-api.basiq.io/users/11103cba-4a08-4397-84a5-22ac125ed2f6/transactions/5071ea12-0747-4b23-bca6-b38ff92a1a94,https://au-api.basiq.io/users/11103cba-4a08-4397-84a5-22ac125ed2f6/accounts/49544383-c19c-4c97-b8d1-5322d0faa6af,https://au-api.basiq.io/institutions/AU00000,,Supermarket and Grocery Stores,411
transaction,ada503a6-d815-4196-815f-abebb87c895a,posted,WALHALLA GOLDFIELDSRWY WALH,-15.00,49544383-c19c-4c97-b8d1-5322d0faa6af,-429.14,debit,payment,AU00000,5453f0a3-083c-43c6-9086-adfe94df9918,,,2022-05-09T00:00:00Z,,https://au-api.basiq.io/users/11103cba-4a08-4397-84a5-22ac125ed2f6/transactions/ada503a6-d815-4196-815f-abebb87c895a,https://au-api.basiq.io/users/11103cba-4a08-4397-84a5-22ac125ed2f6/accounts/49544383-c19c-4c97-b8d1-5322d0faa6af,https://au-api.basiq.io/institutions/AU00000,,Amusement and Other Recreation Activities,913
transaction,27e4245e-fa05-4ee0-be6b-bbbfc608d945,posted,SMYTHESDALE FOOD & LIQ SMYT,-8.54,49544383-c19c-4c97-b8d1-5322d0faa6af,-414.14,debit,payment,AU00000,5453f0a3-083c-43c6-9086-adfe94df9918,,,2022-05-09T00:00:00Z,,https://au-api.basiq.io/users/11103cba-4a08-4397-84a5-22ac125ed2f6/transactions/27e4245e-fa05-4ee0-be6b-bbbfc608d945,https://au-api.basiq.io/users/11103cba-4a08-4397-84a5-22ac125ed2f6/accounts/49544383-c19c-4c97-b8d1-5322d0faa6af,https://au-api.basiq.io/institutions/AU00000,,Supermarket and Grocery Stores,411
transaction,00097402-faad-4db3-aa9b-2534505bc71c,posted,SAFEWAY 3266 BALL,-6.98,49544383-c19c-4c97-b8d1-5322d0faa6af,-405.60,debit,payment,AU00000,5453f0a3-083c-43c6-9086-adfe94df9918,,,2022-05-09T00:00:00Z,,https://au-api.basiq.io/users/11103cba-4a08-4397-84a5-22ac125ed2f6/transactions/00097402-faad-4db3-aa9b-2534505bc71c,https://au-api.basiq.io/users/11103cba-4a08-4397-84a5-22ac125ed2f6/accounts/49544383-c19c-4c97-b8d1-5322d0faa6af,https://au-api.basiq.io/institutions/AU00000,,Supermarket and Grocery Stores,411
transaction,8126d12e-fe5b-44a6-b1ca-5a68574c00ed,posted,RAWSON CARAVAN PK RAWSON,-37.00,49544383-c19c-4c97-b8d1-5322d0faa6af,-398.62,debit,payment,AU00000,5453f0a3-083c-43c6-9086-adfe94df9918,,,2022-05-08T00:00:00Z,,https://au-api.basiq.io/users/11103cba-4a08-4397-84a5-22ac125ed2f6/transactions/8126d12e-fe5b-44a6-b1ca-5a68574c00ed,https://au-api.basiq.io/users/11103cba-4a08-4397-84a5-22ac125ed2f6/accounts/49544383-c19c-4c97-b8d1-5322d0faa6af,https://au-api.basiq.io/institutions/AU00000,,Accommodation,440
transaction,aac98794-e1a6-40d8-b10c-44cd5a6334d6,posted,DELAWARE NORTH VENUE BALL,-74.00,49544383-c19c-4c97-b8d1-5322d0faa6af,-361.62,debit,payment,AU00000,5453f0a3-083c-43c6-9086-adfe94df9918,,,2022-05-08T00:00:00Z,,https://au-api.basiq.io/users/11103cba-4a08-4397-84a5-22ac125ed2f6/transactions/aac98794-e1a6-40d8-b10c-44cd5a6334d6,https://au-api.basiq.io/users/11103cba-4a08-4397-84a5-22ac125ed2f6/accounts/49544383-c19c-4c97-b8d1-5322d0faa6af,https://au-api.basiq.io/institutions/AU00000,,"Cafes, Restaurants and Takeaway Food Services",451
transaction,2abeaf6c-5dc6-4645-a11f-90b3125e6df2,posted,SMYTHESDALE FOOD & LIQ SMYT,-7.85,49544383-c19c-4c97-b8d1-5322d0faa6af,-287.62,debit,payment,AU00000,5453f0a3-083c-43c6-9086-adfe94df9918,,,2022-05-08T00:00:00Z,,https://au-api.basiq.io/users/11103cba-4a08-4397-84a5-22ac125ed2f6/transactions/2abeaf6c-5dc6-4645-a11f-90b3125e6df2,https://au-api.basiq.io/users/11103cba-4a08-4397-84a5-22ac125ed2f6/accounts/49544383-c19c-4c97-b8d1-5322d0faa6af,https://au-api.basiq.io/institutions/AU00000,,Supermarket and Grocery Stores,411
transaction,7e795970-0ea2-4101-ba34-464451b72383,posted,COLES EXPRESS 1898 MOE AU,-113.57,49544383-c19c-4c97-b8d1-5322d0faa6af,-279.77,debit,payment,AU00000,5453f0a3-083c-43c6-9086-adfe94df9918,,,2022-05-07T00:00:00Z,,https://au-api.basiq.io/users/11103cba-4a08-4397-84a5-22ac125ed2f6/transactions/7e795970-0ea2-4101-ba34-464451b72383,https://au-api.basiq.io/users/11103cba-4a08-4397-84a5-22ac125ed2f6/accounts/49544383-c19c-4c97-b8d1-5322d0faa6af,https://au-api.basiq.io/institutions/AU00000,,Fuel Retailing,400
transaction,f0d0e016-b0a3-4cea-97a4-ff3c4d58f343,posted,WOOLWORTHS 3266 SEBASTOPOL VIC AU,-259.15,49544383-c19c-4c97-b8d1-5322d0faa6af,-166.20,debit,payment,AU00000,5453f0a3-083c-43c6-9086-adfe94df9918,,,2022-05-07T00:00:00Z,,https://au-api.basiq.io/users/11103cba-4a08-4397-84a5-22ac125ed2f6/transactions/f0d0e016-b0a3-4cea-97a4-ff3c4d58f343,https://au-api.basiq.io/users/11103cba-4a08-4397-84a5-22ac125ed2f6/accounts/49544383-c19c-4c97-b8d1-5322d0faa6af,https://au-api.basiq.io/institutions/AU00000,,Supermarket and Grocery Stores,411
transaction,cc39161d-5947-4641-817a-90e6918c23c2,posted,SMYTHESDALE FOOD & L IQ SMYTHESDALE AU,-60.87,49544383-c19c-4c97-b8d1-5322d0faa6af,92.95,debit,payment,AU00000,5453f0a3-083c-43c6-9086-adfe94df9918,,,2022-05-06T00:00:00Z,,https://au-api.basiq.io/users/11103cba-4a08-4397-84a5-22ac125ed2f6/transactions/cc39161d-5947-4641-817a-90e6918c23c2,https://au-api.basiq.io/users/11103cba-4a08-4397-84a5-22ac125ed2f6/accounts/49544383-c19c-4c97-b8d1-5322d0faa6af,https://au-api.basiq.io/institutions/AU00000,,Supermarket and Grocery Stores,411
transaction,244a379d-56fd-41c7-8662-ec27f34a21ae,posted,DELAWARE NORTH VENUE BALL,-74.90,49544383-c19c-4c97-b8d1-5322d0faa6af,153.82,debit,payment,AU00000,5453f0a3-083c-43c6-9086-adfe94df9918,,,2022-05-05T00:00:00Z,,https://au-api.basiq.io/users/11103cba-4a08-4397-84a5-22ac125ed2f6/transactions/244a379d-56fd-41c7-8662-ec27f34a21ae,https://au-api.basiq.io/users/11103cba-4a08-4397-84a5-22ac125ed2f6/accounts/49544383-c19c-4c97-b8d1-5322d0faa6af,https://au-api.basiq.io/institutions/AU00000,,"Cafes, Restaurants and Takeaway Food Services",451
transaction,5991b7d6-81dd-4c75-b8a4-6e0fc6f576cf,posted,SOVEREIGN HILL BALL,-21.00,49544383-c19c-4c97-b8d1-5322d0faa6af,228.72,debit,payment,AU00000,5453f0a3-083c-43c6-9086-adfe94df9918,,,2022-05-05T00:00:00Z,,https://au-api.basiq.io/users/11103cba-4a08-4397-84a5-22ac125ed2f6/transactions/5991b7d6-81dd-4c75-b8a4-6e0fc6f576cf,https://au-api.basiq.io/users/11103cba-4a08-4397-84a5-22ac125ed2f6/accounts/49544383-c19c-4c97-b8d1-5322d0faa6af,https://au-api.basiq.io/institutions/AU00000,,Amusement and Other Recreation Activities,913
transaction,f5bebb82-fccf-4a1f-8f89-db0aa7383fb1,posted,SOVEREIGN HILL BALL,-12.50,49544383-c19c-4c97-b8d1-5322d0faa6af,249.72,debit,payment,AU00000,5453f0a3-083c-43c6-9086-adfe94df9918,,,2022-05-05T00:00:00Z,,https://au-api.basiq.io/users/11103cba-4a08-4397-84a5-22ac125ed2f6/transactions/f5bebb82-fccf-4a1f-8f89-db0aa7383fb1,https://au-api.basiq.io/users/11103cba-4a08-4397-84a5-22ac125ed2f6/accounts/49544383-c19c-4c97-b8d1-5322d0faa6af,https://au-api.basiq.io/institutions/AU00000,,Amusement and Other Recreation Activities,913
transaction,68d27703-7936-4e8b-8770-46e7d48f590c,posted,BROWN GRAIN THAI RES BALLARAT AU,-76.80,49544383-c19c-4c97-b8d1-5322d0faa6af,262.22,debit,payment,AU00000,5453f0a3-083c-43c6-9086-adfe94df9918,,,2022-05-05T00:00:00Z,,https://au-api.basiq.io/users/11103cba-4a08-4397-84a5-22ac125ed2f6/transactions/68d27703-7936-4e8b-8770-46e7d48f590c,https://au-api.basiq.io/users/11103cba-4a08-4397-84a5-22ac125ed2f6/accounts/49544383-c19c-4c97-b8d1-5322d0faa6af,https://au-api.basiq.io/institutions/AU00000,,"Cafes, Restaurants and Takeaway Food Services",451
transaction,0b31ba42-88db-461a-b80a-f3fb20cf44f6,posted,GUM SAN HERITAGE CTR ARAR,-33.00,49544383-c19c-4c97-b8d1-5322d0faa6af,339.02,debit,payment,AU00000,5453f0a3-083c-43c6-9086-adfe94df9918,,,2022-05-04T00:00:00Z,,https://au-api.basiq.io/users/11103cba-4a08-4397-84a5-22ac125ed2f6/transactions/0b31ba42-88db-461a-b80a-f3fb20cf44f6,https://au-api.basiq.io/users/11103cba-4a08-4397-84a5-22ac125ed2f6/accounts/49544383-c19c-4c97-b8d1-5322d0faa6af,https://au-api.basiq.io/institutions/AU00000,,Regulatory Services,772
transaction,77a042a3-98fb-4fff-af7c-fa09e2b58d69,posted,THE FORGE PIZZERIA BALLARAT AU,-94.00,49544383-c19c-4c97-b8d1-5322d0faa6af,372.02,debit,payment,AU00000,5453f0a3-083c-43c6-9086-adfe94df9918,,,2022-05-04T00:00:00Z,,https://au-api.basiq.io/users/11103cba-4a08-4397-84a5-22ac125ed2f6/transactions/77a042a3-98fb-4fff-af7c-fa09e2b58d69,https://au-api.basiq.io/users/11103cba-4a08-4397-84a5-22ac125ed2f6/accounts/49544383-c19c-4c97-b8d1-5322d0faa6af,https://au-api.basiq.io/institutions/AU00000,,"Cafes, Restaurants and Takeaway Food Services",451
transaction,d0edb43b-daa8-4387-846d-7e8e2801b946,posted,SOVEREIGN HILL BALLARAT AU,-137.00,49544383-c19c-4c97-b8d1-5322d0faa6af,466.02,debit,payment,AU00000,5453f0a3-083c-43c6-9086-adfe94df9918,,,2022-05-03T00:00:00Z,,https://au-api.basiq.io/users/11103cba-4a08-4397-84a5-22ac125ed2f6/transactions/d0edb43b-daa8-4387-846d-7e8e2801b946,https://au-api.basiq.io/users/11103cba-4a08-4397-84a5-22ac125ed2f6/accounts/49544383-c19c-4c97-b8d1-5322d0faa6af,https://au-api.basiq.io/institutions/AU00000,,Amusement and Other Recreation Activities,913
transaction,c9b2f591-93ef-49fc-86e5-8320f2f01e8e,posted,ENTWINEDCAFEREST CAST,-50.00,49544383-c19c-4c97-b8d1-5322d0faa6af,603.02,debit,payment,AU00000,5453f0a3-083c-43c6-9086-adfe94df9918,,,2022-05-03T00:00:00Z,,https://au-api.basiq.io/users/11103cba-4a08-4397-84a5-22ac125ed2f6/transactions/c9b2f591-93ef-49fc-86e5-8320f2f01e8e,https://au-api.basiq.io/users/11103cba-4a08-4397-84a5-22ac125ed2f6/accounts/49544383-c19c-4c97-b8d1-5322d0faa6af,https://au-api.basiq.io/institutions/AU00000,,Unknown,0
transaction,46ac0e4d-faff-442e-b109-1c525c4c5e38,posted,HALLS GAP BAKERY VIC HALL,-21.10,49544383-c19c-4c97-b8d1-5322d0faa6af,653.02,debit,payment,AU00000,5453f0a3-083c-43c6-9086-adfe94df9918,,,2022-05-03T00:00:00Z,,https://au-api.basiq.io/users/11103cba-4a08-4397-84a5-22ac125ed2f6/transactions/46ac0e4d-faff-442e-b109-1c525c4c5e38,https://au-api.basiq.io/users/11103cba-4a08-4397-84a5-22ac125ed2f6/accounts/49544383-c19c-4c97-b8d1-5322d0faa6af,https://au-api.basiq.io/institutions/AU00000,,Bakery Product Manufacturing,117
transaction,b9fee9b9-fc99-4932-96cc-4c5d7b672ed6,posted,CALTEX STAR MART ARARAT AU,-237.73,49544383-c19c-4c97-b8d1-5322d0faa6af,674.12,debit,payment,AU00000,5453f0a3-083c-43c6-9086-adfe94df9918,,,2022-05-03T00:00:00Z,,https://au-api.basiq.io/users/11103cba-4a08-4397-84a5-22ac125ed2f6/transactions/b9fee9b9-fc99-4932-96cc-4c5d7b672ed6,https://au-api.basiq.io/users/11103cba-4a08-4397-84a5-22ac125ed2f6/accounts/49544383-c19c-4c97-b8d1-5322d0faa6af,https://au-api.basiq.io/institutions/AU00000,,Fuel Retailing,400
transaction,2df02cd3-99d6-470d-b989-ef8d1e6fe19d,posted,Red Rock Olives54999 POMONAL03 AU,-81.00,49544383-c19c-4c97-b8d1-5322d0faa6af,911.85,debit,payment,AU00000,5453f0a3-083c-43c6-9086-adfe94df9918,,,2022-05-03T00:00:00Z,,https://au-api.basiq.io/users/11103cba-4a08-4397-84a5-22ac125ed2f6/transactions/2df02cd3-99d6-470d-b989-ef8d1e6fe19d,https://au-api.basiq.io/users/11103cba-4a08-4397-84a5-22ac125ed2f6/accounts/49544383-c19c-4c97-b8d1-5322d0faa6af,https://au-api.basiq.io/institutions/AU00000,,"Cafes, Restaurants and Takeaway Food Services",451
transaction,a4c6d728-5acc-46c3-a0ee-3b3c2c7e701d,posted,SUSHI TRAIN GRNFL ST ADELAID,-87.50,49544383-c19c-4c97-b8d1-5322d0faa6af,992.85,debit,payment,AU00000,5453f0a3-083c-43c6-9086-adfe94df9918,,,2022-05-02T00:00:00Z,,https://au-api.basiq.io/users/11103cba-4a08-4397-84a5-22ac125ed2f6/transactions/a4c6d728-5acc-46c3-a0ee-3b3c2c7e701d,https://au-api.basiq.io/users/11103cba-4a08-4397-84a5-22ac125ed2f6/accounts/49544383-c19c-4c97-b8d1-5322d0faa6af,https://au-api.basiq.io/institutions/AU00000,,"Cafes, Restaurants and Takeaway Food Services",451
transaction,7fc05d21-aac5-4da7-a513-3ae7dcd75bf8,posted,DEWNR - ADELAIDE ADEL,-16.00,49544383-c19c-4c97-b8d1-5322d0faa6af,1080.35,debit,payment,AU00000,5453f0a3-083c-43c6-9086-adfe94df9918,,,2022-05-02T00:00:00Z,,https://au-api.basiq.io/users/11103cba-4a08-4397-84a5-22ac125ed2f6/transactions/7fc05d21-aac5-4da7-a513-3ae7dcd75bf8,https://au-api.basiq.io/users/11103cba-4a08-4397-84a5-22ac125ed2f6/accounts/49544383-c19c-4c97-b8d1-5322d0faa6af,https://au-api.basiq.io/institutions/AU00000,,Regulatory Services,772
transaction,fa0bc5a5-d0b9-4ccf-8ce0-e0429c9d27e9,posted,POST TAILEM BEND L TAIL,-11.20,49544383-c19c-4c97-b8d1-5322d0faa6af,1096.35,debit,payment,AU00000,5453f0a3-083c-43c6-9086-adfe94df9918,,,2022-05-02T00:00:00Z,,https://au-api.basiq.io/users/11103cba-4a08-4397-84a5-22ac125ed2f6/transactions/fa0bc5a5-d0b9-4ccf-8ce0-e0429c9d27e9,https://au-api.basiq.io/users/11103cba-4a08-4397-84a5-22ac125ed2f6/accounts/49544383-c19c-4c97-b8d1-5322d0faa6af,https://au-api.basiq.io/institutions/AU00000,,Postal and Courier Pick-up and Delivery Services,510
transaction,87867289-5649-431e-8031-d823cde89c57,posted,Cash Wdr  VIC 366001   AUS,-303.00,49544383-c19c-4c97-b8d1-5322d0faa6af,1107.55,debit,cash-withdrawal,AU00000,5453f0a3-083c-43c6-9086-adfe94df9918,,,2022-04-30T00:00:00Z,,https://au-api.basiq.io/users/11103cba-4a08-4397-84a5-22ac125ed2f6/transactions/87867289-5649-431e-8031-d823cde89c57,https://au-api.basiq.io/users/11103cba-4a08-4397-84a5-22ac125ed2f6/accounts/49544383-c19c-4c97-b8d1-5322d0faa6af,https://au-api.basiq.io/institutions/AU00000,,,
transaction,84b51361-f5e2-4366-aa0c-a92d31545997,posted,HOLLICK ESTATES PTY COONAWARRA AU,-116.00,49544383-c19c-4c97-b8d1-5322d0faa6af,1410.55,debit,payment,AU00000,5453f0a3-083c-43c6-9086-adfe94df9918,,,2022-04-30T00:00:00Z,,https://au-api.basiq.io/users/11103cba-4a08-4397-84a5-22ac125ed2f6/transactions/84b51361-f5e2-4366-aa0c-a92d31545997,https://au-api.basiq.io/users/11103cba-4a08-4397-84a5-22ac125ed2f6/accounts/49544383-c19c-4c97-b8d1-5322d0faa6af,https://au-api.basiq.io/institutions/AU00000,,Specialised Food Retailing,412
transaction,47e37bde-f68b-487b-b20b-04d92a7cfd75,posted,TFR From Transaction to CC Acc 13,9293.50,49544383-c19c-4c97-b8d1-5322d0faa6af,1526.55,credit,transfer,AU00000,5453f0a3-083c-43c6-9086-adfe94df9918,,,2022-04-29T00:00:00Z,,https://au-api.basiq.io/users/11103cba-4a08-4397-84a5-22ac125ed2f6/transactions/47e37bde-f68b-487b-b20b-04d92a7cfd75,https://au-api.basiq.io/users/11103cba-4a08-4397-84a5-22ac125ed2f6/accounts/49544383-c19c-4c97-b8d1-5322d0faa6af,https://au-api.basiq.io/institutions/AU00000,,,
transaction,accd2844-922d-4ea9-81ab-4536fcc6bd4a,posted,Glen Roy Winem340301 GLENROY5 AU,-134.00,49544383-c19c-4c97-b8d1-5322d0faa6af,-7766.95,debit,payment,AU00000,5453f0a3-083c-43c6-9086-adfe94df9918,,,2022-04-29T00:00:00Z,,https://au-api.basiq.io/users/11103cba-4a08-4397-84a5-22ac125ed2f6/transactions/accd2844-922d-4ea9-81ab-4536fcc6bd4a,https://au-api.basiq.io/users/11103cba-4a08-4397-84a5-22ac125ed2f6/accounts/49544383-c19c-4c97-b8d1-5322d0faa6af,https://au-api.basiq.io/institutions/AU00000,,Specialised Food Retailing,412
transaction,b7cbbe5b-0b0f-4d22-8b1b-522ab6b89983,posted,KIDMAN WINES COONAWARRA AU,-23.00,49544383-c19c-4c97-b8d1-5322d0faa6af,-7632.95,debit,payment,AU00000,5453f0a3-083c-43c6-9086-adfe94df9918,,,2022-04-29T00:00:00Z,,https://au-api.basiq.io/users/11103cba-4a08-4397-84a5-22ac125ed2f6/transactions/b7cbbe5b-0b0f-4d22-8b1b-522ab6b89983,https://au-api.basiq.io/users/11103cba-4a08-4397-84a5-22ac125ed2f6/accounts/49544383-c19c-4c97-b8d1-5322d0faa6af,https://au-api.basiq.io/institutions/AU00000,,Amusement and Other Recreation Activities,913
transaction,771b4d4b-9dce-435b-b35f-90f6c3c63dfa,posted,DEWNR - NARACOORTE C NARACOORTE AU,-76.00,49544383-c19c-4c97-b8d1-5322d0faa6af,-7609.95,debit,payment,AU00000,5453f0a3-083c-43c6-9086-adfe94df9918,,,2022-04-29T00:00:00Z,,https://au-api.basiq.io/users/11103cba-4a08-4397-84a5-22ac125ed2f6/transactions/771b4d4b-9dce-435b-b35f-90f6c3c63dfa,https://au-api.basiq.io/users/11103cba-4a08-4397-84a5-22ac125ed2f6/accounts/49544383-c19c-4c97-b8d1-5322d0faa6af,https://au-api.basiq.io/institutions/AU00000,,Regulatory Services,772
transaction,39c54fd5-f2d1-4d7c-af12-b44f13a773b2,posted,ADELAIDE BACKPACKERS A ADEL,-281.00,49544383-c19c-4c97-b8d1-5322d0faa6af,-7533.95,debit,payment,AU00000,5453f0a3-083c-43c6-9086-adfe94df9918,,,2022-04-28T00:00:00Z,,https://au-api.basiq.io/users/11103cba-4a08-4397-84a5-22ac125ed2f6/transactions/39c54fd5-f2d1-4d7c-af12-b44f13a773b2,https://au-api.basiq.io/users/11103cba-4a08-4397-84a5-22ac125ed2f6/accounts/49544383-c19c-4c97-b8d1-5322d0faa6af,https://au-api.basiq.io/institutions/AU00000,,Accommodation,440
transaction,a858d818-c9af-43a1-8b6d-a6cc7ea44eb1,posted,IGA FRESH WESTSIDE MURR,-82.88,49544383-c19c-4c97-b8d1-5322d0faa6af,-7252.95,debit,payment,AU00000,5453f0a3-083c-43c6-9086-adfe94df9918,,,2022-04-28T00:00:00Z,,https://au-api.basiq.io/users/11103cba-4a08-4397-84a5-22ac125ed2f6/transactions/a858d818-c9af-43a1-8b6d-a6cc7ea44eb1,https://au-api.basiq.io/users/11103cba-4a08-4397-84a5-22ac125ed2f6/accounts/49544383-c19c-4c97-b8d1-5322d0faa6af,https://au-api.basiq.io/institutions/AU00000,,Supermarket and Grocery Stores,411
transaction,35d63507-dfd0-492e-93d3-0bf3c727c35c,posted,CORONATION MEAT STO TAIL,-33.90,49544383-c19c-4c97-b8d1-5322d0faa6af,-7170.07,debit,payment,AU00000,5453f0a3-083c-43c6-9086-adfe94df9918,,,2022-04-28T00:00:00Z,,https://au-api.basiq.io/users/11103cba-4a08-4397-84a5-22ac125ed2f6/transactions/35d63507-dfd0-492e-93d3-0bf3c727c35c,https://au-api.basiq.io/users/11103cba-4a08-4397-84a5-22ac125ed2f6/accounts/49544383-c19c-4c97-b8d1-5322d0faa6af,https://au-api.basiq.io/institutions/AU00000,,Specialised Food Retailing,412
transaction,af1f6c39-26c7-44e2-a97a-1a6f265e2341,posted,PARKFAST SA P/L ADEL,-19.00,49544383-c19c-4c97-b8d1-5322d0faa6af,-7136.17,debit,payment,AU00000,5453f0a3-083c-43c6-9086-adfe94df9918,,,2022-04-28T00:00:00Z,,https://au-api.basiq.io/users/11103cba-4a08-4397-84a5-22ac125ed2f6/transactions/af1f6c39-26c7-44e2-a97a-1a6f265e2341,https://au-api.basiq.io/users/11103cba-4a08-4397-84a5-22ac125ed2f6/accounts/49544383-c19c-4c97-b8d1-5322d0faa6af,https://au-api.basiq.io/institutions/AU00000,,Other Personal Services,953
transaction,76b74cb1-cbbe-4bc5-859c-4975ea6570a7,posted,BASECAMPCAFEBURNSIDE HAZELWOOD PAR AU,-81.80,49544383-c19c-4c97-b8d1-5322d0faa6af,-7117.17,debit,payment,AU00000,5453f0a3-083c-43c6-9086-adfe94df9918,,,2022-04-27T00:00:00Z,,https://au-api.basiq.io/users/11103cba-4a08-4397-84a5-22ac125ed2f6/transactions/76b74cb1-cbbe-4bc5-859c-4975ea6570a7,https://au-api.basiq.io/users/11103cba-4a08-4397-84a5-22ac125ed2f6/accounts/49544383-c19c-4c97-b8d1-5322d0faa6af,https://au-api.basiq.io/institutions/AU00000,,"Cafes, Restaurants and Takeaway Food Services",451
transaction,5cefb304-43ef-4143-8879-fe8ff0cb1ac3,posted,BP WEST TERRACE 3171 ADELAIDE AU,-228.16,49544383-c19c-4c97-b8d1-5322d0faa6af,-7035.37,debit,payment,AU00000,5453f0a3-083c-43c6-9086-adfe94df9918,,,2022-04-27T00:00:00Z,,https://au-api.basiq.io/users/11103cba-4a08-4397-84a5-22ac125ed2f6/transactions/5cefb304-43ef-4143-8879-fe8ff0cb1ac3,https://au-api.basiq.io/users/11103cba-4a08-4397-84a5-22ac125ed2f6/accounts/49544383-c19c-4c97-b8d1-5322d0faa6af,https://au-api.basiq.io/institutions/AU00000,,Fuel Retailing,400
transaction,f44cbbec-1adf-4c2c-abc5-27ea75abfd8a,posted,RAPTOR DOMAIN SEAL,-101.00,49544383-c19c-4c97-b8d1-5322d0faa6af,-6807.21,debit,payment,AU00000,5453f0a3-083c-43c6-9086-adfe94df9918,,,2022-04-27T00:00:00Z,,https://au-api.basiq.io/users/11103cba-4a08-4397-84a5-22ac125ed2f6/transactions/f44cbbec-1adf-4c2c-abc5-27ea75abfd8a,https://au-api.basiq.io/users/11103cba-4a08-4397-84a5-22ac125ed2f6/accounts/49544383-c19c-4c97-b8d1-5322d0faa6af,https://au-api.basiq.io/institutions/AU00000,,Amusement and Other Recreation Activities,913
transaction,593700b2-0d2c-4a30-a69f-89d849195fd9,posted,RAPTOR DOMAIN SEAL,-39.00,49544383-c19c-4c97-b8d1-5322d0faa6af,-6706.21,debit,payment,AU00000,5453f0a3-083c-43c6-9086-adfe94df9918,,,2022-04-27T00:00:00Z,,https://au-api.basiq.io/users/11103cba-4a08-4397-84a5-22ac125ed2f6/transactions/593700b2-0d2c-4a30-a69f-89d849195fd9,https://au-api.basiq.io/users/11103cba-4a08-4397-84a5-22ac125ed2f6/accounts/49544383-c19c-4c97-b8d1-5322d0faa6af,https://au-api.basiq.io/institutions/AU00000,,Amusement and Other Recreation Activities,913
transaction,bf59c76c-1f19-4163-a2ce-cbf8c5287935,posted,SOUTH AUSTRALIAN MUS ADELAIDE AU,-18.60,49544383-c19c-4c97-b8d1-5322d0faa6af,-6667.21,debit,payment,AU00000,5453f0a3-083c-43c6-9086-adfe94df9918,,,2022-04-27T00:00:00Z,,https://au-api.basiq.io/users/11103cba-4a08-4397-84a5-22ac125ed2f6/transactions/bf59c76c-1f19-4163-a2ce-cbf8c5287935,https://au-api.basiq.io/users/11103cba-4a08-4397-84a5-22ac125ed2f6/accounts/49544383-c19c-4c97-b8d1-5322d0faa6af,https://au-api.basiq.io/institutions/AU00000,,Pharmaceutical and Other Store-Based Retailing,427
transaction,279d3f9c-c6bf-46c7-a32b-00628e77fca2,posted,LE SOUK ACM PTY LTD ADELAIDE SA AU,-71.00,49544383-c19c-4c97-b8d1-5322d0faa6af,-6648.61,debit,payment,AU00000,5453f0a3-083c-43c6-9086-adfe94df9918,,,2022-04-27T00:00:00Z,,https://au-api.basiq.io/users/11103cba-4a08-4397-84a5-22ac125ed2f6/transactions/279d3f9c-c6bf-46c7-a32b-00628e77fca2,https://au-api.basiq.io/users/11103cba-4a08-4397-84a5-22ac125ed2f6/accounts/49544383-c19c-4c97-b8d1-5322d0faa6af,https://au-api.basiq.io/institutions/AU00000,,"Cafes, Restaurants and Takeaway Food Services",451
transaction,2e02c545-9522-4890-a37a-d930019d8852,posted,EXCEL ALLIANCE PTY L PENN,-69.00,49544383-c19c-4c97-b8d1-5322d0faa6af,-6577.61,debit,payment,AU00000,5453f0a3-083c-43c6-9086-adfe94df9918,,,2022-04-26T00:00:00Z,,https://au-api.basiq.io/users/11103cba-4a08-4397-84a5-22ac125ed2f6/transactions/2e02c545-9522-4890-a37a-d930019d8852,https://au-api.basiq.io/users/11103cba-4a08-4397-84a5-22ac125ed2f6/accounts/49544383-c19c-4c97-b8d1-5322d0faa6af,https://au-api.basiq.io/institutions/AU00000,,Unknown,0
transaction,dd5b9a6c-8b82-4050-8587-c6682ae528f6,posted,CAPE JERVIS STATION CAPE JE,-56.00,49544383-c19c-4c97-b8d1-5322d0faa6af,-6508.61,debit,payment,AU00000,5453f0a3-083c-43c6-9086-adfe94df9918,,,2022-04-26T00:00:00Z,,https://au-api.basiq.io/users/11103cba-4a08-4397-84a5-22ac125ed2f6/transactions/dd5b9a6c-8b82-4050-8587-c6682ae528f6,https://au-api.basiq.io/users/11103cba-4a08-4397-84a5-22ac125ed2f6/accounts/49544383-c19c-4c97-b8d1-5322d0faa6af,https://au-api.basiq.io/institutions/AU00000,,Accommodation,440
transaction,90f554ff-d3b0-4765-a4dc-35310734041d,posted,CLIFFORDS HONEY FARM HAINES,-37.00,49544383-c19c-4c97-b8d1-5322d0faa6af,-6452.61,debit,payment,AU00000,5453f0a3-083c-43c6-9086-adfe94df9918,,,2022-04-26T00:00:00Z,,https://au-api.basiq.io/users/11103cba-4a08-4397-84a5-22ac125ed2f6/transactions/90f554ff-d3b0-4765-a4dc-35310734041d,https://au-api.basiq.io/users/11103cba-4a08-4397-84a5-22ac125ed2f6/accounts/49544383-c19c-4c97-b8d1-5322d0faa6af,https://au-api.basiq.io/institutions/AU00000,,Pharmaceutical and Other Store-Based Retailing,427
transaction,7ac1708b-6e62-413e-a96d-ffd2d7ff3e73,posted,JAMIES ITALIAN ADELA ADELAIDE AU,-125.10,49544383-c19c-4c97-b8d1-5322d0faa6af,-6415.61,debit,payment,AU00000,5453f0a3-083c-43c6-9086-adfe94df9918,,,2022-04-26T00:00:00Z,,https://au-api.basiq.io/users/11103cba-4a08-4397-84a5-22ac125ed2f6/transactions/7ac1708b-6e62-413e-a96d-ffd2d7ff3e73,https://au-api.basiq.io/users/11103cba-4a08-4397-84a5-22ac125ed2f6/accounts/49544383-c19c-4c97-b8d1-5322d0faa6af,https://au-api.basiq.io/institutions/AU00000,,"Cafes, Restaurants and Takeaway Food Services",451
transaction,e8f1d861-4de8-4bd8-b951-003eb0f03a46,posted,ONE LITTLE SISTER NORMANVILLE SA AU,-80.00,49544383-c19c-4c97-b8d1-5322d0faa6af,-6290.51,debit,payment,AU00000,5453f0a3-083c-43c6-9086-adfe94df9918,,,2022-04-26T00:00:00Z,,https://au-api.basiq.io/users/11103cba-4a08-4397-84a5-22ac125ed2f6/transactions/e8f1d861-4de8-4bd8-b951-003eb0f03a46,https://au-api.basiq.io/users/11103cba-4a08-4397-84a5-22ac125ed2f6/accounts/49544383-c19c-4c97-b8d1-5322d0faa6af,https://au-api.basiq.io/institutions/AU00000,,"Cafes, Restaurants and Takeaway Food Services",451
transaction,13b5c077-ee0c-4f77-a937-a8775ee23667,posted,K I Wilderness Karatta AU,-1400.00,49544383-c19c-4c97-b8d1-5322d0faa6af,-6210.51,debit,payment,AU00000,5453f0a3-083c-43c6-9086-adfe94df9918,,,2022-04-25T00:00:00Z,,https://au-api.basiq.io/users/11103cba-4a08-4397-84a5-22ac125ed2f6/transactions/13b5c077-ee0c-4f77-a937-a8775ee23667,https://au-api.basiq.io/users/11103cba-4a08-4397-84a5-22ac125ed2f6/accounts/49544383-c19c-4c97-b8d1-5322d0faa6af,https://au-api.basiq.io/institutions/AU00000,,Accommodation,440
transaction,16c1db7c-84d5-41e6-b021-09df49962683,posted,DEWNR FLINDERS CHASE KINGSCOTE AU,-29.00,49544383-c19c-4c97-b8d1-5322d0faa6af,-4810.51,debit,payment,AU00000,5453f0a3-083c-43c6-9086-adfe94df9918,,,2022-04-25T00:00:00Z,,https://au-api.basiq.io/users/11103cba-4a08-4397-84a5-22ac125ed2f6/transactions/16c1db7c-84d5-41e6-b021-09df49962683,https://au-api.basiq.io/users/11103cba-4a08-4397-84a5-22ac125ed2f6/accounts/49544383-c19c-4c97-b8d1-5322d0faa6af,https://au-api.basiq.io/institutions/AU00000,,Regulatory Services,772
transaction,a22172a3-334b-4328-b586-7b61b0ac71a1,posted,ISLAND PURE CYGNET RIVER SA AU,-43.95,49544383-c19c-4c97-b8d1-5322d0faa6af,-4781.51,debit,payment,AU00000,5453f0a3-083c-43c6-9086-adfe94df9918,,,2022-04-22T00:00:00Z,,https://au-api.basiq.io/users/11103cba-4a08-4397-84a5-22ac125ed2f6/transactions/a22172a3-334b-4328-b586-7b61b0ac71a1,https://au-api.basiq.io/users/11103cba-4a08-4397-84a5-22ac125ed2f6/accounts/49544383-c19c-4c97-b8d1-5322d0faa6af,https://au-api.basiq.io/institutions/AU00000,,Specialised Food Retailing,412
transaction,3daa5da4-5e3e-48dd-b4f8-f6a2663f10fd,posted,KANGAROO ISLAND LIGU KINGSCOTE AU,-24.00,49544383-c19c-4c97-b8d1-5322d0faa6af,-4737.56,debit,payment,AU00000,5453f0a3-083c-43c6-9086-adfe94df9918,,,2022-04-22T00:00:00Z,,https://au-api.basiq.io/users/11103cba-4a08-4397-84a5-22ac125ed2f6/transactions/3daa5da4-5e3e-48dd-b4f8-f6a2663f10fd,https://au-api.basiq.io/users/11103cba-4a08-4397-84a5-22ac125ed2f6/accounts/49544383-c19c-4c97-b8d1-5322d0faa6af,https://au-api.basiq.io/institutions/AU00000,,"Cafes, Restaurants and Takeaway Food Services",451
transaction,d6ab750e-c8ff-4e91-9043-7da67f16be91,posted,BELLA CAFE RESTAURAN KINGSCOTE AU,-61.50,49544383-c19c-4c97-b8d1-5322d0faa6af,-4713.56,debit,payment,AU00000,5453f0a3-083c-43c6-9086-adfe94df9918,,,2022-04-22T00:00:00Z,,https://au-api.basiq.io/users/11103cba-4a08-4397-84a5-22ac125ed2f6/transactions/d6ab750e-c8ff-4e91-9043-7da67f16be91,https://au-api.basiq.io/users/11103cba-4a08-4397-84a5-22ac125ed2f6/accounts/49544383-c19c-4c97-b8d1-5322d0faa6af,https://au-api.basiq.io/institutions/AU00000,,"Cafes, Restaurants and Takeaway Food Services",451
transaction,f520ac1c-ed40-4ad4-8efc-ca17c6729400,posted,Cash Wdr  KINGSCOTE    SA,-303.00,49544383-c19c-4c97-b8d1-5322d0faa6af,-4652.06,debit,cash-withdrawal,AU00000,5453f0a3-083c-43c6-9086-adfe94df9918,,,2022-04-22T00:00:00Z,,https://au-api.basiq.io/users/11103cba-4a08-4397-84a5-22ac125ed2f6/transactions/f520ac1c-ed40-4ad4-8efc-ca17c6729400,https://au-api.basiq.io/users/11103cba-4a08-4397-84a5-22ac125ed2f6/accounts/49544383-c19c-4c97-b8d1-5322d0faa6af,https://au-api.basiq.io/institutions/AU00000,,,
transaction,fd3d7c28-00c5-4473-b05c-c747214e96b6,posted,GOODWOOD QUALITY MEATS GOOD,-69.15,49544383-c19c-4c97-b8d1-5322d0faa6af,-4349.06,debit,payment,AU00000,5453f0a3-083c-43c6-9086-adfe94df9918,,,2022-04-21T00:00:00Z,,https://au-api.basiq.io/users/11103cba-4a08-4397-84a5-22ac125ed2f6/transactions/fd3d7c28-00c5-4473-b05c-c747214e96b6,https://au-api.basiq.io/users/11103cba-4a08-4397-84a5-22ac125ed2f6/accounts/49544383-c19c-4c97-b8d1-5322d0faa6af,https://au-api.basiq.io/institutions/AU00000,,Specialised Food Retailing,412
transaction,f1c3aa37-7e17-4376-9cb4-d0777b54f1ee,posted,BOULANGERIE 113 PTY LTD GOOD,-37.70,49544383-c19c-4c97-b8d1-5322d0faa6af,-4279.91,debit,payment,AU00000,5453f0a3-083c-43c6-9086-adfe94df9918,,,2022-04-21T00:00:00Z,,https://au-api.basiq.io/users/11103cba-4a08-4397-84a5-22ac125ed2f6/transactions/f1c3aa37-7e17-4376-9cb4-d0777b54f1ee,https://au-api.basiq.io/users/11103cba-4a08-4397-84a5-22ac125ed2f6/accounts/49544383-c19c-4c97-b8d1-5322d0faa6af,https://au-api.basiq.io/institutions/AU00000,,Bakery Product Manufacturing,117
transaction,fe67fbff-f0d8-4204-94b1-f4823684fdf5,posted,BOULANGERIE 113 PTY LTD GOOD,-15.60,49544383-c19c-4c97-b8d1-5322d0faa6af,-4242.21,debit,payment,AU00000,5453f0a3-083c-43c6-9086-adfe94df9918,,,2022-04-21T00:00:00Z,,https://au-api.basiq.io/users/11103cba-4a08-4397-84a5-22ac125ed2f6/transactions/fe67fbff-f0d8-4204-94b1-f4823684fdf5,https://au-api.basiq.io/users/11103cba-4a08-4397-84a5-22ac125ed2f6/accounts/49544383-c19c-4c97-b8d1-5322d0faa6af,https://au-api.basiq.io/institutions/AU00000,,Bakery Product Manufacturing,117
transaction,81a32a1c-816e-45c4-b17a-874632224d39,posted,BOULANGERIE 113 PTY LTD GOOD,-15.30,49544383-c19c-4c97-b8d1-5322d0faa6af,-4226.61,debit,payment,AU00000,5453f0a3-083c-43c6-9086-adfe94df9918,,,2022-04-21T00:00:00Z,,https://au-api.basiq.io/users/11103cba-4a08-4397-84a5-22ac125ed2f6/transactions/81a32a1c-816e-45c4-b17a-874632224d39,https://au-api.basiq.io/users/11103cba-4a08-4397-84a5-22ac125ed2f6/accounts/49544383-c19c-4c97-b8d1-5322d0faa6af,https://au-api.basiq.io/institutions/AU00000,,Bakery Product Manufacturing,117
transaction,f6e0dc16-6651-400c-b0ce-b4ef19befc9d,posted,REFUND  20/12,10.95,49544383-c19c-4c97-b8d1-5322d0faa6af,-4211.31,credit,refund,AU00000,5453f0a3-083c-43c6-9086-adfe94df9918,,,2022-04-21T00:00:00Z,,https://au-api.basiq.io/users/11103cba-4a08-4397-84a5-22ac125ed2f6/transactions/f6e0dc16-6651-400c-b0ce-b4ef19befc9d,https://au-api.basiq.io/users/11103cba-4a08-4397-84a5-22ac125ed2f6/accounts/49544383-c19c-4c97-b8d1-5322d0faa6af,https://au-api.basiq.io/institutions/AU00000,,,
transaction,96df1077-2e52-461a-8b72-982353c4c34e,posted,KANGAROO ISLAND SHEL AMERICAN RIV AU,-36.65,49544383-c19c-4c97-b8d1-5322d0faa6af,-4222.26,debit,payment,AU00000,5453f0a3-083c-43c6-9086-adfe94df9918,,,2022-04-21T00:00:00Z,,https://au-api.basiq.io/users/11103cba-4a08-4397-84a5-22ac125ed2f6/transactions/96df1077-2e52-461a-8b72-982353c4c34e,https://au-api.basiq.io/users/11103cba-4a08-4397-84a5-22ac125ed2f6/accounts/49544383-c19c-4c97-b8d1-5322d0faa6af,https://au-api.basiq.io/institutions/AU00000,,"Cafes, Restaurants and Takeaway Food Services",451
transaction,569ade36-45f9-432f-9310-4fee31ba8059,posted,KANGAROO ISLAND SHEL AMERICAN RIV AU,-35.85,49544383-c19c-4c97-b8d1-5322d0faa6af,-4185.61,debit,payment,AU00000,5453f0a3-083c-43c6-9086-adfe94df9918,,,2022-04-21T00:00:00Z,,https://au-api.basiq.io/users/11103cba-4a08-4397-84a5-22ac125ed2f6/transactions/569ade36-45f9-432f-9310-4fee31ba8059,https://au-api.basiq.io/users/11103cba-4a08-4397-84a5-22ac125ed2f6/accounts/49544383-c19c-4c97-b8d1-5322d0faa6af,https://au-api.basiq.io/institutions/AU00000,,"Cafes, Restaurants and Takeaway Food Services",451
transaction,7cc56865-3dcb-48e7-b0a6-4e7a0922864d,posted,COLES 4934 ALDI,-76.10,49544383-c19c-4c97-b8d1-5322d0faa6af,-4149.76,debit,payment,AU00000,5453f0a3-083c-43c6-9086-adfe94df9918,,,2022-04-20T00:00:00Z,,https://au-api.basiq.io/users/11103cba-4a08-4397-84a5-22ac125ed2f6/transactions/7cc56865-3dcb-48e7-b0a6-4e7a0922864d,https://au-api.basiq.io/users/11103cba-4a08-4397-84a5-22ac125ed2f6/accounts/49544383-c19c-4c97-b8d1-5322d0faa6af,https://au-api.basiq.io/institutions/AU00000,,Supermarket and Grocery Stores,411
transaction,27d3fc01-ded0-42bf-9eb7-d1557f6aa08f,posted,WOW RNDLE MAL 5317 ADEL,-37.24,49544383-c19c-4c97-b8d1-5322d0faa6af,-4073.66,debit,payment,AU00000,5453f0a3-083c-43c6-9086-adfe94df9918,,,2022-04-20T00:00:00Z,,https://au-api.basiq.io/users/11103cba-4a08-4397-84a5-22ac125ed2f6/transactions/27d3fc01-ded0-42bf-9eb7-d1557f6aa08f,https://au-api.basiq.io/users/11103cba-4a08-4397-84a5-22ac125ed2f6/accounts/49544383-c19c-4c97-b8d1-5322d0faa6af,https://au-api.basiq.io/institutions/AU00000,,Supermarket and Grocery Stores,411
transaction,fb87112d-c42d-4ad0-8c15-02e16b48f5de,posted,DAVID JONES LIMITED ADEL,-33.95,49544383-c19c-4c97-b8d1-5322d0faa6af,-4036.42,debit,payment,AU00000,5453f0a3-083c-43c6-9086-adfe94df9918,,,2022-04-20T00:00:00Z,,https://au-api.basiq.io/users/11103cba-4a08-4397-84a5-22ac125ed2f6/transactions/fb87112d-c42d-4ad0-8c15-02e16b48f5de,https://au-api.basiq.io/users/11103cba-4a08-4397-84a5-22ac125ed2f6/accounts/49544383-c19c-4c97-b8d1-5322d0faa6af,https://au-api.basiq.io/institutions/AU00000,,Department Stores,426
transaction,a2692e3b-7937-4f3f-b171-0a1fafa65452,posted,MYER ADELAIDE CITY ADEL,-17.95,49544383-c19c-4c97-b8d1-5322d0faa6af,-4002.47,debit,payment,AU00000,5453f0a3-083c-43c6-9086-adfe94df9918,,,2022-04-20T00:00:00Z,,https://au-api.basiq.io/users/11103cba-4a08-4397-84a5-22ac125ed2f6/transactions/a2692e3b-7937-4f3f-b171-0a1fafa65452,https://au-api.basiq.io/users/11103cba-4a08-4397-84a5-22ac125ed2f6/accounts/49544383-c19c-4c97-b8d1-5322d0faa6af,https://au-api.basiq.io/institutions/AU00000,,Department Stores,426
transaction,abf72748-cea7-4a21-89d2-d4e7c819ca59,posted,THE BODY SHOP ADEL,-10.95,49544383-c19c-4c97-b8d1-5322d0faa6af,-3984.52,debit,payment,AU00000,5453f0a3-083c-43c6-9086-adfe94df9918,,,2022-04-20T00:00:00Z,,https://au-api.basiq.io/users/11103cba-4a08-4397-84a5-22ac125ed2f6/transactions/abf72748-cea7-4a21-89d2-d4e7c819ca59,https://au-api.basiq.io/users/11103cba-4a08-4397-84a5-22ac125ed2f6/accounts/49544383-c19c-4c97-b8d1-5322d0faa6af,https://au-api.basiq.io/institutions/AU00000,,Pharmaceutical and Other Store-Based Retailing,427
transaction,9c4d3670-03ff-4d83-8047-d52c36f8d4fd,posted,REFUND  20/12,14.95,49544383-c19c-4c97-b8d1-5322d0faa6af,-3973.57,credit,refund,AU00000,5453f0a3-083c-43c6-9086-adfe94df9918,,,2022-04-20T00:00:00Z,,https://au-api.basiq.io/users/11103cba-4a08-4397-84a5-22ac125ed2f6/transactions/9c4d3670-03ff-4d83-8047-d52c36f8d4fd,https://au-api.basiq.io/users/11103cba-4a08-4397-84a5-22ac125ed2f6/accounts/49544383-c19c-4c97-b8d1-5322d0faa6af,https://au-api.basiq.io/institutions/AU00000,,,
transaction,7fed8841-4299-4d0b-9f60-c62cf95a708d,posted,CALTEX ALDINGA BEACH ALDINGA BEACHAU,-211.37,49544383-c19c-4c97-b8d1-5322d0faa6af,-3988.52,debit,payment,AU00000,5453f0a3-083c-43c6-9086-adfe94df9918,,,2022-04-20T00:00:00Z,,https://au-api.basiq.io/users/11103cba-4a08-4397-84a5-22ac125ed2f6/transactions/7fed8841-4299-4d0b-9f60-c62cf95a708d,https://au-api.basiq.io/users/11103cba-4a08-4397-84a5-22ac125ed2f6/accounts/49544383-c19c-4c97-b8d1-5322d0faa6af,https://au-api.basiq.io/institutions/AU00000,,Fuel Retailing,400
transaction,08dcf77e-a957-43b1-a1ce-92db7e7b63ff,posted,GOODWOOD FOODLAND GOODWOOD AU,-234.24,49544383-c19c-4c97-b8d1-5322d0faa6af,-3777.15,debit,payment,AU00000,5453f0a3-083c-43c6-9086-adfe94df9918,,,2022-04-20T00:00:00Z,,https://au-api.basiq.io/users/11103cba-4a08-4397-84a5-22ac125ed2f6/transactions/08dcf77e-a957-43b1-a1ce-92db7e7b63ff,https://au-api.basiq.io/users/11103cba-4a08-4397-84a5-22ac125ed2f6/accounts/49544383-c19c-4c97-b8d1-5322d0faa6af,https://au-api.basiq.io/institutions/AU00000,,Supermarket and Grocery Stores,411
transaction,39bf4559-4557-4eea-bdc2-23c19167fdf8,posted,AMOLITE PTY LTD GOODWOOD AU,-158.55,49544383-c19c-4c97-b8d1-5322d0faa6af,-3542.91,debit,payment,AU00000,5453f0a3-083c-43c6-9086-adfe94df9918,,,2022-04-20T00:00:00Z,,https://au-api.basiq.io/users/11103cba-4a08-4397-84a5-22ac125ed2f6/transactions/39bf4559-4557-4eea-bdc2-23c19167fdf8,https://au-api.basiq.io/users/11103cba-4a08-4397-84a5-22ac125ed2f6/accounts/49544383-c19c-4c97-b8d1-5322d0faa6af,https://au-api.basiq.io/institutions/AU00000,,Specialised Food Retailing,412
transaction,277905ee-43b2-4ef2-aae3-c589503b6dc0,posted,SOUTH AUSTRALIAN MUSEUM FADEL,-57.10,49544383-c19c-4c97-b8d1-5322d0faa6af,-3384.36,debit,payment,AU00000,5453f0a3-083c-43c6-9086-adfe94df9918,,,2022-04-19T00:00:00Z,,https://au-api.basiq.io/users/11103cba-4a08-4397-84a5-22ac125ed2f6/transactions/277905ee-43b2-4ef2-aae3-c589503b6dc0,https://au-api.basiq.io/users/11103cba-4a08-4397-84a5-22ac125ed2f6/accounts/49544383-c19c-4c97-b8d1-5322d0faa6af,https://au-api.basiq.io/institutions/AU00000,,Amusement and Other Recreation Activities,913
transaction,9a67a558-571d-433e-a83c-036687feaabd,posted,THE SMELLY CHEESE SH ADELAID,-48.20,49544383-c19c-4c97-b8d1-5322d0faa6af,-3327.26,debit,payment,AU00000,5453f0a3-083c-43c6-9086-adfe94df9918,,,2022-04-19T00:00:00Z,,https://au-api.basiq.io/users/11103cba-4a08-4397-84a5-22ac125ed2f6/transactions/9a67a558-571d-433e-a83c-036687feaabd,https://au-api.basiq.io/users/11103cba-4a08-4397-84a5-22ac125ed2f6/accounts/49544383-c19c-4c97-b8d1-5322d0faa6af,https://au-api.basiq.io/institutions/AU00000,,Specialised Food Retailing,412
transaction,ed1100b3-1e10-48ae-90f4-e5dd713c6151,posted,DAVID JONES LIMITED ADEL,-25.95,49544383-c19c-4c97-b8d1-5322d0faa6af,-3279.06,debit,payment,AU00000,5453f0a3-083c-43c6-9086-adfe94df9918,,,2022-04-19T00:00:00Z,,https://au-api.basiq.io/users/11103cba-4a08-4397-84a5-22ac125ed2f6/transactions/ed1100b3-1e10-48ae-90f4-e5dd713c6151,https://au-api.basiq.io/users/11103cba-4a08-4397-84a5-22ac125ed2f6/accounts/49544383-c19c-4c97-b8d1-5322d0faa6af,https://au-api.basiq.io/institutions/AU00000,,Department Stores,426
transaction,833dd2d9-2465-46c8-aec4-fbe90ba0c1d9,posted,HOUSE OF HEALTH ADELAID,-21.94,49544383-c19c-4c97-b8d1-5322d0faa6af,-3253.11,debit,payment,AU00000,5453f0a3-083c-43c6-9086-adfe94df9918,,,2022-04-19T00:00:00Z,,https://au-api.basiq.io/users/11103cba-4a08-4397-84a5-22ac125ed2f6/transactions/833dd2d9-2465-46c8-aec4-fbe90ba0c1d9,https://au-api.basiq.io/users/11103cba-4a08-4397-84a5-22ac125ed2f6/accounts/49544383-c19c-4c97-b8d1-5322d0faa6af,https://au-api.basiq.io/institutions/AU00000,,Other Health Care Services,859
transaction,3c7ab0b9-ee52-4ae4-9bf9-7b9742bd11c4,posted,LE SOUK ACM PTY LTD ADELAID,-19.00,49544383-c19c-4c97-b8d1-5322d0faa6af,-3231.17,debit,payment,AU00000,5453f0a3-083c-43c6-9086-adfe94df9918,,,2022-04-19T00:00:00Z,,https://au-api.basiq.io/users/11103cba-4a08-4397-84a5-22ac125ed2f6/transactions/3c7ab0b9-ee52-4ae4-9bf9-7b9742bd11c4,https://au-api.basiq.io/users/11103cba-4a08-4397-84a5-22ac125ed2f6/accounts/49544383-c19c-4c97-b8d1-5322d0faa6af,https://au-api.basiq.io/institutions/AU00000,,"Cafes, Restaurants and Takeaway Food Services",451
transaction,544ab34a-1a72-4c36-b5a7-e7f3b7313b2c,posted,CITY OF ADELAIDE ADEL,-17.00,49544383-c19c-4c97-b8d1-5322d0faa6af,-3212.17,debit,payment,AU00000,5453f0a3-083c-43c6-9086-adfe94df9918,,,2022-04-19T00:00:00Z,,https://au-api.basiq.io/users/11103cba-4a08-4397-84a5-22ac125ed2f6/transactions/544ab34a-1a72-4c36-b5a7-e7f3b7313b2c,https://au-api.basiq.io/users/11103cba-4a08-4397-84a5-22ac125ed2f6/accounts/49544383-c19c-4c97-b8d1-5322d0faa6af,https://au-api.basiq.io/institutions/AU00000,,Regulatory Services,772
transaction,8c8ebdb4-265e-4766-9501-a3352e65e024,posted,MYER ADELAIDE CITY ADEL,-14.95,49544383-c19c-4c97-b8d1-5322d0faa6af,-3195.17,debit,payment,AU00000,5453f0a3-083c-43c6-9086-adfe94df9918,,,2022-04-19T00:00:00Z,,https://au-api.basiq.io/users/11103cba-4a08-4397-84a5-22ac125ed2f6/transactions/8c8ebdb4-265e-4766-9501-a3352e65e024,https://au-api.basiq.io/users/11103cba-4a08-4397-84a5-22ac125ed2f6/accounts/49544383-c19c-4c97-b8d1-5322d0faa6af,https://au-api.basiq.io/institutions/AU00000,,Department Stores,426
transaction,6216e0e5-ac60-4c1f-a329-e0fee3fc5ba1,posted,LUSH MYER CENTRE ADEL,-10.95,49544383-c19c-4c97-b8d1-5322d0faa6af,-3180.22,debit,payment,AU00000,5453f0a3-083c-43c6-9086-adfe94df9918,,,2022-04-19T00:00:00Z,,https://au-api.basiq.io/users/11103cba-4a08-4397-84a5-22ac125ed2f6/transactions/6216e0e5-ac60-4c1f-a329-e0fee3fc5ba1,https://au-api.basiq.io/users/11103cba-4a08-4397-84a5-22ac125ed2f6/accounts/49544383-c19c-4c97-b8d1-5322d0faa6af,https://au-api.basiq.io/institutions/AU00000,,Personal Care Services,951
transaction,f01bb880-7bce-4f3b-93f3-019804ee593e,posted,LE SOUK ACM PTY LTD ADELAID,-9.00,49544383-c19c-4c97-b8d1-5322d0faa6af,-3169.27,debit,payment,AU00000,5453f0a3-083c-43c6-9086-adfe94df9918,,,2022-04-19T00:00:00Z,,https://au-api.basiq.io/users/11103cba-4a08-4397-84a5-22ac125ed2f6/transactions/f01bb880-7bce-4f3b-93f3-019804ee593e,https://au-api.basiq.io/users/11103cba-4a08-4397-84a5-22ac125ed2f6/accounts/49544383-c19c-4c97-b8d1-5322d0faa6af,https://au-api.basiq.io/institutions/AU00000,,"Cafes, Restaurants and Takeaway Food Services",451
transaction,1560cbdf-7599-4062-bce5-2a4169b16330,posted,CITY OF ADELAIDE ADEL,-5.00,49544383-c19c-4c97-b8d1-5322d0faa6af,-3160.27,debit,payment,AU00000,5453f0a3-083c-43c6-9086-adfe94df9918,,,2022-04-19T00:00:00Z,,https://au-api.basiq.io/users/11103cba-4a08-4397-84a5-22ac125ed2f6/transactions/1560cbdf-7599-4062-bce5-2a4169b16330,https://au-api.basiq.io/users/11103cba-4a08-4397-84a5-22ac125ed2f6/accounts/49544383-c19c-4c97-b8d1-5322d0faa6af,https://au-api.basiq.io/institutions/AU00000,,Regulatory Services,772
transaction,3c6cee35-d06a-4ced-a7d2-ed9660871460,posted,ADELAIDE METROCARD ADEL,-4.40,49544383-c19c-4c97-b8d1-5322d0faa6af,-3155.27,debit,payment,AU00000,5453f0a3-083c-43c6-9086-adfe94df9918,,,2022-04-19T00:00:00Z,,https://au-api.basiq.io/users/11103cba-4a08-4397-84a5-22ac125ed2f6/transactions/3c6cee35-d06a-4ced-a7d2-ed9660871460,https://au-api.basiq.io/users/11103cba-4a08-4397-84a5-22ac125ed2f6/accounts/49544383-c19c-4c97-b8d1-5322d0faa6af,https://au-api.basiq.io/institutions/AU00000,,Pipeline and Other Transport,502
transaction,fe8f470e-2601-4f67-b378-86ec1ca2a5e6,posted,ADELAIDE METROCARD ADEL,-2.30,49544383-c19c-4c97-b8d1-5322d0faa6af,-3150.87,debit,payment,AU00000,5453f0a3-083c-43c6-9086-adfe94df9918,,,2022-04-19T00:00:00Z,,https://au-api.basiq.io/users/11103cba-4a08-4397-84a5-22ac125ed2f6/transactions/fe8f470e-2601-4f67-b378-86ec1ca2a5e6,https://au-api.basiq.io/users/11103cba-4a08-4397-84a5-22ac125ed2f6/accounts/49544383-c19c-4c97-b8d1-5322d0faa6af,https://au-api.basiq.io/institutions/AU00000,,Pipeline and Other Transport,502
transaction,abc62029-73af-4ded-8f7d-1b4bb694302e,posted,ADELAIDE METROCARD ADEL,-2.30,49544383-c19c-4c97-b8d1-5322d0faa6af,-3148.57,debit,payment,AU00000,5453f0a3-083c-43c6-9086-adfe94df9918,,,2022-04-19T00:00:00Z,,https://au-api.basiq.io/users/11103cba-4a08-4397-84a5-22ac125ed2f6/transactions/abc62029-73af-4ded-8f7d-1b4bb694302e,https://au-api.basiq.io/users/11103cba-4a08-4397-84a5-22ac125ed2f6/accounts/49544383-c19c-4c97-b8d1-5322d0faa6af,https://au-api.basiq.io/institutions/AU00000,,Pipeline and Other Transport,502
transaction,2d7d21a9-7a6a-4b1a-9f8b-91059d17b69e,posted,REFUND  20/12,11.00,49544383-c19c-4c97-b8d1-5322d0faa6af,-3146.27,credit,refund,AU00000,5453f0a3-083c-43c6-9086-adfe94df9918,,,2022-04-19T00:00:00Z,,https://au-api.basiq.io/users/11103cba-4a08-4397-84a5-22ac125ed2f6/transactions/2d7d21a9-7a6a-4b1a-9f8b-91059d17b69e,https://au-api.basiq.io/users/11103cba-4a08-4397-84a5-22ac125ed2f6/accounts/49544383-c19c-4c97-b8d1-5322d0faa6af,https://au-api.basiq.io/institutions/AU00000,,,
transaction,5b3bf4a7-9634-4727-a7c3-fc3077c46141,posted,REFUND  ADELAIDE     AU,46.01,49544383-c19c-4c97-b8d1-5322d0faa6af,-3157.27,credit,refund,AU00000,5453f0a3-083c-43c6-9086-adfe94df9918,,,2022-04-19T00:00:00Z,,https://au-api.basiq.io/users/11103cba-4a08-4397-84a5-22ac125ed2f6/transactions/5b3bf4a7-9634-4727-a7c3-fc3077c46141,https://au-api.basiq.io/users/11103cba-4a08-4397-84a5-22ac125ed2f6/accounts/49544383-c19c-4c97-b8d1-5322d0faa6af,https://au-api.basiq.io/institutions/AU00000,,,
transaction,396bfb9b-9829-4480-ada1-74f1380c8bcd,posted,HAIGH RETAIL PTY LTD ADELAIDE AU,-42.45,49544383-c19c-4c97-b8d1-5322d0faa6af,-3203.28,debit,payment,AU00000,5453f0a3-083c-43c6-9086-adfe94df9918,,,2022-04-19T00:00:00Z,,https://au-api.basiq.io/users/11103cba-4a08-4397-84a5-22ac125ed2f6/transactions/396bfb9b-9829-4480-ada1-74f1380c8bcd,https://au-api.basiq.io/users/11103cba-4a08-4397-84a5-22ac125ed2f6/accounts/49544383-c19c-4c97-b8d1-5322d0faa6af,https://au-api.basiq.io/institutions/AU00000,,Specialised Food Retailing,412
transaction,3b9b932a-736e-4e48-83c5-569aea22c4a2,posted,SUSHI BAR MICHIRU ADELAIDE AU,-113.00,49544383-c19c-4c97-b8d1-5322d0faa6af,-3160.83,debit,payment,AU00000,5453f0a3-083c-43c6-9086-adfe94df9918,,,2022-04-19T00:00:00Z,,https://au-api.basiq.io/users/11103cba-4a08-4397-84a5-22ac125ed2f6/transactions/3b9b932a-736e-4e48-83c5-569aea22c4a2,https://au-api.basiq.io/users/11103cba-4a08-4397-84a5-22ac125ed2f6/accounts/49544383-c19c-4c97-b8d1-5322d0faa6af,https://au-api.basiq.io/institutions/AU00000,,"Cafes, Restaurants and Takeaway Food Services",451
transaction,1e517baf-ad63-4d08-bc18-eeb3661bdd91,posted,BUNNINGS 360000 WINDSOR GARDEAU,-10.98,49544383-c19c-4c97-b8d1-5322d0faa6af,-3047.83,debit,payment,AU00000,5453f0a3-083c-43c6-9086-adfe94df9918,,,2022-04-18T00:00:00Z,,https://au-api.basiq.io/users/11103cba-4a08-4397-84a5-22ac125ed2f6/transactions/1e517baf-ad63-4d08-bc18-eeb3661bdd91,https://au-api.basiq.io/users/11103cba-4a08-4397-84a5-22ac125ed2f6/accounts/49544383-c19c-4c97-b8d1-5322d0faa6af,https://au-api.basiq.io/institutions/AU00000,,"Hardware, Building and Garden Supplies Retailing",423
transaction,c3ee42a9-732c-4554-8fcf-547376f31fee,posted,KIKKI K PTY LTD ADEL,-193.58,49544383-c19c-4c97-b8d1-5322d0faa6af,-3036.85,debit,payment,AU00000,5453f0a3-083c-43c6-9086-adfe94df9918,,,2022-04-18T00:00:00Z,,https://au-api.basiq.io/users/11103cba-4a08-4397-84a5-22ac125ed2f6/transactions/c3ee42a9-732c-4554-8fcf-547376f31fee,https://au-api.basiq.io/users/11103cba-4a08-4397-84a5-22ac125ed2f6/accounts/49544383-c19c-4c97-b8d1-5322d0faa6af,https://au-api.basiq.io/institutions/AU00000,,Pharmaceutical and Other Store-Based Retailing,427
transaction,ee5e1acc-1ba6-49cc-bd88-e9f4694686f7,posted,ReadeBook (Hollywood) Sali,-83.94,49544383-c19c-4c97-b8d1-5322d0faa6af,-2843.27,debit,payment,AU00000,5453f0a3-083c-43c6-9086-adfe94df9918,,,2022-04-18T00:00:00Z,,https://au-api.basiq.io/users/11103cba-4a08-4397-84a5-22ac125ed2f6/transactions/ee5e1acc-1ba6-49cc-bd88-e9f4694686f7,https://au-api.basiq.io/users/11103cba-4a08-4397-84a5-22ac125ed2f6/accounts/49544383-c19c-4c97-b8d1-5322d0faa6af,https://au-api.basiq.io/institutions/AU00000,,Recreational Goods Retailing,424
transaction,fa7c6ed5-ce4b-4a74-abd3-8c90949bf665,posted,AG ADE RUNDLE MALL ADEL,-45.80,49544383-c19c-4c97-b8d1-5322d0faa6af,-2759.33,debit,payment,AU00000,5453f0a3-083c-43c6-9086-adfe94df9918,,,2022-04-18T00:00:00Z,,https://au-api.basiq.io/users/11103cba-4a08-4397-84a5-22ac125ed2f6/transactions/fa7c6ed5-ce4b-4a74-abd3-8c90949bf665,https://au-api.basiq.io/users/11103cba-4a08-4397-84a5-22ac125ed2f6/accounts/49544383-c19c-4c97-b8d1-5322d0faa6af,https://au-api.basiq.io/institutions/AU00000,,Pharmaceutical and Other Store-Based Retailing,427
transaction,48c5437c-7348-4630-b2ea-8c7f9319aea4,posted,LET THEM EAT ADEL,-44.00,49544383-c19c-4c97-b8d1-5322d0faa6af,-2713.53,debit,payment,AU00000,5453f0a3-083c-43c6-9086-adfe94df9918,,,2022-04-18T00:00:00Z,,https://au-api.basiq.io/users/11103cba-4a08-4397-84a5-22ac125ed2f6/transactions/48c5437c-7348-4630-b2ea-8c7f9319aea4,https://au-api.basiq.io/users/11103cba-4a08-4397-84a5-22ac125ed2f6/accounts/49544383-c19c-4c97-b8d1-5322d0faa6af,https://au-api.basiq.io/institutions/AU00000,,"Cafes, Restaurants and Takeaway Food Services",451
transaction,4cb43015-f342-4156-b8d0-122b928ca365,posted,FEAST FINE FOODS ADEL,-37.29,49544383-c19c-4c97-b8d1-5322d0faa6af,-2669.53,debit,payment,AU00000,5453f0a3-083c-43c6-9086-adfe94df9918,,,2022-04-18T00:00:00Z,,https://au-api.basiq.io/users/11103cba-4a08-4397-84a5-22ac125ed2f6/transactions/4cb43015-f342-4156-b8d0-122b928ca365,https://au-api.basiq.io/users/11103cba-4a08-4397-84a5-22ac125ed2f6/accounts/49544383-c19c-4c97-b8d1-5322d0faa6af,https://au-api.basiq.io/institutions/AU00000,,Specialised Food Retailing,412
transaction,b80e4f88-6132-4dd5-8aa6-df4e87cd3f95,posted,NICK & ANN PESSIOS ADEL,-36.70,49544383-c19c-4c97-b8d1-5322d0faa6af,-2632.24,debit,payment,AU00000,5453f0a3-083c-43c6-9086-adfe94df9918,,,2022-04-18T00:00:00Z,,https://au-api.basiq.io/users/11103cba-4a08-4397-84a5-22ac125ed2f6/transactions/b80e4f88-6132-4dd5-8aa6-df4e87cd3f95,https://au-api.basiq.io/users/11103cba-4a08-4397-84a5-22ac125ed2f6/accounts/49544383-c19c-4c97-b8d1-5322d0faa6af,https://au-api.basiq.io/institutions/AU00000,,Supermarket and Grocery Stores,411
transaction,cd8e5883-de01-491d-9280-18ebae9c639b,posted,CAFE BRUNELLI ADAL,-27.00,49544383-c19c-4c97-b8d1-5322d0faa6af,-2595.54,debit,payment,AU00000,5453f0a3-083c-43c6-9086-adfe94df9918,,,2022-04-18T00:00:00Z,,https://au-api.basiq.io/users/11103cba-4a08-4397-84a5-22ac125ed2f6/transactions/cd8e5883-de01-491d-9280-18ebae9c639b,https://au-api.basiq.io/users/11103cba-4a08-4397-84a5-22ac125ed2f6/accounts/49544383-c19c-4c97-b8d1-5322d0faa6af,https://au-api.basiq.io/institutions/AU00000,,"Cafes, Restaurants and Takeaway Food Services",451
transaction,8e6519d3-767b-4eda-b9a0-a50f09a93318,posted,THE REJECT SHOP AUST ADEL,-18.00,49544383-c19c-4c97-b8d1-5322d0faa6af,-2568.54,debit,payment,AU00000,5453f0a3-083c-43c6-9086-adfe94df9918,,,2022-04-18T00:00:00Z,,https://au-api.basiq.io/users/11103cba-4a08-4397-84a5-22ac125ed2f6/transactions/8e6519d3-767b-4eda-b9a0-a50f09a93318,https://au-api.basiq.io/users/11103cba-4a08-4397-84a5-22ac125ed2f6/accounts/49544383-c19c-4c97-b8d1-5322d0faa6af,https://au-api.basiq.io/institutions/AU00000,,Pharmaceutical and Other Store-Based Retailing,427
transaction,8510589c-9a46-4058-b35e-84d5298a3a9f,posted,CITY OF ADELAIDE ADEL,-14.00,49544383-c19c-4c97-b8d1-5322d0faa6af,-2550.54,debit,payment,AU00000,5453f0a3-083c-43c6-9086-adfe94df9918,,,2022-04-18T00:00:00Z,,https://au-api.basiq.io/users/11103cba-4a08-4397-84a5-22ac125ed2f6/transactions/8510589c-9a46-4058-b35e-84d5298a3a9f,https://au-api.basiq.io/users/11103cba-4a08-4397-84a5-22ac125ed2f6/accounts/49544383-c19c-4c97-b8d1-5322d0faa6af,https://au-api.basiq.io/institutions/AU00000,,Regulatory Services,772
transaction,8511e46f-def7-42be-b40c-937c2586be48,posted,KMART 1211 ADEL,-11.00,49544383-c19c-4c97-b8d1-5322d0faa6af,-2536.54,debit,payment,AU00000,5453f0a3-083c-43c6-9086-adfe94df9918,,,2022-04-18T00:00:00Z,,https://au-api.basiq.io/users/11103cba-4a08-4397-84a5-22ac125ed2f6/transactions/8511e46f-def7-42be-b40c-937c2586be48,https://au-api.basiq.io/users/11103cba-4a08-4397-84a5-22ac125ed2f6/accounts/49544383-c19c-4c97-b8d1-5322d0faa6af,https://au-api.basiq.io/institutions/AU00000,,Department Stores,426
transaction,e4b7bba5-038b-48fc-9410-f94d88998e5e,posted,HAIGH RETAIL PTY LTD ADEL,-10.85,49544383-c19c-4c97-b8d1-5322d0faa6af,-2525.54,debit,payment,AU00000,5453f0a3-083c-43c6-9086-adfe94df9918,,,2022-04-18T00:00:00Z,,https://au-api.basiq.io/users/11103cba-4a08-4397-84a5-22ac125ed2f6/transactions/e4b7bba5-038b-48fc-9410-f94d88998e5e,https://au-api.basiq.io/users/11103cba-4a08-4397-84a5-22ac125ed2f6/accounts/49544383-c19c-4c97-b8d1-5322d0faa6af,https://au-api.basiq.io/institutions/AU00000,,Specialised Food Retailing,412
transaction,3bea2fb5-0e57-4b29-9a5f-cf9b9f5ed4a1,posted,ADELAIDE METROCARD ADEL,-6.30,49544383-c19c-4c97-b8d1-5322d0faa6af,-2514.69,debit,payment,AU00000,5453f0a3-083c-43c6-9086-adfe94df9918,,,2022-04-18T00:00:00Z,,https://au-api.basiq.io/users/11103cba-4a08-4397-84a5-22ac125ed2f6/transactions/3bea2fb5-0e57-4b29-9a5f-cf9b9f5ed4a1,https://au-api.basiq.io/users/11103cba-4a08-4397-84a5-22ac125ed2f6/accounts/49544383-c19c-4c97-b8d1-5322d0faa6af,https://au-api.basiq.io/institutions/AU00000,,Pipeline and Other Transport,502
transaction,9362bc4f-9d80-4663-ae9b-f6f2e5d3274c,posted,HJ GILLIES PLAINS ADELAIDE SA AU,-8.95,49544383-c19c-4c97-b8d1-5322d0faa6af,-2508.39,debit,payment,AU00000,5453f0a3-083c-43c6-9086-adfe94df9918,,,2022-04-17T00:00:00Z,,https://au-api.basiq.io/users/11103cba-4a08-4397-84a5-22ac125ed2f6/transactions/9362bc4f-9d80-4663-ae9b-f6f2e5d3274c,https://au-api.basiq.io/users/11103cba-4a08-4397-84a5-22ac125ed2f6/accounts/49544383-c19c-4c97-b8d1-5322d0faa6af,https://au-api.basiq.io/institutions/AU00000,,"Cafes, Restaurants and Takeaway Food Services",451
transaction,342baab7-ebdd-423f-b95d-afdeedb6310c,posted,WHYALLA FOODLAND IGA WHYA,-63.31,49544383-c19c-4c97-b8d1-5322d0faa6af,-2499.44,debit,payment,AU00000,5453f0a3-083c-43c6-9086-adfe94df9918,,,2022-04-17T00:00:00Z,,https://au-api.basiq.io/users/11103cba-4a08-4397-84a5-22ac125ed2f6/transactions/342baab7-ebdd-423f-b95d-afdeedb6310c,https://au-api.basiq.io/users/11103cba-4a08-4397-84a5-22ac125ed2f6/accounts/49544383-c19c-4c97-b8d1-5322d0faa6af,https://au-api.basiq.io/institutions/AU00000,,Supermarket and Grocery Stores,411
transaction,4895a7b9-1bad-48ae-8955-11e50be13db7,posted,MOGAS KERSBROOK KERS,-13.80,49544383-c19c-4c97-b8d1-5322d0faa6af,-2436.13,debit,payment,AU00000,5453f0a3-083c-43c6-9086-adfe94df9918,,,2022-04-17T00:00:00Z,,https://au-api.basiq.io/users/11103cba-4a08-4397-84a5-22ac125ed2f6/transactions/4895a7b9-1bad-48ae-8955-11e50be13db7,https://au-api.basiq.io/users/11103cba-4a08-4397-84a5-22ac125ed2f6/accounts/49544383-c19c-4c97-b8d1-5322d0faa6af,https://au-api.basiq.io/institutions/AU00000,,Fuel Retailing,400
transaction,812e9b17-8be0-4b42-be7c-f77dbf41fa64,posted,JAMIES ITALIAN ADELA ADELAIDE AU,-35.85,49544383-c19c-4c97-b8d1-5322d0faa6af,-2422.33,debit,payment,AU00000,5453f0a3-083c-43c6-9086-adfe94df9918,,,2022-04-16T00:00:00Z,,https://au-api.basiq.io/users/11103cba-4a08-4397-84a5-22ac125ed2f6/transactions/812e9b17-8be0-4b42-be7c-f77dbf41fa64,https://au-api.basiq.io/users/11103cba-4a08-4397-84a5-22ac125ed2f6/accounts/49544383-c19c-4c97-b8d1-5322d0faa6af,https://au-api.basiq.io/institutions/AU00000,,"Cafes, Restaurants and Takeaway Food Services",451
transaction,865e5bef-c242-408a-8ea9-18fef9d2c0fa,posted,TOYWORLD ADELAIDE CI ADELAIDE AU,-188.93,49544383-c19c-4c97-b8d1-5322d0faa6af,-2386.48,debit,payment,AU00000,5453f0a3-083c-43c6-9086-adfe94df9918,,,2022-04-16T00:00:00Z,,https://au-api.basiq.io/users/11103cba-4a08-4397-84a5-22ac125ed2f6/transactions/865e5bef-c242-408a-8ea9-18fef9d2c0fa,https://au-api.basiq.io/users/11103cba-4a08-4397-84a5-22ac125ed2f6/accounts/49544383-c19c-4c97-b8d1-5322d0faa6af,https://au-api.basiq.io/institutions/AU00000,,Recreational Goods Retailing,424
transaction,0a049e80-801b-4d63-8b9f-227933bde541,posted,MURTFAM PTY LTD BELAIR AU,-148.00,49544383-c19c-4c97-b8d1-5322d0faa6af,-2197.55,debit,payment,AU00000,5453f0a3-083c-43c6-9086-adfe94df9918,,,2022-04-15T00:00:00Z,,https://au-api.basiq.io/users/11103cba-4a08-4397-84a5-22ac125ed2f6/transactions/0a049e80-801b-4d63-8b9f-227933bde541,https://au-api.basiq.io/users/11103cba-4a08-4397-84a5-22ac125ed2f6/accounts/49544383-c19c-4c97-b8d1-5322d0faa6af,https://au-api.basiq.io/institutions/AU00000,,Sports and Physical Recreation Activities,911
transaction,bef4d7cf-0c44-4dfa-9a2e-672ef8cce2ca,posted,FIRST DROP WINES ATHELSTONE AU,-180.00,49544383-c19c-4c97-b8d1-5322d0faa6af,-2049.55,debit,payment,AU00000,5453f0a3-083c-43c6-9086-adfe94df9918,,,2022-04-15T00:00:00Z,,https://au-api.basiq.io/users/11103cba-4a08-4397-84a5-22ac125ed2f6/transactions/bef4d7cf-0c44-4dfa-9a2e-672ef8cce2ca,https://au-api.basiq.io/users/11103cba-4a08-4397-84a5-22ac125ed2f6/accounts/49544383-c19c-4c97-b8d1-5322d0faa6af,https://au-api.basiq.io/institutions/AU00000,,Specialised Food Retailing,412
transaction,7aee4584-790e-48d0-8b35-29876eeadc0e,posted,DHP WHYALLA WHYA,-85.00,49544383-c19c-4c97-b8d1-5322d0faa6af,-1869.55,debit,payment,AU00000,5453f0a3-083c-43c6-9086-adfe94df9918,,,2022-04-14T00:00:00Z,,https://au-api.basiq.io/users/11103cba-4a08-4397-84a5-22ac125ed2f6/transactions/7aee4584-790e-48d0-8b35-29876eeadc0e,https://au-api.basiq.io/users/11103cba-4a08-4397-84a5-22ac125ed2f6/accounts/49544383-c19c-4c97-b8d1-5322d0faa6af,https://au-api.basiq.io/institutions/AU00000,,Accommodation,440
transaction,fa678e09-7201-4908-b4e6-55eedb68c31d,posted,TUMBY BAY BAKERY TUMBY B,-26.00,49544383-c19c-4c97-b8d1-5322d0faa6af,-1784.55,debit,payment,AU00000,5453f0a3-083c-43c6-9086-adfe94df9918,,,2022-04-14T00:00:00Z,,https://au-api.basiq.io/users/11103cba-4a08-4397-84a5-22ac125ed2f6/transactions/fa678e09-7201-4908-b4e6-55eedb68c31d,https://au-api.basiq.io/users/11103cba-4a08-4397-84a5-22ac125ed2f6/accounts/49544383-c19c-4c97-b8d1-5322d0faa6af,https://au-api.basiq.io/institutions/AU00000,,Specialised Food Retailing,412
transaction,f80cf40e-9aaa-4150-b6e5-c01d30f10e24,posted,DRAKES SUPERMARKETS PORT,-23.33,49544383-c19c-4c97-b8d1-5322d0faa6af,-1758.55,debit,payment,AU00000,5453f0a3-083c-43c6-9086-adfe94df9918,,,2022-04-14T00:00:00Z,,https://au-api.basiq.io/users/11103cba-4a08-4397-84a5-22ac125ed2f6/transactions/f80cf40e-9aaa-4150-b6e5-c01d30f10e24,https://au-api.basiq.io/users/11103cba-4a08-4397-84a5-22ac125ed2f6/accounts/49544383-c19c-4c97-b8d1-5322d0faa6af,https://au-api.basiq.io/institutions/AU00000,,Supermarket and Grocery Stores,411
transaction,ee128b31-dc78-4c06-8b35-68183e5ef4b7,posted,COLES EXPRESS 1934 WHYALLA AU,-299.77,49544383-c19c-4c97-b8d1-5322d0faa6af,-1735.22,debit,payment,AU00000,5453f0a3-083c-43c6-9086-adfe94df9918,,,2022-04-14T00:00:00Z,,https://au-api.basiq.io/users/11103cba-4a08-4397-84a5-22ac125ed2f6/transactions/ee128b31-dc78-4c06-8b35-68183e5ef4b7,https://au-api.basiq.io/users/11103cba-4a08-4397-84a5-22ac125ed2f6/accounts/49544383-c19c-4c97-b8d1-5322d0faa6af,https://au-api.basiq.io/institutions/AU00000,,Fuel Retailing,400
transaction,d113e2da-a8be-4c66-adec-97b925a0df65,posted,MURTFAM PTY LTD BELA,-50.00,49544383-c19c-4c97-b8d1-5322d0faa6af,-1435.45,debit,payment,AU00000,5453f0a3-083c-43c6-9086-adfe94df9918,,,2022-04-13T00:00:00Z,,https://au-api.basiq.io/users/11103cba-4a08-4397-84a5-22ac125ed2f6/transactions/d113e2da-a8be-4c66-adec-97b925a0df65,https://au-api.basiq.io/users/11103cba-4a08-4397-84a5-22ac125ed2f6/accounts/49544383-c19c-4c97-b8d1-5322d0faa6af,https://au-api.basiq.io/institutions/AU00000,,Sports and Physical Recreation Activities,911
transaction,e5e52613-aaaa-4427-b59f-58395605f403,posted,COFFIN BAY CARAVAN COFF,-41.00,49544383-c19c-4c97-b8d1-5322d0faa6af,-1385.45,debit,payment,AU00000,5453f0a3-083c-43c6-9086-adfe94df9918,,,2022-04-12T00:00:00Z,,https://au-api.basiq.io/users/11103cba-4a08-4397-84a5-22ac125ed2f6/transactions/e5e52613-aaaa-4427-b59f-58395605f403,https://au-api.basiq.io/users/11103cba-4a08-4397-84a5-22ac125ed2f6/accounts/49544383-c19c-4c97-b8d1-5322d0faa6af,https://au-api.basiq.io/institutions/AU00000,,Accommodation,440
transaction,ee94afb5-be0f-41bc-90ba-f408322a0bba,posted,LIQUORLAND 3022 PORT LINCOLN AU,-64.00,49544383-c19c-4c97-b8d1-5322d0faa6af,-1344.45,debit,payment,AU00000,5453f0a3-083c-43c6-9086-adfe94df9918,,,2022-04-12T00:00:00Z,,https://au-api.basiq.io/users/11103cba-4a08-4397-84a5-22ac125ed2f6/transactions/ee94afb5-be0f-41bc-90ba-f408322a0bba,https://au-api.basiq.io/users/11103cba-4a08-4397-84a5-22ac125ed2f6/accounts/49544383-c19c-4c97-b8d1-5322d0faa6af,https://au-api.basiq.io/institutions/AU00000,,Specialised Food Retailing,412
transaction,4b5045fe-4127-4922-b823-98b68aa55b4d,posted,COLES 0440 PORT LINCOLN AU,-173.40,49544383-c19c-4c97-b8d1-5322d0faa6af,-1280.45,debit,payment,AU00000,5453f0a3-083c-43c6-9086-adfe94df9918,,,2022-04-12T00:00:00Z,,https://au-api.basiq.io/users/11103cba-4a08-4397-84a5-22ac125ed2f6/transactions/4b5045fe-4127-4922-b823-98b68aa55b4d,https://au-api.basiq.io/users/11103cba-4a08-4397-84a5-22ac125ed2f6/accounts/49544383-c19c-4c97-b8d1-5322d0faa6af,https://au-api.basiq.io/institutions/AU00000,,Supermarket and Grocery Stores,411
transaction,5143af81-2508-4d42-944e-9e8cf788a6d7,posted,G PEDEMONTE MANUFACT PORT LINCOLN,-50.95,49544383-c19c-4c97-b8d1-5322d0faa6af,-1107.05,debit,payment,AU00000,5453f0a3-083c-43c6-9086-adfe94df9918,,,2022-04-12T00:00:00Z,,https://au-api.basiq.io/users/11103cba-4a08-4397-84a5-22ac125ed2f6/transactions/5143af81-2508-4d42-944e-9e8cf788a6d7,https://au-api.basiq.io/users/11103cba-4a08-4397-84a5-22ac125ed2f6/accounts/49544383-c19c-4c97-b8d1-5322d0faa6af,https://au-api.basiq.io/institutions/AU00000,,"Clothing, Footwear and Personal Accessory Retailing",425
transaction,759b4861-b434-438e-9232-c2d7ab42a8e4,posted,BUNNINGS 384000 PORT LINCOLN AU,-42.89,49544383-c19c-4c97-b8d1-5322d0faa6af,-1056.10,debit,payment,AU00000,5453f0a3-083c-43c6-9086-adfe94df9918,,,2022-04-12T00:00:00Z,,https://au-api.basiq.io/users/11103cba-4a08-4397-84a5-22ac125ed2f6/transactions/759b4861-b434-438e-9232-c2d7ab42a8e4,https://au-api.basiq.io/users/11103cba-4a08-4397-84a5-22ac125ed2f6/accounts/49544383-c19c-4c97-b8d1-5322d0faa6af,https://au-api.basiq.io/institutions/AU00000,,"Hardware, Building and Garden Supplies Retailing",423
transaction,08923663-ce36-45ce-a737-56ee814d263c,posted,Cash Wdr  COFFIN BAY   AU,-203.50,49544383-c19c-4c97-b8d1-5322d0faa6af,-1013.21,debit,cash-withdrawal,AU00000,5453f0a3-083c-43c6-9086-adfe94df9918,,,2022-04-11T00:00:00Z,,https://au-api.basiq.io/users/11103cba-4a08-4397-84a5-22ac125ed2f6/transactions/08923663-ce36-45ce-a737-56ee814d263c,https://au-api.basiq.io/users/11103cba-4a08-4397-84a5-22ac125ed2f6/accounts/49544383-c19c-4c97-b8d1-5322d0faa6af,https://au-api.basiq.io/institutions/AU00000,,,
transaction,5e2c88c5-3508-4f48-aceb-141079025faf,posted,Coffin Bay Yacht Club COFF,-59.00,49544383-c19c-4c97-b8d1-5322d0faa6af,-809.71,debit,payment,AU00000,5453f0a3-083c-43c6-9086-adfe94df9918,,,2022-04-11T00:00:00Z,,https://au-api.basiq.io/users/11103cba-4a08-4397-84a5-22ac125ed2f6/transactions/5e2c88c5-3508-4f48-aceb-141079025faf,https://au-api.basiq.io/users/11103cba-4a08-4397-84a5-22ac125ed2f6/accounts/49544383-c19c-4c97-b8d1-5322d0faa6af,https://au-api.basiq.io/institutions/AU00000,,Sports and Physical Recreation Activities,911
transaction,c6965040-718f-4dc8-9cc3-947bb55fc607,posted,COFFIN BAY GETAWAY ACCOMMCOFF,-48.00,49544383-c19c-4c97-b8d1-5322d0faa6af,-750.71,debit,payment,AU00000,5453f0a3-083c-43c6-9086-adfe94df9918,,,2022-04-11T00:00:00Z,,https://au-api.basiq.io/users/11103cba-4a08-4397-84a5-22ac125ed2f6/transactions/c6965040-718f-4dc8-9cc3-947bb55fc607,https://au-api.basiq.io/users/11103cba-4a08-4397-84a5-22ac125ed2f6/accounts/49544383-c19c-4c97-b8d1-5322d0faa6af,https://au-api.basiq.io/institutions/AU00000,,Accommodation,440
transaction,0d422c36-c889-4b42-86d4-4055de51312d,posted,COFFIN BAY CARAVAN COFF,-41.00,49544383-c19c-4c97-b8d1-5322d0faa6af,-702.71,debit,payment,AU00000,5453f0a3-083c-43c6-9086-adfe94df9918,,,2022-04-11T00:00:00Z,,https://au-api.basiq.io/users/11103cba-4a08-4397-84a5-22ac125ed2f6/transactions/0d422c36-c889-4b42-86d4-4055de51312d,https://au-api.basiq.io/users/11103cba-4a08-4397-84a5-22ac125ed2f6/accounts/49544383-c19c-4c97-b8d1-5322d0faa6af,https://au-api.basiq.io/institutions/AU00000,,Accommodation,440
transaction,1ab13492-b268-4fe8-b105-d7d6785a2aa1,posted,BEACHCOMBER AGENCIES COFF,-6.80,49544383-c19c-4c97-b8d1-5322d0faa6af,-661.71,debit,payment,AU00000,5453f0a3-083c-43c6-9086-adfe94df9918,,,2022-04-11T00:00:00Z,,https://au-api.basiq.io/users/11103cba-4a08-4397-84a5-22ac125ed2f6/transactions/1ab13492-b268-4fe8-b105-d7d6785a2aa1,https://au-api.basiq.io/users/11103cba-4a08-4397-84a5-22ac125ed2f6/accounts/49544383-c19c-4c97-b8d1-5322d0faa6af,https://au-api.basiq.io/institutions/AU00000,,Specialised Food Retailing,412
transaction,b1e85da9-591b-48e4-aaa0-cc216d416558,posted,DISTRICT COUNCIL STREAKY STRE,-40.00,49544383-c19c-4c97-b8d1-5322d0faa6af,-654.91,debit,payment,AU00000,5453f0a3-083c-43c6-9086-adfe94df9918,,,2022-04-10T00:00:00Z,,https://au-api.basiq.io/users/11103cba-4a08-4397-84a5-22ac125ed2f6/transactions/b1e85da9-591b-48e4-aaa0-cc216d416558,https://au-api.basiq.io/users/11103cba-4a08-4397-84a5-22ac125ed2f6/accounts/49544383-c19c-4c97-b8d1-5322d0faa6af,https://au-api.basiq.io/institutions/AU00000,,Regulatory Services,772
transaction,5ef4154d-a088-4390-8821-7dd57005f969,posted,COFFIN BAY CARAVAN COFFIN BAY AU,-81.00,49544383-c19c-4c97-b8d1-5322d0faa6af,-614.91,debit,payment,AU00000,5453f0a3-083c-43c6-9086-adfe94df9918,,,2022-04-09T00:00:00Z,,https://au-api.basiq.io/users/11103cba-4a08-4397-84a5-22ac125ed2f6/transactions/5ef4154d-a088-4390-8821-7dd57005f969,https://au-api.basiq.io/users/11103cba-4a08-4397-84a5-22ac125ed2f6/accounts/49544383-c19c-4c97-b8d1-5322d0faa6af,https://au-api.basiq.io/institutions/AU00000,,Accommodation,440
transaction,1853c005-62f5-4fb2-9827-8c1957d2a4b0,posted,STREAKY BAY FOODLAND STREAKY BAY AU,-115.59,49544383-c19c-4c97-b8d1-5322d0faa6af,-533.91,debit,payment,AU00000,5453f0a3-083c-43c6-9086-adfe94df9918,,,2022-04-08T00:00:00Z,,https://au-api.basiq.io/users/11103cba-4a08-4397-84a5-22ac125ed2f6/transactions/1853c005-62f5-4fb2-9827-8c1957d2a4b0,https://au-api.basiq.io/users/11103cba-4a08-4397-84a5-22ac125ed2f6/accounts/49544383-c19c-4c97-b8d1-5322d0faa6af,https://au-api.basiq.io/institutions/AU00000,,Supermarket and Grocery Stores,411
transaction,8874b9fa-fc6b-419f-9dba-3e022693ac12,posted,BRACE MOBIL PTY LTD STREAKY BAY AU,-238.18,49544383-c19c-4c97-b8d1-5322d0faa6af,-418.32,debit,payment,AU00000,5453f0a3-083c-43c6-9086-adfe94df9918,,,2022-04-08T00:00:00Z,,https://au-api.basiq.io/users/11103cba-4a08-4397-84a5-22ac125ed2f6/transactions/8874b9fa-fc6b-419f-9dba-3e022693ac12,https://au-api.basiq.io/users/11103cba-4a08-4397-84a5-22ac125ed2f6/accounts/49544383-c19c-4c97-b8d1-5322d0faa6af,https://au-api.basiq.io/institutions/AU00000,,Fuel Retailing,400
transaction,d6b88e8c-391c-47da-9237-225feb79a911,posted,BECK BROTHER IGA STRE,-93.61,49544383-c19c-4c97-b8d1-5322d0faa6af,-180.14,debit,payment,AU00000,5453f0a3-083c-43c6-9086-adfe94df9918,,,2022-04-07T00:00:00Z,,https://au-api.basiq.io/users/11103cba-4a08-4397-84a5-22ac125ed2f6/transactions/d6b88e8c-391c-47da-9237-225feb79a911,https://au-api.basiq.io/users/11103cba-4a08-4397-84a5-22ac125ed2f6/accounts/49544383-c19c-4c97-b8d1-5322d0faa6af,https://au-api.basiq.io/institutions/AU00000,,Supermarket and Grocery Stores,411
transaction,bc54474d-9c04-4abe-939e-477fe944ecfd,posted,VISITOR INFO CENTRE STRE,-41.00,49544383-c19c-4c97-b8d1-5322d0faa6af,-86.53,debit,payment,AU00000,5453f0a3-083c-43c6-9086-adfe94df9918,,,2022-04-07T00:00:00Z,,https://au-api.basiq.io/users/11103cba-4a08-4397-84a5-22ac125ed2f6/transactions/bc54474d-9c04-4abe-939e-477fe944ecfd,https://au-api.basiq.io/users/11103cba-4a08-4397-84a5-22ac125ed2f6/accounts/49544383-c19c-4c97-b8d1-5322d0faa6af,https://au-api.basiq.io/institutions/AU00000,,Amusement and Other Recreation Activities,913
transaction,26a2817c-2b60-413d-9bcf-298df102ffbd,posted,SHELLY BEACH CARAVAN CEDU,-40.90,49544383-c19c-4c97-b8d1-5322d0faa6af,-45.53,debit,payment,AU00000,5453f0a3-083c-43c6-9086-adfe94df9918,,,2022-04-07T00:00:00Z,,https://au-api.basiq.io/users/11103cba-4a08-4397-84a5-22ac125ed2f6/transactions/26a2817c-2b60-413d-9bcf-298df102ffbd,https://au-api.basiq.io/users/11103cba-4a08-4397-84a5-22ac125ed2f6/accounts/49544383-c19c-4c97-b8d1-5322d0faa6af,https://au-api.basiq.io/institutions/AU00000,,Accommodation,440
transaction,9ce7dadd-71ee-47c7-a8d2-693f06c9c340,posted,BECK BROTHER IGA STRE,-22.68,49544383-c19c-4c97-b8d1-5322d0faa6af,-4.63,debit,payment,AU00000,5453f0a3-083c-43c6-9086-adfe94df9918,,,2022-04-07T00:00:00Z,,https://au-api.basiq.io/users/11103cba-4a08-4397-84a5-22ac125ed2f6/transactions/9ce7dadd-71ee-47c7-a8d2-693f06c9c340,https://au-api.basiq.io/users/11103cba-4a08-4397-84a5-22ac125ed2f6/accounts/49544383-c19c-4c97-b8d1-5322d0faa6af,https://au-api.basiq.io/institutions/AU00000,,Supermarket and Grocery Stores,411
transaction,8c70d40b-1bac-4528-9689-fa6afbaf4017,posted,STREAKY BAY HOTEL NO STREAKY BAY AU,-22.00,49544383-c19c-4c97-b8d1-5322d0faa6af,18.05,debit,payment,AU00000,5453f0a3-083c-43c6-9086-adfe94df9918,,,2022-04-07T00:00:00Z,,https://au-api.basiq.io/users/11103cba-4a08-4397-84a5-22ac125ed2f6/transactions/8c70d40b-1bac-4528-9689-fa6afbaf4017,https://au-api.basiq.io/users/11103cba-4a08-4397-84a5-22ac125ed2f6/accounts/49544383-c19c-4c97-b8d1-5322d0faa6af,https://au-api.basiq.io/institutions/AU00000,,Accommodation,440
transaction,9b455ecd-511c-4fb1-9737-588ad46bc41d,posted,BAY FUNKTION STREAKY BAY AU,-80.00,49544383-c19c-4c97-b8d1-5322d0faa6af,40.05,debit,payment,AU00000,5453f0a3-083c-43c6-9086-adfe94df9918,,,2022-04-07T00:00:00Z,,https://au-api.basiq.io/users/11103cba-4a08-4397-84a5-22ac125ed2f6/transactions/9b455ecd-511c-4fb1-9737-588ad46bc41d,https://au-api.basiq.io/users/11103cba-4a08-4397-84a5-22ac125ed2f6/accounts/49544383-c19c-4c97-b8d1-5322d0faa6af,https://au-api.basiq.io/institutions/AU00000,,"Cafes, Restaurants and Takeaway Food Services",451
transaction,267fb905-83ea-451e-bbfd-2c792fbe7687,posted,DISTRICT COUNCIL STR STREAKY BAY AU,-40.00,49544383-c19c-4c97-b8d1-5322d0faa6af,120.05,debit,payment,AU00000,5453f0a3-083c-43c6-9086-adfe94df9918,,,2022-04-06T00:00:00Z,,https://au-api.basiq.io/users/11103cba-4a08-4397-84a5-22ac125ed2f6/transactions/267fb905-83ea-451e-bbfd-2c792fbe7687,https://au-api.basiq.io/users/11103cba-4a08-4397-84a5-22ac125ed2f6/accounts/49544383-c19c-4c97-b8d1-5322d0faa6af,https://au-api.basiq.io/institutions/AU00000,,Regulatory Services,772
transaction,7324043a-b6fd-448d-844d-ef5cb67bb8f5,posted,CEDUNA FOODLAND CEDU,-52.30,49544383-c19c-4c97-b8d1-5322d0faa6af,160.05,debit,payment,AU00000,5453f0a3-083c-43c6-9086-adfe94df9918,,,2022-04-06T00:00:00Z,,https://au-api.basiq.io/users/11103cba-4a08-4397-84a5-22ac125ed2f6/transactions/7324043a-b6fd-448d-844d-ef5cb67bb8f5,https://au-api.basiq.io/users/11103cba-4a08-4397-84a5-22ac125ed2f6/accounts/49544383-c19c-4c97-b8d1-5322d0faa6af,https://au-api.basiq.io/institutions/AU00000,,Supermarket and Grocery Stores,411
transaction,f304027f-d112-42c3-8245-a7c76ba209c8,posted,NULLARBOR ROADHOUSE YALA,-21.00,49544383-c19c-4c97-b8d1-5322d0faa6af,212.35,debit,payment,AU00000,5453f0a3-083c-43c6-9086-adfe94df9918,,,2022-04-06T00:00:00Z,,https://au-api.basiq.io/users/11103cba-4a08-4397-84a5-22ac125ed2f6/transactions/f304027f-d112-42c3-8245-a7c76ba209c8,https://au-api.basiq.io/users/11103cba-4a08-4397-84a5-22ac125ed2f6/accounts/49544383-c19c-4c97-b8d1-5322d0faa6af,https://au-api.basiq.io/institutions/AU00000,,Fuel Retailing,400
transaction,4bfded45-d791-4539-9553-261f7982ed49,posted,SA FUEL PTY LTD STREAKY BAY AU,-45.85,49544383-c19c-4c97-b8d1-5322d0faa6af,233.35,debit,payment,AU00000,5453f0a3-083c-43c6-9086-adfe94df9918,,,2022-04-06T00:00:00Z,,https://au-api.basiq.io/users/11103cba-4a08-4397-84a5-22ac125ed2f6/transactions/4bfded45-d791-4539-9553-261f7982ed49,https://au-api.basiq.io/users/11103cba-4a08-4397-84a5-22ac125ed2f6/accounts/49544383-c19c-4c97-b8d1-5322d0faa6af,https://au-api.basiq.io/institutions/AU00000,,"Mineral, Metal and Chemical Wholesaling",332
transaction,44a28fbc-8076-4961-b4df-57ff895555a4,posted,NULLARBOR ROADHOUSE YALATA SA AU,-65.00,49544383-c19c-4c97-b8d1-5322d0faa6af,279.20,debit,payment,AU00000,5453f0a3-083c-43c6-9086-adfe94df9918,,,2022-04-04T00:00:00Z,,https://au-api.basiq.io/users/11103cba-4a08-4397-84a5-22ac125ed2f6/transactions/44a28fbc-8076-4961-b4df-57ff895555a4,https://au-api.basiq.io/users/11103cba-4a08-4397-84a5-22ac125ed2f6/accounts/49544383-c19c-4c97-b8d1-5322d0faa6af,https://au-api.basiq.io/institutions/AU00000,,Fuel Retailing,400
transaction,8e35b538-c8d2-4825-9c93-08daf510405e,posted,EUCLA MOTOR HOTEL EUCLA AU,-322.67,49544383-c19c-4c97-b8d1-5322d0faa6af,344.20,debit,payment,AU00000,5453f0a3-083c-43c6-9086-adfe94df9918,,,2022-04-04T00:00:00Z,,https://au-api.basiq.io/users/11103cba-4a08-4397-84a5-22ac125ed2f6/transactions/8e35b538-c8d2-4825-9c93-08daf510405e,https://au-api.basiq.io/users/11103cba-4a08-4397-84a5-22ac125ed2f6/accounts/49544383-c19c-4c97-b8d1-5322d0faa6af,https://au-api.basiq.io/institutions/AU00000,,Accommodation,440
transaction,b3e2caf1-4d0d-4b4e-94d3-a535daef1bda,posted,PINK LAKE IGA ESPE,-36.28,49544383-c19c-4c97-b8d1-5322d0faa6af,666.87,debit,payment,AU00000,5453f0a3-083c-43c6-9086-adfe94df9918,,,2022-04-03T00:00:00Z,,https://au-api.basiq.io/users/11103cba-4a08-4397-84a5-22ac125ed2f6/transactions/b3e2caf1-4d0d-4b4e-94d3-a535daef1bda,https://au-api.basiq.io/users/11103cba-4a08-4397-84a5-22ac125ed2f6/accounts/49544383-c19c-4c97-b8d1-5322d0faa6af,https://au-api.basiq.io/institutions/AU00000,,Supermarket and Grocery Stores,411
transaction,2e2df607-2ed5-4798-9057-3efbf51d6500,posted,Savings Interest CR Bal @0%%,104.27,b2360b69-e3f3-49f3-bbc4-65d04865db02,23363.62,credit,interest,AU00000,5453f0a3-083c-43c6-9086-adfe94df9918,,,2022-06-28T00:00:00Z,,https://au-api.basiq.io/users/11103cba-4a08-4397-84a5-22ac125ed2f6/transactions/2e2df607-2ed5-4798-9057-3efbf51d6500,https://au-api.basiq.io/users/11103cba-4a08-4397-84a5-22ac125ed2f6/accounts/b2360b69-e3f3-49f3-bbc4-65d04865db02,https://au-api.basiq.io/institutions/AU00000,,,
transaction,f32cba39-7f47-47bc-aa11-438c16b633e9,posted,TFR Acc14000 TO 12389,500.00,b2360b69-e3f3-49f3-bbc4-65d04865db02,23259.35,credit,transfer,AU00000,5453f0a3-083c-43c6-9086-adfe94df9918,,,2022-06-14T00:00:00Z,,https://au-api.basiq.io/users/11103cba-4a08-4397-84a5-22ac125ed2f6/transactions/f32cba39-7f47-47bc-aa11-438c16b633e9,https://au-api.basiq.io/users/11103cba-4a08-4397-84a5-22ac125ed2f6/accounts/b2360b69-e3f3-49f3-bbc4-65d04865db02,https://au-api.basiq.io/institutions/AU00000,,,
transaction,ba0ea5b9-ce22-468c-9ef9-dddd3e809653,posted,Savings Interest CR Bal @0%%,102.39,b2360b69-e3f3-49f3-bbc4-65d04865db02,22759.35,credit,interest,AU00000,5453f0a3-083c-43c6-9086-adfe94df9918,,,2022-05-31T00:00:00Z,,https://au-api.basiq.io/users/11103cba-4a08-4397-84a5-22ac125ed2f6/transactions/ba0ea5b9-ce22-468c-9ef9-dddd3e809653,https://au-api.basiq.io/users/11103cba-4a08-4397-84a5-22ac125ed2f6/accounts/b2360b69-e3f3-49f3-bbc4-65d04865db02,https://au-api.basiq.io/institutions/AU00000,,,
transaction,1a1d5b0c-fb3f-406a-b188-cee543c5d366,posted,TFR Acc14000 TO 12389,500.00,b2360b69-e3f3-49f3-bbc4-65d04865db02,22656.96,credit,transfer,AU00000,5453f0a3-083c-43c6-9086-adfe94df9918,,,2022-05-14T00:00:00Z,,https://au-api.basiq.io/users/11103cba-4a08-4397-84a5-22ac125ed2f6/transactions/1a1d5b0c-fb3f-406a-b188-cee543c5d366,https://au-api.basiq.io/users/11103cba-4a08-4397-84a5-22ac125ed2f6/accounts/b2360b69-e3f3-49f3-bbc4-65d04865db02,https://au-api.basiq.io/institutions/AU00000,,,
transaction,ea23e8d4-467d-4ff6-8552-2d31ec9dada0,posted,Savings Interest CR Bal @0%%,89.63,b2360b69-e3f3-49f3-bbc4-65d04865db02,22156.96,credit,interest,AU00000,5453f0a3-083c-43c6-9086-adfe94df9918,,,2022-04-30T00:00:00Z,,https://au-api.basiq.io/users/11103cba-4a08-4397-84a5-22ac125ed2f6/transactions/ea23e8d4-467d-4ff6-8552-2d31ec9dada0,https://au-api.basiq.io/users/11103cba-4a08-4397-84a5-22ac125ed2f6/accounts/b2360b69-e3f3-49f3-bbc4-65d04865db02,https://au-api.basiq.io/institutions/AU00000,,,
transaction,02edf40d-b812-45e4-acdf-d632b32ed6f5,posted,TFR Acc14000 TO 12389,500.00,b2360b69-e3f3-49f3-bbc4-65d04865db02,22067.33,credit,transfer,AU00000,5453f0a3-083c-43c6-9086-adfe94df9918,,,2022-04-13T00:00:00Z,,https://au-api.basiq.io/users/11103cba-4a08-4397-84a5-22ac125ed2f6/transactions/02edf40d-b812-45e4-acdf-d632b32ed6f5,https://au-api.basiq.io/users/11103cba-4a08-4397-84a5-22ac125ed2f6/accounts/b2360b69-e3f3-49f3-bbc4-65d04865db02,https://au-api.basiq.io/institutions/AU00000,,,
