type,id,status,description,amount,account,balance,direction,class,institution,connection,enrich,transactionDate,postDate,subClass,links.self,links.account,links.institution,links.connection,subClass.title,subClass.code
transaction,2bae8200-88aa-41ab-beca-f4274cef6c53,posted,Transfer Platnm Homeloan 346454,-3905.00,0b107c33-e858-4bbd-abba-f757ae4da1fc,6315.30,debit,transfer,AU00000,5453f0a3-083c-43c6-9086-adfe94df9918,,,2022-12-29T00:00:00Z,,https://au-api.basiq.io/users/11103cba-4a08-4397-84a5-22ac125ed2f6/transactions/2bae8200-88aa-41ab-beca-f4274cef6c53,https://au-api.basiq.io/users/11103cba-4a08-4397-84a5-22ac125ed2f6/accounts/0b107c33-e858-4bbd-abba-f757ae4da1fc,https://au-api.basiq.io/institutions/AU00000,,,
transaction,1666b2c5-1595-4588-96cc-220a5d02348b,posted,Wdl ATM CBA ATM  BALGOWLAH A    NSW 210901   AUS,-200.00,0b107c33-e858-4bbd-abba-f757ae4da1fc,10220.30,debit,cash-withdrawal,AU00000,5453f0a3-083c-43c6-9086-adfe94df9918,,,2022-12-28T00:00:00Z,,https://au-api.basiq.io/users/11103cba-4a08-4397-84a5-22ac125ed2f6/transactions/1666b2c5-1595-4588-96cc-220a5d02348b,https://au-api.basiq.io/users/11103cba-4a08-4397-84a5-22ac125ed2f6/accounts/0b107c33-e858-4bbd-abba-f757ae4da1fc,https://au-api.basiq.io/institutions/AU00000,,,
transaction,2ac3301b-b58f-4eb1-85dd-32208977cd0a,posted,Wdl ATM CBA ATM  BALGOWLAH A    NSW 210901   AUS,-100.00,0b107c33-e858-4bbd-abba-f757ae4da1fc,10420.30,debit,cash-withdrawal,AU00000,5453f0a3-083c-43c6-9086-adfe94df9918,,,2022-12-28T00:00:00Z,,https://au-api.basiq.io/users/11103cba-4a08-4397-84a5-22ac125ed2f6/transactions/2ac3301b-b58f-4eb1-85dd-32208977cd0a,https://au-api.basiq.io/users/11103cba-4a08-4397-84a5-22ac125ed2f6/accounts/0b107c33-e858-4bbd-abba-f757ae4da1fc,https://au-api.basiq.io/institutions/AU00000,,,
transaction,068a1d53-d0d6-404a-ba51-2bb764dec743,posted,TFR From Transaction to CC Acc 13,-9353.50,0b107c33-e858-4bbd-abba-f757ae4da1fc,10520.30,debit,transfer,AU00000,5453f0a3-083c-43c6-9086-adfe94df9918,,,2022-12-28T00:00:00Z,,https://au-api.basiq.io/users/11103cba-4a08-4397-84a5-22ac125ed2f6/transactions/068a1d53-d0d6-404a-ba51-2bb764dec743,https://au-api.basiq.io/users/11103cba-4a08-4397-84a5-22ac125ed2f6/accounts/0b107c33-e858-4bbd-abba-f757ae4da1fc,https://au-api.basiq.io/institutions/AU00000,,,
transaction,af0dc7d5-8152-49ed-9719-a1c730074e0d,posted,Payroll WFRMS 15439393,17098.00,0b107c33-e858-4bbd-abba-f757ae4da1fc,19873.80,credit,transfer,AU00000,5453f0a3-083c-43c6-9086-adfe94df9918,,,2022-12-28T00:00:00Z,,https://au-api.basiq.io/users/11103cba-4a08-4397-84a5-22ac125ed2f6/transactions/af0dc7d5-8152-49ed-9719-a1c730074e0d,https://au-api.basiq.io/users/11103cba-4a08-4397-84a5-22ac125ed2f6/accounts/0b107c33-e858-4bbd-abba-f757ae4da1fc,https://au-api.basiq.io/institutions/AU00000,,,
transaction,865f00a6-839b-4108-9175-6bbc643688b8,posted,Wdl ATM CBA ATM  MANLY A        NSW 219701   AUS,-400.00,0b107c33-e858-4bbd-abba-f757ae4da1fc,2775.80,debit,cash-withdrawal,AU00000,5453f0a3-083c-43c6-9086-adfe94df9918,,,2022-12-26T00:00:00Z,,https://au-api.basiq.io/users/11103cba-4a08-4397-84a5-22ac125ed2f6/transactions/865f00a6-839b-4108-9175-6bbc643688b8,https://au-api.basiq.io/users/11103cba-4a08-4397-84a5-22ac125ed2f6/accounts/0b107c33-e858-4bbd-abba-f757ae4da1fc,https://au-api.basiq.io/institutions/AU00000,,,
transaction,046c9e1f-f23f-4548-9aad-94207c518ad0,posted,Wdl ATM WESTPAC IGA BALGOWLAH  BALGOWL        AU,-200.00,0b107c33-e858-4bbd-abba-f757ae4da1fc,3175.80,debit,cash-withdrawal,AU00000,5453f0a3-083c-43c6-9086-adfe94df9918,,,2022-12-25T00:00:00Z,,https://au-api.basiq.io/users/11103cba-4a08-4397-84a5-22ac125ed2f6/transactions/046c9e1f-f23f-4548-9aad-94207c518ad0,https://au-api.basiq.io/users/11103cba-4a08-4397-84a5-22ac125ed2f6/accounts/0b107c33-e858-4bbd-abba-f757ae4da1fc,https://au-api.basiq.io/institutions/AU00000,,,
transaction,6f008194-47f8-4b66-bb3f-e9ca11bc0cbd,posted,Non Hooli ATM Withdrawal Fee,-2.50,0b107c33-e858-4bbd-abba-f757ae4da1fc,3375.80,debit,bank-fee,AU00000,5453f0a3-083c-43c6-9086-adfe94df9918,,,2022-12-25T00:00:00Z,,https://au-api.basiq.io/users/11103cba-4a08-4397-84a5-22ac125ed2f6/transactions/6f008194-47f8-4b66-bb3f-e9ca11bc0cbd,https://au-api.basiq.io/users/11103cba-4a08-4397-84a5-22ac125ed2f6/accounts/0b107c33-e858-4bbd-abba-f757ae4da1fc,https://au-api.basiq.io/institutions/AU00000,,,
transaction,8e473fe4-ea73-4f8f-b575-b57cd4721571,posted,Wdl ATM CBA ATM  MANLY B        NSW 219702   AUS,-200.00,0b107c33-e858-4bbd-abba-f757ae4da1fc,3378.30,debit,cash-withdrawal,AU00000,5453f0a3-083c-43c6-9086-adfe94df9918,,,2022-12-18T00:00:00Z,,https://au-api.basiq.io/users/11103cba-4a08-4397-84a5-22ac125ed2f6/transactions/8e473fe4-ea73-4f8f-b575-b57cd4721571,https://au-api.basiq.io/users/11103cba-4a08-4397-84a5-22ac125ed2f6/accounts/0b107c33-e858-4bbd-abba-f757ae4da1fc,https://au-api.basiq.io/institutions/AU00000,,,
transaction,aaa311d9-aad0-4d70-9650-c5ad7f58b898,posted,Manly Maths Tutor Wages,201.00,0b107c33-e858-4bbd-abba-f757ae4da1fc,3578.30,credit,transfer,AU00000,5453f0a3-083c-43c6-9086-adfe94df9918,,,2022-12-15T00:00:00Z,,https://au-api.basiq.io/users/11103cba-4a08-4397-84a5-22ac125ed2f6/transactions/aaa311d9-aad0-4d70-9650-c5ad7f58b898,https://au-api.basiq.io/users/11103cba-4a08-4397-84a5-22ac125ed2f6/accounts/0b107c33-e858-4bbd-abba-f757ae4da1fc,https://au-api.basiq.io/institutions/AU00000,,,
transaction,dab9e69e-cbdb-451f-9137-2a67fde6d8eb,posted,MANLY WEST SCHOOL,-2530.81,0b107c33-e858-4bbd-abba-f757ae4da1fc,3377.30,debit,payment,AU00000,5453f0a3-083c-43c6-9086-adfe94df9918,,,2022-12-15T00:00:00Z,,https://au-api.basiq.io/users/11103cba-4a08-4397-84a5-22ac125ed2f6/transactions/dab9e69e-cbdb-451f-9137-2a67fde6d8eb,https://au-api.basiq.io/users/11103cba-4a08-4397-84a5-22ac125ed2f6/accounts/0b107c33-e858-4bbd-abba-f757ae4da1fc,https://au-api.basiq.io/institutions/AU00000,,School Education,802
transaction,15c16075-5818-4cc7-af1f-b336b27a309f,posted,MANLY WEST SCHOOL,-101.00,0b107c33-e858-4bbd-abba-f757ae4da1fc,5908.11,debit,payment,AU00000,5453f0a3-083c-43c6-9086-adfe94df9918,,,2022-12-15T00:00:00Z,,https://au-api.basiq.io/users/11103cba-4a08-4397-84a5-22ac125ed2f6/transactions/15c16075-5818-4cc7-af1f-b336b27a309f,https://au-api.basiq.io/users/11103cba-4a08-4397-84a5-22ac125ed2f6/accounts/0b107c33-e858-4bbd-abba-f757ae4da1fc,https://au-api.basiq.io/institutions/AU00000,,School Education,802
transaction,d6cac72f-71d4-484f-a25a-47d91d054921,posted,Manly Maths Tutor Wages,201.00,0b107c33-e858-4bbd-abba-f757ae4da1fc,6009.11,credit,transfer,AU00000,5453f0a3-083c-43c6-9086-adfe94df9918,,,2022-12-13T00:00:00Z,,https://au-api.basiq.io/users/11103cba-4a08-4397-84a5-22ac125ed2f6/transactions/d6cac72f-71d4-484f-a25a-47d91d054921,https://au-api.basiq.io/users/11103cba-4a08-4397-84a5-22ac125ed2f6/accounts/0b107c33-e858-4bbd-abba-f757ae4da1fc,https://au-api.basiq.io/institutions/AU00000,,,
transaction,2be78ea6-8a3e-4666-b4a6-a29381908185,posted,TFR Acc14000 TO 12389,-500.00,0b107c33-e858-4bbd-abba-f757ae4da1fc,5808.11,debit,transfer,AU00000,5453f0a3-083c-43c6-9086-adfe94df9918,,,2022-12-12T00:00:00Z,,https://au-api.basiq.io/users/11103cba-4a08-4397-84a5-22ac125ed2f6/transactions/2be78ea6-8a3e-4666-b4a6-a29381908185,https://au-api.basiq.io/users/11103cba-4a08-4397-84a5-22ac125ed2f6/accounts/0b107c33-e858-4bbd-abba-f757ae4da1fc,https://au-api.basiq.io/institutions/AU00000,,,
transaction,31afbaa1-0139-459c-b5cd-04f1e836652f,posted,AGL RETAIL ENERGY LTD,-95.00,0b107c33-e858-4bbd-abba-f757ae4da1fc,6308.11,debit,payment,AU00000,5453f0a3-083c-43c6-9086-adfe94df9918,,,2022-12-09T00:00:00Z,,https://au-api.basiq.io/users/11103cba-4a08-4397-84a5-22ac125ed2f6/transactions/31afbaa1-0139-459c-b5cd-04f1e836652f,https://au-api.basiq.io/users/11103cba-4a08-4397-84a5-22ac125ed2f6/accounts/0b107c33-e858-4bbd-abba-f757ae4da1fc,https://au-api.basiq.io/institutions/AU00000,,Electricity Distribution,263
transaction,d5e84ba7-6e5c-4054-abc7-0ffc48935e72,posted,AGL RETAIL ENERGY LTD,-78.00,0b107c33-e858-4bbd-abba-f757ae4da1fc,6403.11,debit,payment,AU00000,5453f0a3-083c-43c6-9086-adfe94df9918,,,2022-12-09T00:00:00Z,,https://au-api.basiq.io/users/11103cba-4a08-4397-84a5-22ac125ed2f6/transactions/d5e84ba7-6e5c-4054-abc7-0ffc48935e72,https://au-api.basiq.io/users/11103cba-4a08-4397-84a5-22ac125ed2f6/accounts/0b107c33-e858-4bbd-abba-f757ae4da1fc,https://au-api.basiq.io/institutions/AU00000,,Electricity Distribution,263
transaction,2e29cc43-c835-4aa4-b392-5cb7eaeefee6,posted,Transfer Platnm Homeloan 346454,-3912.50,0b107c33-e858-4bbd-abba-f757ae4da1fc,6481.11,debit,transfer,AU00000,5453f0a3-083c-43c6-9086-adfe94df9918,,,2022-11-28T00:00:00Z,,https://au-api.basiq.io/users/11103cba-4a08-4397-84a5-22ac125ed2f6/transactions/2e29cc43-c835-4aa4-b392-5cb7eaeefee6,https://au-api.basiq.io/users/11103cba-4a08-4397-84a5-22ac125ed2f6/accounts/0b107c33-e858-4bbd-abba-f757ae4da1fc,https://au-api.basiq.io/institutions/AU00000,,,
transaction,c74e183a-8ca1-4b08-aca4-4b8d70feff68,posted,TFR From Transaction to CC Acc 13,-9346.00,0b107c33-e858-4bbd-abba-f757ae4da1fc,10393.61,debit,transfer,AU00000,5453f0a3-083c-43c6-9086-adfe94df9918,,,2022-11-27T00:00:00Z,,https://au-api.basiq.io/users/11103cba-4a08-4397-84a5-22ac125ed2f6/transactions/c74e183a-8ca1-4b08-aca4-4b8d70feff68,https://au-api.basiq.io/users/11103cba-4a08-4397-84a5-22ac125ed2f6/accounts/0b107c33-e858-4bbd-abba-f757ae4da1fc,https://au-api.basiq.io/institutions/AU00000,,,
transaction,2b50dd19-3454-438b-8158-08315029ad3f,posted,Payroll WFRMS 15439393,17098.00,0b107c33-e858-4bbd-abba-f757ae4da1fc,19739.61,credit,transfer,AU00000,5453f0a3-083c-43c6-9086-adfe94df9918,,,2022-11-27T00:00:00Z,,https://au-api.basiq.io/users/11103cba-4a08-4397-84a5-22ac125ed2f6/transactions/2b50dd19-3454-438b-8158-08315029ad3f,https://au-api.basiq.io/users/11103cba-4a08-4397-84a5-22ac125ed2f6/accounts/0b107c33-e858-4bbd-abba-f757ae4da1fc,https://au-api.basiq.io/institutions/AU00000,,,
transaction,a1c27b51-a9a8-4f89-92e5-411b1ae5fa17,posted,Manly Maths Tutor Wages,201.00,0b107c33-e858-4bbd-abba-f757ae4da1fc,2641.61,credit,transfer,AU00000,5453f0a3-083c-43c6-9086-adfe94df9918,,,2022-11-15T00:00:00Z,,https://au-api.basiq.io/users/11103cba-4a08-4397-84a5-22ac125ed2f6/transactions/a1c27b51-a9a8-4f89-92e5-411b1ae5fa17,https://au-api.basiq.io/users/11103cba-4a08-4397-84a5-22ac125ed2f6/accounts/0b107c33-e858-4bbd-abba-f757ae4da1fc,https://au-api.basiq.io/institutions/AU00000,,,
transaction,181ea6ec-faaa-4653-81f5-5fc6bd772714,posted,Wdl ATM WESTPAC IGA BALGOWLAH  BALGOWL        AU,-200.00,0b107c33-e858-4bbd-abba-f757ae4da1fc,2440.61,debit,cash-withdrawal,AU00000,5453f0a3-083c-43c6-9086-adfe94df9918,,,2022-11-14T00:00:00Z,,https://au-api.basiq.io/users/11103cba-4a08-4397-84a5-22ac125ed2f6/transactions/181ea6ec-faaa-4653-81f5-5fc6bd772714,https://au-api.basiq.io/users/11103cba-4a08-4397-84a5-22ac125ed2f6/accounts/0b107c33-e858-4bbd-abba-f757ae4da1fc,https://au-api.basiq.io/institutions/AU00000,,,
transaction,ae060c33-1c39-4ce7-aeea-f37cbe99aa55,posted,Non Hooli ATM Withdrawal Fee,-2.50,0b107c33-e858-4bbd-abba-f757ae4da1fc,2640.61,debit,bank-fee,AU00000,5453f0a3-083c-43c6-9086-adfe94df9918,,,2022-11-14T00:00:00Z,,https://au-api.basiq.io/users/11103cba-4a08-4397-84a5-22ac125ed2f6/transactions/ae060c33-1c39-4ce7-aeea-f37cbe99aa55,https://au-api.basiq.io/users/11103cba-4a08-4397-84a5-22ac125ed2f6/accounts/0b107c33-e858-4bbd-abba-f757ae4da1fc,https://au-api.basiq.io/institutions/AU00000,,,
transaction,e97cb032-9388-4970-9498-1091d8c3f6df,posted,Wdl ATM WESTPAC IGA BALGOWLAH  BALGOWL        AU,-500.00,0b107c33-e858-4bbd-abba-f757ae4da1fc,2643.11,debit,cash-withdrawal,AU00000,5453f0a3-083c-43c6-9086-adfe94df9918,,,2022-11-14T00:00:00Z,,https://au-api.basiq.io/users/11103cba-4a08-4397-84a5-22ac125ed2f6/transactions/e97cb032-9388-4970-9498-1091d8c3f6df,https://au-api.basiq.io/users/11103cba-4a08-4397-84a5-22ac125ed2f6/accounts/0b107c33-e858-4bbd-abba-f757ae4da1fc,https://au-api.basiq.io/institutions/AU00000,,,
transaction,597bfc8e-f838-4929-be93-dc6321b1a956,posted,Non Hooli ATM Withdrawal Fee,-2.50,0b107c33-e858-4bbd-abba-f757ae4da1fc,3143.11,debit,bank-fee,AU00000,5453f0a3-083c-43c6-9086-adfe94df9918,,,2022-11-14T00:00:00Z,,https://au-api.basiq.io/users/11103cba-4a08-4397-84a5-22ac125ed2f6/transactions/597bfc8e-f838-4929-be93-dc6321b1a956,https://au-api.basiq.io/users/11103cba-4a08-4397-84a5-22ac125ed2f6/accounts/0b107c33-e858-4bbd-abba-f757ae4da1fc,https://au-api.basiq.io/institutions/AU00000,,,
transaction,b4c91878-3f39-4036-b510-3f9be6f84750,posted,MANLY WEST SCHOOL,-2530.81,0b107c33-e858-4bbd-abba-f757ae4da1fc,3145.61,debit,payment,AU00000,5453f0a3-083c-43c6-9086-adfe94df9918,,,2022-11-14T00:00:00Z,,https://au-api.basiq.io/users/11103cba-4a08-4397-84a5-22ac125ed2f6/transactions/b4c91878-3f39-4036-b510-3f9be6f84750,https://au-api.basiq.io/users/11103cba-4a08-4397-84a5-22ac125ed2f6/accounts/0b107c33-e858-4bbd-abba-f757ae4da1fc,https://au-api.basiq.io/institutions/AU00000,,School Education,802
transaction,fe180cfc-0bec-4496-a0f7-4207377f365d,posted,MANLY WEST SCHOOL,-101.00,0b107c33-e858-4bbd-abba-f757ae4da1fc,5676.42,debit,payment,AU00000,5453f0a3-083c-43c6-9086-adfe94df9918,,,2022-11-14T00:00:00Z,,https://au-api.basiq.io/users/11103cba-4a08-4397-84a5-22ac125ed2f6/transactions/fe180cfc-0bec-4496-a0f7-4207377f365d,https://au-api.basiq.io/users/11103cba-4a08-4397-84a5-22ac125ed2f6/accounts/0b107c33-e858-4bbd-abba-f757ae4da1fc,https://au-api.basiq.io/institutions/AU00000,,School Education,802
transaction,9492be43-0b6b-44d3-9b47-def5386f5902,posted,Manly Maths Tutor Wages,201.00,0b107c33-e858-4bbd-abba-f757ae4da1fc,5777.42,credit,transfer,AU00000,5453f0a3-083c-43c6-9086-adfe94df9918,,,2022-11-12T00:00:00Z,,https://au-api.basiq.io/users/11103cba-4a08-4397-84a5-22ac125ed2f6/transactions/9492be43-0b6b-44d3-9b47-def5386f5902,https://au-api.basiq.io/users/11103cba-4a08-4397-84a5-22ac125ed2f6/accounts/0b107c33-e858-4bbd-abba-f757ae4da1fc,https://au-api.basiq.io/institutions/AU00000,,,
transaction,0661634b-54b3-49c3-be12-c2a41152d295,posted,TFR Acc14000 TO 12389,-500.00,0b107c33-e858-4bbd-abba-f757ae4da1fc,5576.42,debit,transfer,AU00000,5453f0a3-083c-43c6-9086-adfe94df9918,,,2022-11-11T00:00:00Z,,https://au-api.basiq.io/users/11103cba-4a08-4397-84a5-22ac125ed2f6/transactions/0661634b-54b3-49c3-be12-c2a41152d295,https://au-api.basiq.io/users/11103cba-4a08-4397-84a5-22ac125ed2f6/accounts/0b107c33-e858-4bbd-abba-f757ae4da1fc,https://au-api.basiq.io/institutions/AU00000,,,
transaction,d9066e8f-3539-4b40-ac2e-2dc25d199ddc,posted,AGL RETAIL ENERGY LTD,-95.00,0b107c33-e858-4bbd-abba-f757ae4da1fc,6076.42,debit,payment,AU00000,5453f0a3-083c-43c6-9086-adfe94df9918,,,2022-11-08T00:00:00Z,,https://au-api.basiq.io/users/11103cba-4a08-4397-84a5-22ac125ed2f6/transactions/d9066e8f-3539-4b40-ac2e-2dc25d199ddc,https://au-api.basiq.io/users/11103cba-4a08-4397-84a5-22ac125ed2f6/accounts/0b107c33-e858-4bbd-abba-f757ae4da1fc,https://au-api.basiq.io/institutions/AU00000,,Electricity Distribution,263
transaction,8cee9c72-c5aa-479a-8109-c1a6a1f276c7,posted,AGL RETAIL ENERGY LTD,-78.00,0b107c33-e858-4bbd-abba-f757ae4da1fc,6171.42,debit,payment,AU00000,5453f0a3-083c-43c6-9086-adfe94df9918,,,2022-11-08T00:00:00Z,,https://au-api.basiq.io/users/11103cba-4a08-4397-84a5-22ac125ed2f6/transactions/8cee9c72-c5aa-479a-8109-c1a6a1f276c7,https://au-api.basiq.io/users/11103cba-4a08-4397-84a5-22ac125ed2f6/accounts/0b107c33-e858-4bbd-abba-f757ae4da1fc,https://au-api.basiq.io/institutions/AU00000,,Electricity Distribution,263
transaction,a4e205cf-f1b6-4761-b4b0-ee1cbd619fd0,posted,V9193 04/07 FOREIGN CURRENCY TRAN FEE     Ref: 74973807186,-2.02,0b107c33-e858-4bbd-abba-f757ae4da1fc,6249.42,debit,bank-fee,AU00000,5453f0a3-083c-43c6-9086-adfe94df9918,,,2022-11-03T00:00:00Z,,https://au-api.basiq.io/users/11103cba-4a08-4397-84a5-22ac125ed2f6/transactions/a4e205cf-f1b6-4761-b4b0-ee1cbd619fd0,https://au-api.basiq.io/users/11103cba-4a08-4397-84a5-22ac125ed2f6/accounts/0b107c33-e858-4bbd-abba-f757ae4da1fc,https://au-api.basiq.io/institutions/AU00000,,,
transaction,bbaea36c-4a61-4ad2-809d-6e3e1f9d2172,posted,V9193 04/07 FOREIGN CURRENCY TRAN FEE     Ref: 74974007186,-1.31,0b107c33-e858-4bbd-abba-f757ae4da1fc,6251.44,debit,bank-fee,AU00000,5453f0a3-083c-43c6-9086-adfe94df9918,,,2022-11-03T00:00:00Z,,https://au-api.basiq.io/users/11103cba-4a08-4397-84a5-22ac125ed2f6/transactions/bbaea36c-4a61-4ad2-809d-6e3e1f9d2172,https://au-api.basiq.io/users/11103cba-4a08-4397-84a5-22ac125ed2f6/accounts/0b107c33-e858-4bbd-abba-f757ae4da1fc,https://au-api.basiq.io/institutions/AU00000,,,
transaction,09bc778e-3bb6-497b-bdbb-647192cc2772,posted,Transfer Platnm Homeloan 346454,-3920.00,0b107c33-e858-4bbd-abba-f757ae4da1fc,6252.75,debit,transfer,AU00000,5453f0a3-083c-43c6-9086-adfe94df9918,,,2022-10-28T00:00:00Z,,https://au-api.basiq.io/users/11103cba-4a08-4397-84a5-22ac125ed2f6/transactions/09bc778e-3bb6-497b-bdbb-647192cc2772,https://au-api.basiq.io/users/11103cba-4a08-4397-84a5-22ac125ed2f6/accounts/0b107c33-e858-4bbd-abba-f757ae4da1fc,https://au-api.basiq.io/institutions/AU00000,,,
transaction,749436d9-7593-4f7c-a84c-fb86d6c0871e,posted,TFR From Transaction to CC Acc 13,-9338.50,0b107c33-e858-4bbd-abba-f757ae4da1fc,10172.75,debit,transfer,AU00000,5453f0a3-083c-43c6-9086-adfe94df9918,,,2022-10-27T00:00:00Z,,https://au-api.basiq.io/users/11103cba-4a08-4397-84a5-22ac125ed2f6/transactions/749436d9-7593-4f7c-a84c-fb86d6c0871e,https://au-api.basiq.io/users/11103cba-4a08-4397-84a5-22ac125ed2f6/accounts/0b107c33-e858-4bbd-abba-f757ae4da1fc,https://au-api.basiq.io/institutions/AU00000,,,
transaction,fc8d9902-4b3c-4f4e-941c-d498eb4b8d39,posted,Payroll WFRMS 15439393,15985.00,0b107c33-e858-4bbd-abba-f757ae4da1fc,19511.25,credit,transfer,AU00000,5453f0a3-083c-43c6-9086-adfe94df9918,,,2022-10-27T00:00:00Z,,https://au-api.basiq.io/users/11103cba-4a08-4397-84a5-22ac125ed2f6/transactions/fc8d9902-4b3c-4f4e-941c-d498eb4b8d39,https://au-api.basiq.io/users/11103cba-4a08-4397-84a5-22ac125ed2f6/accounts/0b107c33-e858-4bbd-abba-f757ae4da1fc,https://au-api.basiq.io/institutions/AU00000,,,
transaction,578a2167-4aa3-4e7f-8e0c-f0c342bcda5b,posted,Wdl ATM WES IGA BALGOWLAH HGT  BALGOWL        AU,-200.00,0b107c33-e858-4bbd-abba-f757ae4da1fc,3526.25,debit,cash-withdrawal,AU00000,5453f0a3-083c-43c6-9086-adfe94df9918,,,2022-10-18T00:00:00Z,,https://au-api.basiq.io/users/11103cba-4a08-4397-84a5-22ac125ed2f6/transactions/578a2167-4aa3-4e7f-8e0c-f0c342bcda5b,https://au-api.basiq.io/users/11103cba-4a08-4397-84a5-22ac125ed2f6/accounts/0b107c33-e858-4bbd-abba-f757ae4da1fc,https://au-api.basiq.io/institutions/AU00000,,,
transaction,fe79243a-3cf7-4e11-8e67-3184eb3de9a0,posted,Non Hooli ATM Withdrawal Fee,-2.50,0b107c33-e858-4bbd-abba-f757ae4da1fc,3726.25,debit,bank-fee,AU00000,5453f0a3-083c-43c6-9086-adfe94df9918,,,2022-10-18T00:00:00Z,,https://au-api.basiq.io/users/11103cba-4a08-4397-84a5-22ac125ed2f6/transactions/fe79243a-3cf7-4e11-8e67-3184eb3de9a0,https://au-api.basiq.io/users/11103cba-4a08-4397-84a5-22ac125ed2f6/accounts/0b107c33-e858-4bbd-abba-f757ae4da1fc,https://au-api.basiq.io/institutions/AU00000,,,
transaction,9ecf1a23-9f87-4493-9f5d-dd825d29f7e5,posted,Manly Maths Tutor Wages,201.00,0b107c33-e858-4bbd-abba-f757ae4da1fc,3728.75,credit,transfer,AU00000,5453f0a3-083c-43c6-9086-adfe94df9918,,,2022-10-17T00:00:00Z,,https://au-api.basiq.io/users/11103cba-4a08-4397-84a5-22ac125ed2f6/transactions/9ecf1a23-9f87-4493-9f5d-dd825d29f7e5,https://au-api.basiq.io/users/11103cba-4a08-4397-84a5-22ac125ed2f6/accounts/0b107c33-e858-4bbd-abba-f757ae4da1fc,https://au-api.basiq.io/institutions/AU00000,,,
transaction,30997a29-7e9e-45c9-a2ed-0ceb62fd038b,posted,MANLY WEST SCHOOL,-2530.81,0b107c33-e858-4bbd-abba-f757ae4da1fc,3527.75,debit,payment,AU00000,5453f0a3-083c-43c6-9086-adfe94df9918,,,2022-10-17T00:00:00Z,,https://au-api.basiq.io/users/11103cba-4a08-4397-84a5-22ac125ed2f6/transactions/30997a29-7e9e-45c9-a2ed-0ceb62fd038b,https://au-api.basiq.io/users/11103cba-4a08-4397-84a5-22ac125ed2f6/accounts/0b107c33-e858-4bbd-abba-f757ae4da1fc,https://au-api.basiq.io/institutions/AU00000,,School Education,802
transaction,a43c3659-07b7-4bb3-b0d2-f980b91c48b2,posted,MANLY WEST SCHOOL,-101.00,0b107c33-e858-4bbd-abba-f757ae4da1fc,6058.56,debit,payment,AU00000,5453f0a3-083c-43c6-9086-adfe94df9918,,,2022-10-17T00:00:00Z,,https://au-api.basiq.io/users/11103cba-4a08-4397-84a5-22ac125ed2f6/transactions/a43c3659-07b7-4bb3-b0d2-f980b91c48b2,https://au-api.basiq.io/users/11103cba-4a08-4397-84a5-22ac125ed2f6/accounts/0b107c33-e858-4bbd-abba-f757ae4da1fc,https://au-api.basiq.io/institutions/AU00000,,School Education,802
transaction,acea410f-a998-4b6b-a741-c691e10b9f2a,posted,Manly Maths Tutor Wages,201.00,0b107c33-e858-4bbd-abba-f757ae4da1fc,6159.56,credit,transfer,AU00000,5453f0a3-083c-43c6-9086-adfe94df9918,,,2022-10-13T00:00:00Z,,https://au-api.basiq.io/users/11103cba-4a08-4397-84a5-22ac125ed2f6/transactions/acea410f-a998-4b6b-a741-c691e10b9f2a,https://au-api.basiq.io/users/11103cba-4a08-4397-84a5-22ac125ed2f6/accounts/0b107c33-e858-4bbd-abba-f757ae4da1fc,https://au-api.basiq.io/institutions/AU00000,,,
transaction,7c5a45fa-291e-4a38-9d86-e25fe1cc542c,posted,TFR Acc14000 TO 12389,-500.00,0b107c33-e858-4bbd-abba-f757ae4da1fc,5958.56,debit,transfer,AU00000,5453f0a3-083c-43c6-9086-adfe94df9918,,,2022-10-12T00:00:00Z,,https://au-api.basiq.io/users/11103cba-4a08-4397-84a5-22ac125ed2f6/transactions/7c5a45fa-291e-4a38-9d86-e25fe1cc542c,https://au-api.basiq.io/users/11103cba-4a08-4397-84a5-22ac125ed2f6/accounts/0b107c33-e858-4bbd-abba-f757ae4da1fc,https://au-api.basiq.io/institutions/AU00000,,,
transaction,265d3135-23d7-4a14-bfc6-699879c0596d,posted,AGL RETAIL ENERGY LTD (GAS),-95.00,0b107c33-e858-4bbd-abba-f757ae4da1fc,6458.56,debit,payment,AU00000,5453f0a3-083c-43c6-9086-adfe94df9918,,,2022-10-11T00:00:00Z,,https://au-api.basiq.io/users/11103cba-4a08-4397-84a5-22ac125ed2f6/transactions/265d3135-23d7-4a14-bfc6-699879c0596d,https://au-api.basiq.io/users/11103cba-4a08-4397-84a5-22ac125ed2f6/accounts/0b107c33-e858-4bbd-abba-f757ae4da1fc,https://au-api.basiq.io/institutions/AU00000,,Electricity Distribution,263
transaction,47abe114-8ff6-44db-b467-10db23674c21,posted,AGL RETAIL ENERGY LTD (GAS),-78.00,0b107c33-e858-4bbd-abba-f757ae4da1fc,6553.56,debit,payment,AU00000,5453f0a3-083c-43c6-9086-adfe94df9918,,,2022-10-11T00:00:00Z,,https://au-api.basiq.io/users/11103cba-4a08-4397-84a5-22ac125ed2f6/transactions/47abe114-8ff6-44db-b467-10db23674c21,https://au-api.basiq.io/users/11103cba-4a08-4397-84a5-22ac125ed2f6/accounts/0b107c33-e858-4bbd-abba-f757ae4da1fc,https://au-api.basiq.io/institutions/AU00000,,Electricity Distribution,263
transaction,cb321b28-2a1b-4403-adfa-4c08666a41ae,posted,Transfer Platnm Homeloan 346454,3905.00,2df58481-c77a-40b1-8249-949cb3ea9670,-353363.25,credit,loan-repayment,AU00000,5453f0a3-083c-43c6-9086-adfe94df9918,,,2022-12-29T00:00:00Z,,https://au-api.basiq.io/users/11103cba-4a08-4397-84a5-22ac125ed2f6/transactions/cb321b28-2a1b-4403-adfa-4c08666a41ae,https://au-api.basiq.io/users/11103cba-4a08-4397-84a5-22ac125ed2f6/accounts/2df58481-c77a-40b1-8249-949cb3ea9670,https://au-api.basiq.io/institutions/AU00000,,,
transaction,f82043c0-eca3-47f4-9adb-79bdd3b01a95,posted,Mortgage Interest Payment 746833,-3705.75,2df58481-c77a-40b1-8249-949cb3ea9670,-357268.25,debit,loan-interest,AU00000,5453f0a3-083c-43c6-9086-adfe94df9918,,,2022-12-17T00:00:00Z,,https://au-api.basiq.io/users/11103cba-4a08-4397-84a5-22ac125ed2f6/transactions/f82043c0-eca3-47f4-9adb-79bdd3b01a95,https://au-api.basiq.io/users/11103cba-4a08-4397-84a5-22ac125ed2f6/accounts/2df58481-c77a-40b1-8249-949cb3ea9670,https://au-api.basiq.io/institutions/AU00000,,,
transaction,3b37a58c-6d1e-4386-8bf5-45f320d8df9e,posted,Transfer Platnm Homeloan 346454,3912.50,2df58481-c77a-40b1-8249-949cb3ea9670,-353562.50,credit,loan-repayment,AU00000,5453f0a3-083c-43c6-9086-adfe94df9918,,,2022-11-28T00:00:00Z,,https://au-api.basiq.io/users/11103cba-4a08-4397-84a5-22ac125ed2f6/transactions/3b37a58c-6d1e-4386-8bf5-45f320d8df9e,https://au-api.basiq.io/users/11103cba-4a08-4397-84a5-22ac125ed2f6/accounts/2df58481-c77a-40b1-8249-949cb3ea9670,https://au-api.basiq.io/institutions/AU00000,,,
transaction,8fa87adf-6407-4f9f-a787-f384a317a4ac,posted,Mortgage Interest Payment 746833,-3698.25,2df58481-c77a-40b1-8249-949cb3ea9670,-357475.00,debit,loan-interest,AU00000,5453f0a3-083c-43c6-9086-adfe94df9918,,,2022-11-16T00:00:00Z,,https://au-api.basiq.io/users/11103cba-4a08-4397-84a5-22ac125ed2f6/transactions/8fa87adf-6407-4f9f-a787-f384a317a4ac,https://au-api.basiq.io/users/11103cba-4a08-4397-84a5-22ac125ed2f6/accounts/2df58481-c77a-40b1-8249-949cb3ea9670,https://au-api.basiq.io/institutions/AU00000,,,
transaction,bfef30e0-ac35-48f7-aad4-fd3723430664,posted,Transfer Platnm Homeloan 346454,3920.00,2df58481-c77a-40b1-8249-949cb3ea9670,-353776.75,credit,loan-repayment,AU00000,5453f0a3-083c-43c6-9086-adfe94df9918,,,2022-10-28T00:00:00Z,,https://au-api.basiq.io/users/11103cba-4a08-4397-84a5-22ac125ed2f6/transactions/bfef30e0-ac35-48f7-aad4-fd3723430664,https://au-api.basiq.io/users/11103cba-4a08-4397-84a5-22ac125ed2f6/accounts/2df58481-c77a-40b1-8249-949cb3ea9670,https://au-api.basiq.io/institutions/AU00000,,,
transaction,7bdb8562-d700-436d-8862-f0dbdf0d9be5,posted,Mortgage Interest Payment 746833,-3691.00,2df58481-c77a-40b1-8249-949cb3ea9670,-357696.75,debit,loan-interest,AU00000,5453f0a3-083c-43c6-9086-adfe94df9918,,,2022-10-17T00:00:00Z,,https://au-api.basiq.io/users/11103cba-4a08-4397-84a5-22ac125ed2f6/transactions/7bdb8562-d700-436d-8862-f0dbdf0d9be5,https://au-api.basiq.io/users/11103cba-4a08-4397-84a5-22ac125ed2f6/accounts/2df58481-c77a-40b1-8249-949cb3ea9670,https://au-api.basiq.io/institutions/AU00000,,,
transaction,330b9993-9a76-4d94-b87c-a9fb7fe69ef1,posted,SUNWAYNE PTY LTD MANLY AU,-47.50,49544383-c19c-4c97-b8d1-5322d0faa6af,13979.53,debit,payment,AU00000,5453f0a3-083c-43c6-9086-adfe94df9918,,,2022-12-31T00:00:00Z,,https://au-api.basiq.io/users/11103cba-4a08-4397-84a5-22ac125ed2f6/transactions/330b9993-9a76-4d94-b87c-a9fb7fe69ef1,https://au-api.basiq.io/users/11103cba-4a08-4397-84a5-22ac125ed2f6/accounts/49544383-c19c-4c97-b8d1-5322d0faa6af,https://au-api.basiq.io/institutions/AU00000,,"Cafes, Restaurants and Takeaway Food Services",451
transaction,c873df5a-e7b5-4b19-a01d-80866729c77d,posted,BP ALLAMBIE 0754 ALLA,-54.21,49544383-c19c-4c97-b8d1-5322d0faa6af,14027.03,debit,payment,AU00000,5453f0a3-083c-43c6-9086-adfe94df9918,,,2022-12-29T00:00:00Z,,https://au-api.basiq.io/users/11103cba-4a08-4397-84a5-22ac125ed2f6/transactions/c873df5a-e7b5-4b19-a01d-80866729c77d,https://au-api.basiq.io/users/11103cba-4a08-4397-84a5-22ac125ed2f6/accounts/49544383-c19c-4c97-b8d1-5322d0faa6af,https://au-api.basiq.io/institutions/AU00000,,Fuel Retailing,400
transaction,53d18bd3-b2b3-47f5-9954-d81e60a892b2,posted,NORTH SYDNEY PARKING NORT,-8.50,49544383-c19c-4c97-b8d1-5322d0faa6af,14081.24,debit,payment,AU00000,5453f0a3-083c-43c6-9086-adfe94df9918,,,2022-12-29T00:00:00Z,,https://au-api.basiq.io/users/11103cba-4a08-4397-84a5-22ac125ed2f6/transactions/53d18bd3-b2b3-47f5-9954-d81e60a892b2,https://au-api.basiq.io/users/11103cba-4a08-4397-84a5-22ac125ed2f6/accounts/49544383-c19c-4c97-b8d1-5322d0faa6af,https://au-api.basiq.io/institutions/AU00000,,Other Personal Services,953
transaction,b27632e5-3bad-47cd-81d1-af1128729288,posted,Only About Children Seaforth 1244301,-163.00,49544383-c19c-4c97-b8d1-5322d0faa6af,14089.74,debit,payment,AU00000,5453f0a3-083c-43c6-9086-adfe94df9918,,,2022-12-29T00:00:00Z,,https://au-api.basiq.io/users/11103cba-4a08-4397-84a5-22ac125ed2f6/transactions/b27632e5-3bad-47cd-81d1-af1128729288,https://au-api.basiq.io/users/11103cba-4a08-4397-84a5-22ac125ed2f6/accounts/49544383-c19c-4c97-b8d1-5322d0faa6af,https://au-api.basiq.io/institutions/AU00000,,Other Health Care Services,859
transaction,04dc015a-f812-481e-92df-11c862a77094,posted,Manly Food Co-Op Manly AU,-39.32,49544383-c19c-4c97-b8d1-5322d0faa6af,14252.74,debit,payment,AU00000,5453f0a3-083c-43c6-9086-adfe94df9918,,,2022-12-29T00:00:00Z,,https://au-api.basiq.io/users/11103cba-4a08-4397-84a5-22ac125ed2f6/transactions/04dc015a-f812-481e-92df-11c862a77094,https://au-api.basiq.io/users/11103cba-4a08-4397-84a5-22ac125ed2f6/accounts/49544383-c19c-4c97-b8d1-5322d0faa6af,https://au-api.basiq.io/institutions/AU00000,,Specialised Food Retailing,412
transaction,ad61a2a0-2979-4b05-90ce-118765974dd1,posted,TFR From Transaction to CC Acc 13,9353.50,49544383-c19c-4c97-b8d1-5322d0faa6af,14292.06,credit,transfer,AU00000,5453f0a3-083c-43c6-9086-adfe94df9918,,,2022-12-28T00:00:00Z,,https://au-api.basiq.io/users/11103cba-4a08-4397-84a5-22ac125ed2f6/transactions/ad61a2a0-2979-4b05-90ce-118765974dd1,https://au-api.basiq.io/users/11103cba-4a08-4397-84a5-22ac125ed2f6/accounts/49544383-c19c-4c97-b8d1-5322d0faa6af,https://au-api.basiq.io/institutions/AU00000,,,
transaction,0586f7ac-dcca-43f1-8f31-c7cfe69b4cf3,posted,Cash Wdr  FRENCHS FRST AU,-203.00,49544383-c19c-4c97-b8d1-5322d0faa6af,4938.56,debit,cash-withdrawal,AU00000,5453f0a3-083c-43c6-9086-adfe94df9918,,,2022-12-28T00:00:00Z,,https://au-api.basiq.io/users/11103cba-4a08-4397-84a5-22ac125ed2f6/transactions/0586f7ac-dcca-43f1-8f31-c7cfe69b4cf3,https://au-api.basiq.io/users/11103cba-4a08-4397-84a5-22ac125ed2f6/accounts/49544383-c19c-4c97-b8d1-5322d0faa6af,https://au-api.basiq.io/institutions/AU00000,,,
transaction,0dfbfbdd-925a-4a77-8bb4-4891c97069bf,posted,CONNECT RADIOLOGY DEE WHY AU,-173.75,49544383-c19c-4c97-b8d1-5322d0faa6af,5141.56,debit,payment,AU00000,5453f0a3-083c-43c6-9086-adfe94df9918,,,2022-12-28T00:00:00Z,,https://au-api.basiq.io/users/11103cba-4a08-4397-84a5-22ac125ed2f6/transactions/0dfbfbdd-925a-4a77-8bb4-4891c97069bf,https://au-api.basiq.io/users/11103cba-4a08-4397-84a5-22ac125ed2f6/accounts/49544383-c19c-4c97-b8d1-5322d0faa6af,https://au-api.basiq.io/institutions/AU00000,,Other Health Care Services,859
transaction,3727cbf9-750d-4b86-b1ea-32c9aff75de2,posted,OFARM ORGANIC GROCER BROO,-35.14,49544383-c19c-4c97-b8d1-5322d0faa6af,5315.31,debit,payment,AU00000,5453f0a3-083c-43c6-9086-adfe94df9918,,,2022-12-27T00:00:00Z,,https://au-api.basiq.io/users/11103cba-4a08-4397-84a5-22ac125ed2f6/transactions/3727cbf9-750d-4b86-b1ea-32c9aff75de2,https://au-api.basiq.io/users/11103cba-4a08-4397-84a5-22ac125ed2f6/accounts/49544383-c19c-4c97-b8d1-5322d0faa6af,https://au-api.basiq.io/institutions/AU00000,,Supermarket and Grocery Stores,411
transaction,74840512-8236-48fa-9bff-8d5898c60d48,posted,NAKED FOOD WARRINGAH BOND,-21.13,49544383-c19c-4c97-b8d1-5322d0faa6af,5350.45,debit,payment,AU00000,5453f0a3-083c-43c6-9086-adfe94df9918,,,2022-12-27T00:00:00Z,,https://au-api.basiq.io/users/11103cba-4a08-4397-84a5-22ac125ed2f6/transactions/74840512-8236-48fa-9bff-8d5898c60d48,https://au-api.basiq.io/users/11103cba-4a08-4397-84a5-22ac125ed2f6/accounts/49544383-c19c-4c97-b8d1-5322d0faa6af,https://au-api.basiq.io/institutions/AU00000,,Specialised Food Retailing,412
transaction,aebf3bf5-f86a-4222-81b0-61350802cdf6,posted,NAKED FOOD WARRINGAH BOND,-20.12,49544383-c19c-4c97-b8d1-5322d0faa6af,5371.58,debit,payment,AU00000,5453f0a3-083c-43c6-9086-adfe94df9918,,,2022-12-27T00:00:00Z,,https://au-api.basiq.io/users/11103cba-4a08-4397-84a5-22ac125ed2f6/transactions/aebf3bf5-f86a-4222-81b0-61350802cdf6,https://au-api.basiq.io/users/11103cba-4a08-4397-84a5-22ac125ed2f6/accounts/49544383-c19c-4c97-b8d1-5322d0faa6af,https://au-api.basiq.io/institutions/AU00000,,Specialised Food Retailing,412
transaction,d45c048e-d411-4cb9-ab60-57d6bfe6278f,posted,FARMERGREGSORGANIC WILD,-115.00,49544383-c19c-4c97-b8d1-5322d0faa6af,5391.70,debit,payment,AU00000,5453f0a3-083c-43c6-9086-adfe94df9918,,,2022-12-26T00:00:00Z,,https://au-api.basiq.io/users/11103cba-4a08-4397-84a5-22ac125ed2f6/transactions/d45c048e-d411-4cb9-ab60-57d6bfe6278f,https://au-api.basiq.io/users/11103cba-4a08-4397-84a5-22ac125ed2f6/accounts/49544383-c19c-4c97-b8d1-5322d0faa6af,https://au-api.basiq.io/institutions/AU00000,,Unknown,0
transaction,fc661c37-528e-4a98-b07d-6bff1f55bf05,posted,Impulse Chiropractic Nort,-61.00,49544383-c19c-4c97-b8d1-5322d0faa6af,5506.70,debit,payment,AU00000,5453f0a3-083c-43c6-9086-adfe94df9918,,,2022-12-26T00:00:00Z,,https://au-api.basiq.io/users/11103cba-4a08-4397-84a5-22ac125ed2f6/transactions/fc661c37-528e-4a98-b07d-6bff1f55bf05,https://au-api.basiq.io/users/11103cba-4a08-4397-84a5-22ac125ed2f6/accounts/49544383-c19c-4c97-b8d1-5322d0faa6af,https://au-api.basiq.io/institutions/AU00000,,Allied Health Services,853
transaction,39af5f53-2ab7-4490-88a4-ae0df0e3ed45,posted,GINSENG HEALTH FOODS FREN,-31.35,49544383-c19c-4c97-b8d1-5322d0faa6af,5567.70,debit,payment,AU00000,5453f0a3-083c-43c6-9086-adfe94df9918,,,2022-12-26T00:00:00Z,,https://au-api.basiq.io/users/11103cba-4a08-4397-84a5-22ac125ed2f6/transactions/39af5f53-2ab7-4490-88a4-ae0df0e3ed45,https://au-api.basiq.io/users/11103cba-4a08-4397-84a5-22ac125ed2f6/accounts/49544383-c19c-4c97-b8d1-5322d0faa6af,https://au-api.basiq.io/institutions/AU00000,,Specialised Food Retailing,412
transaction,582cdd2f-69c1-425e-a29c-43b73da697f3,posted,WOOLWORTHS 1063 FR FREN,-21.13,49544383-c19c-4c97-b8d1-5322d0faa6af,5599.05,debit,payment,AU00000,5453f0a3-083c-43c6-9086-adfe94df9918,,,2022-12-26T00:00:00Z,,https://au-api.basiq.io/users/11103cba-4a08-4397-84a5-22ac125ed2f6/transactions/582cdd2f-69c1-425e-a29c-43b73da697f3,https://au-api.basiq.io/users/11103cba-4a08-4397-84a5-22ac125ed2f6/accounts/49544383-c19c-4c97-b8d1-5322d0faa6af,https://au-api.basiq.io/institutions/AU00000,,Supermarket and Grocery Stores,411
transaction,89a2a4ad-0e13-4e54-b07c-9551e97eb672,posted,WOOLWORTHS 1063 FR FREN,-15.80,49544383-c19c-4c97-b8d1-5322d0faa6af,5620.18,debit,payment,AU00000,5453f0a3-083c-43c6-9086-adfe94df9918,,,2022-12-26T00:00:00Z,,https://au-api.basiq.io/users/11103cba-4a08-4397-84a5-22ac125ed2f6/transactions/89a2a4ad-0e13-4e54-b07c-9551e97eb672,https://au-api.basiq.io/users/11103cba-4a08-4397-84a5-22ac125ed2f6/accounts/49544383-c19c-4c97-b8d1-5322d0faa6af,https://au-api.basiq.io/institutions/AU00000,,Supermarket and Grocery Stores,411
transaction,29a7030b-c00f-479c-86ed-e3cffd7b94f0,posted,DISCOUNT TOY CO BELR,-15.39,49544383-c19c-4c97-b8d1-5322d0faa6af,5635.98,debit,payment,AU00000,5453f0a3-083c-43c6-9086-adfe94df9918,,,2022-12-26T00:00:00Z,,https://au-api.basiq.io/users/11103cba-4a08-4397-84a5-22ac125ed2f6/transactions/29a7030b-c00f-479c-86ed-e3cffd7b94f0,https://au-api.basiq.io/users/11103cba-4a08-4397-84a5-22ac125ed2f6/accounts/49544383-c19c-4c97-b8d1-5322d0faa6af,https://au-api.basiq.io/institutions/AU00000,,Recreational Goods Retailing,424
transaction,a1f239af-b15c-4a0d-b6f9-8736b3941296,posted,REFUND  BONDI JUNCTI AU,21.13,49544383-c19c-4c97-b8d1-5322d0faa6af,5651.37,credit,refund,AU00000,5453f0a3-083c-43c6-9086-adfe94df9918,,,2022-12-26T00:00:00Z,,https://au-api.basiq.io/users/11103cba-4a08-4397-84a5-22ac125ed2f6/transactions/a1f239af-b15c-4a0d-b6f9-8736b3941296,https://au-api.basiq.io/users/11103cba-4a08-4397-84a5-22ac125ed2f6/accounts/49544383-c19c-4c97-b8d1-5322d0faa6af,https://au-api.basiq.io/institutions/AU00000,,,
transaction,fbf386e5-0f39-4967-ab5f-dccb45f8c853,posted,HEADYS PTY LTD BROOKVALE AU,-138.88,49544383-c19c-4c97-b8d1-5322d0faa6af,5630.24,debit,payment,AU00000,5453f0a3-083c-43c6-9086-adfe94df9918,,,2022-12-26T00:00:00Z,,https://au-api.basiq.io/users/11103cba-4a08-4397-84a5-22ac125ed2f6/transactions/fbf386e5-0f39-4967-ab5f-dccb45f8c853,https://au-api.basiq.io/users/11103cba-4a08-4397-84a5-22ac125ed2f6/accounts/49544383-c19c-4c97-b8d1-5322d0faa6af,https://au-api.basiq.io/institutions/AU00000,,Specialised Food Retailing,412
transaction,f418f43e-74a4-4015-8a2f-b640331ee4a4,posted,Sunset Sabi Manl,-41.00,49544383-c19c-4c97-b8d1-5322d0faa6af,5769.12,debit,payment,AU00000,5453f0a3-083c-43c6-9086-adfe94df9918,,,2022-12-25T00:00:00Z,,https://au-api.basiq.io/users/11103cba-4a08-4397-84a5-22ac125ed2f6/transactions/f418f43e-74a4-4015-8a2f-b640331ee4a4,https://au-api.basiq.io/users/11103cba-4a08-4397-84a5-22ac125ed2f6/accounts/49544383-c19c-4c97-b8d1-5322d0faa6af,https://au-api.basiq.io/institutions/AU00000,,"Cafes, Restaurants and Takeaway Food Services",451
transaction,62134bbb-dc1a-4729-8b52-88ef33e3b473,posted,SPOTLIGHT 050 BELR,-18.43,49544383-c19c-4c97-b8d1-5322d0faa6af,5810.12,debit,payment,AU00000,5453f0a3-083c-43c6-9086-adfe94df9918,,,2022-12-25T00:00:00Z,,https://au-api.basiq.io/users/11103cba-4a08-4397-84a5-22ac125ed2f6/transactions/62134bbb-dc1a-4729-8b52-88ef33e3b473,https://au-api.basiq.io/users/11103cba-4a08-4397-84a5-22ac125ed2f6/accounts/49544383-c19c-4c97-b8d1-5322d0faa6af,https://au-api.basiq.io/institutions/AU00000,,"Furniture, Floor Coverings, Houseware and Textile Goods Retailing",421
transaction,cd4eeaff-24c7-4372-847e-651a64de390a,posted,AGL SALES P/L 0307 MELB,-227.55,49544383-c19c-4c97-b8d1-5322d0faa6af,5828.55,debit,payment,AU00000,5453f0a3-083c-43c6-9086-adfe94df9918,,,2022-12-22T00:00:00Z,,https://au-api.basiq.io/users/11103cba-4a08-4397-84a5-22ac125ed2f6/transactions/cd4eeaff-24c7-4372-847e-651a64de390a,https://au-api.basiq.io/users/11103cba-4a08-4397-84a5-22ac125ed2f6/accounts/49544383-c19c-4c97-b8d1-5322d0faa6af,https://au-api.basiq.io/institutions/AU00000,,Electricity Distribution,263
transaction,d6a32e70-414b-4f25-8a47-6e0d0021f229,posted,AGL SALES P/L 0307 MELB,-132.24,49544383-c19c-4c97-b8d1-5322d0faa6af,6056.10,debit,payment,AU00000,5453f0a3-083c-43c6-9086-adfe94df9918,,,2022-12-22T00:00:00Z,,https://au-api.basiq.io/users/11103cba-4a08-4397-84a5-22ac125ed2f6/transactions/d6a32e70-414b-4f25-8a47-6e0d0021f229,https://au-api.basiq.io/users/11103cba-4a08-4397-84a5-22ac125ed2f6/accounts/49544383-c19c-4c97-b8d1-5322d0faa6af,https://au-api.basiq.io/institutions/AU00000,,Electricity Distribution,263
transaction,b4d8f272-a838-4ce2-aeda-ae783773e729,posted,WOOLWORTHS 1063 FR FREN,-23.55,49544383-c19c-4c97-b8d1-5322d0faa6af,6188.34,debit,payment,AU00000,5453f0a3-083c-43c6-9086-adfe94df9918,,,2022-12-22T00:00:00Z,,https://au-api.basiq.io/users/11103cba-4a08-4397-84a5-22ac125ed2f6/transactions/b4d8f272-a838-4ce2-aeda-ae783773e729,https://au-api.basiq.io/users/11103cba-4a08-4397-84a5-22ac125ed2f6/accounts/49544383-c19c-4c97-b8d1-5322d0faa6af,https://au-api.basiq.io/institutions/AU00000,,Supermarket and Grocery Stores,411
transaction,4ae71c6a-ac38-4736-a856-b3cb660247d3,posted,Only About Children Seaforth 1244301,-163.00,49544383-c19c-4c97-b8d1-5322d0faa6af,6211.89,debit,payment,AU00000,5453f0a3-083c-43c6-9086-adfe94df9918,,,2022-12-22T00:00:00Z,,https://au-api.basiq.io/users/11103cba-4a08-4397-84a5-22ac125ed2f6/transactions/4ae71c6a-ac38-4736-a856-b3cb660247d3,https://au-api.basiq.io/users/11103cba-4a08-4397-84a5-22ac125ed2f6/accounts/49544383-c19c-4c97-b8d1-5322d0faa6af,https://au-api.basiq.io/institutions/AU00000,,Other Health Care Services,859
transaction,93fbaf09-fc48-45eb-a783-e2e37189cdb3,posted,SQ *HOLISTIC SKIN Manl,-286.00,49544383-c19c-4c97-b8d1-5322d0faa6af,6374.89,debit,payment,AU00000,5453f0a3-083c-43c6-9086-adfe94df9918,,,2022-12-21T00:00:00Z,,https://au-api.basiq.io/users/11103cba-4a08-4397-84a5-22ac125ed2f6/transactions/93fbaf09-fc48-45eb-a783-e2e37189cdb3,https://au-api.basiq.io/users/11103cba-4a08-4397-84a5-22ac125ed2f6/accounts/49544383-c19c-4c97-b8d1-5322d0faa6af,https://au-api.basiq.io/institutions/AU00000,,Personal Care Services,951
transaction,d1872e2e-914b-4e38-893b-c72a0e5d4f58,posted,UNITED DEE WHY PITTW DEE,-87.41,49544383-c19c-4c97-b8d1-5322d0faa6af,6660.89,debit,payment,AU00000,5453f0a3-083c-43c6-9086-adfe94df9918,,,2022-12-21T00:00:00Z,,https://au-api.basiq.io/users/11103cba-4a08-4397-84a5-22ac125ed2f6/transactions/d1872e2e-914b-4e38-893b-c72a0e5d4f58,https://au-api.basiq.io/users/11103cba-4a08-4397-84a5-22ac125ed2f6/accounts/49544383-c19c-4c97-b8d1-5322d0faa6af,https://au-api.basiq.io/institutions/AU00000,,Fuel Retailing,400
transaction,1c8a8109-809d-442c-a210-7b4554b55f42,posted,NAKED FOOD WARRINGAH BOND,-52.58,49544383-c19c-4c97-b8d1-5322d0faa6af,6748.30,debit,payment,AU00000,5453f0a3-083c-43c6-9086-adfe94df9918,,,2022-12-21T00:00:00Z,,https://au-api.basiq.io/users/11103cba-4a08-4397-84a5-22ac125ed2f6/transactions/1c8a8109-809d-442c-a210-7b4554b55f42,https://au-api.basiq.io/users/11103cba-4a08-4397-84a5-22ac125ed2f6/accounts/49544383-c19c-4c97-b8d1-5322d0faa6af,https://au-api.basiq.io/institutions/AU00000,,Specialised Food Retailing,412
transaction,9369ddc9-7629-456d-a3d9-23fe6e492aab,posted,HEADYS PTY LTD BROO,-36.80,49544383-c19c-4c97-b8d1-5322d0faa6af,6800.88,debit,payment,AU00000,5453f0a3-083c-43c6-9086-adfe94df9918,,,2022-12-21T00:00:00Z,,https://au-api.basiq.io/users/11103cba-4a08-4397-84a5-22ac125ed2f6/transactions/9369ddc9-7629-456d-a3d9-23fe6e492aab,https://au-api.basiq.io/users/11103cba-4a08-4397-84a5-22ac125ed2f6/accounts/49544383-c19c-4c97-b8d1-5322d0faa6af,https://au-api.basiq.io/institutions/AU00000,,Specialised Food Retailing,412
transaction,cf7ca3ab-957e-47ce-ba47-4e7d0993f67a,posted,THE REJECT SHOP 2348 BROO,-16.50,49544383-c19c-4c97-b8d1-5322d0faa6af,6837.68,debit,payment,AU00000,5453f0a3-083c-43c6-9086-adfe94df9918,,,2022-12-21T00:00:00Z,,https://au-api.basiq.io/users/11103cba-4a08-4397-84a5-22ac125ed2f6/transactions/cf7ca3ab-957e-47ce-ba47-4e7d0993f67a,https://au-api.basiq.io/users/11103cba-4a08-4397-84a5-22ac125ed2f6/accounts/49544383-c19c-4c97-b8d1-5322d0faa6af,https://au-api.basiq.io/institutions/AU00000,,Pharmaceutical and Other Store-Based Retailing,427
transaction,7ec0d255-c02a-455e-8038-87a0591021c6,posted,NORTHERN BEACHES COUNCIL - SOUTH RATES,-363.90,49544383-c19c-4c97-b8d1-5322d0faa6af,6854.18,debit,payment,AU00000,5453f0a3-083c-43c6-9086-adfe94df9918,,,2022-12-21T00:00:00Z,,https://au-api.basiq.io/users/11103cba-4a08-4397-84a5-22ac125ed2f6/transactions/7ec0d255-c02a-455e-8038-87a0591021c6,https://au-api.basiq.io/users/11103cba-4a08-4397-84a5-22ac125ed2f6/accounts/49544383-c19c-4c97-b8d1-5322d0faa6af,https://au-api.basiq.io/institutions/AU00000,,Local Government Administration,753
transaction,75128e0d-a5d7-4bcd-8320-fd9042bd277b,posted,BP ALLAMBIE 0754 ALLA,-57.63,49544383-c19c-4c97-b8d1-5322d0faa6af,7218.08,debit,payment,AU00000,5453f0a3-083c-43c6-9086-adfe94df9918,,,2022-12-20T00:00:00Z,,https://au-api.basiq.io/users/11103cba-4a08-4397-84a5-22ac125ed2f6/transactions/75128e0d-a5d7-4bcd-8320-fd9042bd277b,https://au-api.basiq.io/users/11103cba-4a08-4397-84a5-22ac125ed2f6/accounts/49544383-c19c-4c97-b8d1-5322d0faa6af,https://au-api.basiq.io/institutions/AU00000,,Fuel Retailing,400
transaction,84bc0e51-fa5a-4f51-80b0-5ca917abe0c4,posted,WOOLWORTHS 1282 BROO,-13.30,49544383-c19c-4c97-b8d1-5322d0faa6af,7275.71,debit,payment,AU00000,5453f0a3-083c-43c6-9086-adfe94df9918,,,2022-12-20T00:00:00Z,,https://au-api.basiq.io/users/11103cba-4a08-4397-84a5-22ac125ed2f6/transactions/84bc0e51-fa5a-4f51-80b0-5ca917abe0c4,https://au-api.basiq.io/users/11103cba-4a08-4397-84a5-22ac125ed2f6/accounts/49544383-c19c-4c97-b8d1-5322d0faa6af,https://au-api.basiq.io/institutions/AU00000,,Supermarket and Grocery Stores,411
transaction,0f742787-2b79-44a7-b32d-135a40ca9e1d,posted,OFARM ORGANIC GROCER BROO,-11.13,49544383-c19c-4c97-b8d1-5322d0faa6af,7289.01,debit,payment,AU00000,5453f0a3-083c-43c6-9086-adfe94df9918,,,2022-12-20T00:00:00Z,,https://au-api.basiq.io/users/11103cba-4a08-4397-84a5-22ac125ed2f6/transactions/0f742787-2b79-44a7-b32d-135a40ca9e1d,https://au-api.basiq.io/users/11103cba-4a08-4397-84a5-22ac125ed2f6/accounts/49544383-c19c-4c97-b8d1-5322d0faa6af,https://au-api.basiq.io/institutions/AU00000,,Supermarket and Grocery Stores,411
transaction,a4125125-7b67-4126-abe3-c895ebee96d4,posted,YEGANA JAFAROVA DARI,-153.66,49544383-c19c-4c97-b8d1-5322d0faa6af,7300.14,debit,payment,AU00000,5453f0a3-083c-43c6-9086-adfe94df9918,,,2022-12-19T00:00:00Z,,https://au-api.basiq.io/users/11103cba-4a08-4397-84a5-22ac125ed2f6/transactions/a4125125-7b67-4126-abe3-c895ebee96d4,https://au-api.basiq.io/users/11103cba-4a08-4397-84a5-22ac125ed2f6/accounts/49544383-c19c-4c97-b8d1-5322d0faa6af,https://au-api.basiq.io/institutions/AU00000,,Tertiary Education,810
transaction,a2376eaf-a5e4-46d3-88be-531e9fe04c50,posted,POZIBLE*save-the-manly pozi,-101.00,49544383-c19c-4c97-b8d1-5322d0faa6af,7453.80,debit,payment,AU00000,5453f0a3-083c-43c6-9086-adfe94df9918,,,2022-12-19T00:00:00Z,,https://au-api.basiq.io/users/11103cba-4a08-4397-84a5-22ac125ed2f6/transactions/a2376eaf-a5e4-46d3-88be-531e9fe04c50,https://au-api.basiq.io/users/11103cba-4a08-4397-84a5-22ac125ed2f6/accounts/49544383-c19c-4c97-b8d1-5322d0faa6af,https://au-api.basiq.io/institutions/AU00000,,Other Personal Services,953
transaction,14218118-c850-4eb5-80fa-6fdb9de4e02d,posted,FARMERGREGSORGANIC WILD,-91.00,49544383-c19c-4c97-b8d1-5322d0faa6af,7554.80,debit,payment,AU00000,5453f0a3-083c-43c6-9086-adfe94df9918,,,2022-12-19T00:00:00Z,,https://au-api.basiq.io/users/11103cba-4a08-4397-84a5-22ac125ed2f6/transactions/14218118-c850-4eb5-80fa-6fdb9de4e02d,https://au-api.basiq.io/users/11103cba-4a08-4397-84a5-22ac125ed2f6/accounts/49544383-c19c-4c97-b8d1-5322d0faa6af,https://au-api.basiq.io/institutions/AU00000,,Unknown,0
transaction,cdb2ee28-5847-4233-921f-24246c2fcd29,posted,WOOLWORTHS 1282 BROO,-39.20,49544383-c19c-4c97-b8d1-5322d0faa6af,7645.80,debit,payment,AU00000,5453f0a3-083c-43c6-9086-adfe94df9918,,,2022-12-19T00:00:00Z,,https://au-api.basiq.io/users/11103cba-4a08-4397-84a5-22ac125ed2f6/transactions/cdb2ee28-5847-4233-921f-24246c2fcd29,https://au-api.basiq.io/users/11103cba-4a08-4397-84a5-22ac125ed2f6/accounts/49544383-c19c-4c97-b8d1-5322d0faa6af,https://au-api.basiq.io/institutions/AU00000,,Supermarket and Grocery Stores,411
transaction,74b54df2-ba61-46c5-84aa-e4924ad5bed3,posted,FREE RANGE BUTCHERS MONA,-33.90,49544383-c19c-4c97-b8d1-5322d0faa6af,7685.00,debit,payment,AU00000,5453f0a3-083c-43c6-9086-adfe94df9918,,,2022-12-19T00:00:00Z,,https://au-api.basiq.io/users/11103cba-4a08-4397-84a5-22ac125ed2f6/transactions/74b54df2-ba61-46c5-84aa-e4924ad5bed3,https://au-api.basiq.io/users/11103cba-4a08-4397-84a5-22ac125ed2f6/accounts/49544383-c19c-4c97-b8d1-5322d0faa6af,https://au-api.basiq.io/institutions/AU00000,,Specialised Food Retailing,412
transaction,bb2a93ca-7595-4489-bf88-061f24b8a3cb,posted,GINSENG HEALTH FOODS FREN,-28.00,49544383-c19c-4c97-b8d1-5322d0faa6af,7718.90,debit,payment,AU00000,5453f0a3-083c-43c6-9086-adfe94df9918,,,2022-12-19T00:00:00Z,,https://au-api.basiq.io/users/11103cba-4a08-4397-84a5-22ac125ed2f6/transactions/bb2a93ca-7595-4489-bf88-061f24b8a3cb,https://au-api.basiq.io/users/11103cba-4a08-4397-84a5-22ac125ed2f6/accounts/49544383-c19c-4c97-b8d1-5322d0faa6af,https://au-api.basiq.io/institutions/AU00000,,Specialised Food Retailing,412
transaction,b55d9cfd-f0bc-4f04-881c-7847ae822486,posted,HEADYS PTY LTD BROOKVALE AU,-70.70,49544383-c19c-4c97-b8d1-5322d0faa6af,7746.90,debit,payment,AU00000,5453f0a3-083c-43c6-9086-adfe94df9918,,,2022-12-19T00:00:00Z,,https://au-api.basiq.io/users/11103cba-4a08-4397-84a5-22ac125ed2f6/transactions/b55d9cfd-f0bc-4f04-881c-7847ae822486,https://au-api.basiq.io/users/11103cba-4a08-4397-84a5-22ac125ed2f6/accounts/49544383-c19c-4c97-b8d1-5322d0faa6af,https://au-api.basiq.io/institutions/AU00000,,Specialised Food Retailing,412
transaction,1ddb6dcc-29c8-4267-a9e2-a2639d1b1207,posted,SHIRALEE ORGANIC MEATS MANL,-32.90,49544383-c19c-4c97-b8d1-5322d0faa6af,7817.60,debit,payment,AU00000,5453f0a3-083c-43c6-9086-adfe94df9918,,,2022-12-18T00:00:00Z,,https://au-api.basiq.io/users/11103cba-4a08-4397-84a5-22ac125ed2f6/transactions/1ddb6dcc-29c8-4267-a9e2-a2639d1b1207,https://au-api.basiq.io/users/11103cba-4a08-4397-84a5-22ac125ed2f6/accounts/49544383-c19c-4c97-b8d1-5322d0faa6af,https://au-api.basiq.io/institutions/AU00000,,Specialised Food Retailing,412
transaction,f7fbab80-f1b1-4c6a-b3a2-ba53be744147,posted,MANLY HEALTH FOODS MANL,-28.00,49544383-c19c-4c97-b8d1-5322d0faa6af,7850.50,debit,payment,AU00000,5453f0a3-083c-43c6-9086-adfe94df9918,,,2022-12-18T00:00:00Z,,https://au-api.basiq.io/users/11103cba-4a08-4397-84a5-22ac125ed2f6/transactions/f7fbab80-f1b1-4c6a-b3a2-ba53be744147,https://au-api.basiq.io/users/11103cba-4a08-4397-84a5-22ac125ed2f6/accounts/49544383-c19c-4c97-b8d1-5322d0faa6af,https://au-api.basiq.io/institutions/AU00000,,Specialised Food Retailing,412
transaction,eeb13a21-b379-403a-a6d2-c3e8d9072c73,posted,OFARM ORGANIC GROCER MANL,-16.05,49544383-c19c-4c97-b8d1-5322d0faa6af,7878.50,debit,payment,AU00000,5453f0a3-083c-43c6-9086-adfe94df9918,,,2022-12-18T00:00:00Z,,https://au-api.basiq.io/users/11103cba-4a08-4397-84a5-22ac125ed2f6/transactions/eeb13a21-b379-403a-a6d2-c3e8d9072c73,https://au-api.basiq.io/users/11103cba-4a08-4397-84a5-22ac125ed2f6/accounts/49544383-c19c-4c97-b8d1-5322d0faa6af,https://au-api.basiq.io/institutions/AU00000,,Supermarket and Grocery Stores,411
transaction,623f4bc4-59e7-4b70-b9e4-e59e0319438c,posted,GINSENG HEALTH FOODS FREN,-15.90,49544383-c19c-4c97-b8d1-5322d0faa6af,7894.55,debit,payment,AU00000,5453f0a3-083c-43c6-9086-adfe94df9918,,,2022-12-18T00:00:00Z,,https://au-api.basiq.io/users/11103cba-4a08-4397-84a5-22ac125ed2f6/transactions/623f4bc4-59e7-4b70-b9e4-e59e0319438c,https://au-api.basiq.io/users/11103cba-4a08-4397-84a5-22ac125ed2f6/accounts/49544383-c19c-4c97-b8d1-5322d0faa6af,https://au-api.basiq.io/institutions/AU00000,,Specialised Food Retailing,412
transaction,b3b0802e-4297-43ca-98fb-3035817dc37f,posted,WOOLWORTHS 1262 BELR,-49.00,49544383-c19c-4c97-b8d1-5322d0faa6af,7910.45,debit,payment,AU00000,5453f0a3-083c-43c6-9086-adfe94df9918,,,2022-12-18T00:00:00Z,,https://au-api.basiq.io/users/11103cba-4a08-4397-84a5-22ac125ed2f6/transactions/b3b0802e-4297-43ca-98fb-3035817dc37f,https://au-api.basiq.io/users/11103cba-4a08-4397-84a5-22ac125ed2f6/accounts/49544383-c19c-4c97-b8d1-5322d0faa6af,https://au-api.basiq.io/institutions/AU00000,,Supermarket and Grocery Stores,411
transaction,532a2705-37e6-4f5e-9558-49edaa761022,posted,WOOLWORTHS 1262 BELR,-55.99,49544383-c19c-4c97-b8d1-5322d0faa6af,7959.45,debit,payment,AU00000,5453f0a3-083c-43c6-9086-adfe94df9918,,,2022-12-18T00:00:00Z,,https://au-api.basiq.io/users/11103cba-4a08-4397-84a5-22ac125ed2f6/transactions/532a2705-37e6-4f5e-9558-49edaa761022,https://au-api.basiq.io/users/11103cba-4a08-4397-84a5-22ac125ed2f6/accounts/49544383-c19c-4c97-b8d1-5322d0faa6af,https://au-api.basiq.io/institutions/AU00000,,Supermarket and Grocery Stores,411
transaction,60ec1789-e0ef-4bd3-9982-6798a634df83,posted,WOOLWORTHS 1063 FRENCHS FRST NSW AU,-39.17,49544383-c19c-4c97-b8d1-5322d0faa6af,8015.44,debit,payment,AU00000,5453f0a3-083c-43c6-9086-adfe94df9918,,,2022-12-17T00:00:00Z,,https://au-api.basiq.io/users/11103cba-4a08-4397-84a5-22ac125ed2f6/transactions/60ec1789-e0ef-4bd3-9982-6798a634df83,https://au-api.basiq.io/users/11103cba-4a08-4397-84a5-22ac125ed2f6/accounts/49544383-c19c-4c97-b8d1-5322d0faa6af,https://au-api.basiq.io/institutions/AU00000,,Supermarket and Grocery Stores,411
transaction,df890fc5-714a-46b3-965c-ba49dfac2691,posted,Cash Wdr  FRENCHS FRST AU,-53.00,49544383-c19c-4c97-b8d1-5322d0faa6af,8054.61,debit,cash-withdrawal,AU00000,5453f0a3-083c-43c6-9086-adfe94df9918,,,2022-12-17T00:00:00Z,,https://au-api.basiq.io/users/11103cba-4a08-4397-84a5-22ac125ed2f6/transactions/df890fc5-714a-46b3-965c-ba49dfac2691,https://au-api.basiq.io/users/11103cba-4a08-4397-84a5-22ac125ed2f6/accounts/49544383-c19c-4c97-b8d1-5322d0faa6af,https://au-api.basiq.io/institutions/AU00000,,,
transaction,01227c2a-107e-487b-b89b-38fde798d31e,posted,Only About Children Seaforth 1244301,-163.00,49544383-c19c-4c97-b8d1-5322d0faa6af,8107.61,debit,payment,AU00000,5453f0a3-083c-43c6-9086-adfe94df9918,,,2022-12-15T00:00:00Z,,https://au-api.basiq.io/users/11103cba-4a08-4397-84a5-22ac125ed2f6/transactions/01227c2a-107e-487b-b89b-38fde798d31e,https://au-api.basiq.io/users/11103cba-4a08-4397-84a5-22ac125ed2f6/accounts/49544383-c19c-4c97-b8d1-5322d0faa6af,https://au-api.basiq.io/institutions/AU00000,,Other Health Care Services,859
transaction,a7964042-4f88-4cd6-99a4-4f50595eb964,posted,WW PETROL 1790 BELC,-32.81,49544383-c19c-4c97-b8d1-5322d0faa6af,8270.61,debit,payment,AU00000,5453f0a3-083c-43c6-9086-adfe94df9918,,,2022-12-14T00:00:00Z,,https://au-api.basiq.io/users/11103cba-4a08-4397-84a5-22ac125ed2f6/transactions/a7964042-4f88-4cd6-99a4-4f50595eb964,https://au-api.basiq.io/users/11103cba-4a08-4397-84a5-22ac125ed2f6/accounts/49544383-c19c-4c97-b8d1-5322d0faa6af,https://au-api.basiq.io/institutions/AU00000,,Fuel Retailing,400
transaction,84d819df-03f7-4f45-ab67-e4d3cdd0c5ae,posted,WOOLWORTHS 1063 FR FREN,-31.73,49544383-c19c-4c97-b8d1-5322d0faa6af,8303.42,debit,payment,AU00000,5453f0a3-083c-43c6-9086-adfe94df9918,,,2022-12-14T00:00:00Z,,https://au-api.basiq.io/users/11103cba-4a08-4397-84a5-22ac125ed2f6/transactions/84d819df-03f7-4f45-ab67-e4d3cdd0c5ae,https://au-api.basiq.io/users/11103cba-4a08-4397-84a5-22ac125ed2f6/accounts/49544383-c19c-4c97-b8d1-5322d0faa6af,https://au-api.basiq.io/institutions/AU00000,,Supermarket and Grocery Stores,411
transaction,10c78e30-331e-4e27-b9b6-8feab591cd53,posted,WHOLEY MACKEREL SF FREN,-29.20,49544383-c19c-4c97-b8d1-5322d0faa6af,8335.15,debit,payment,AU00000,5453f0a3-083c-43c6-9086-adfe94df9918,,,2022-12-14T00:00:00Z,,https://au-api.basiq.io/users/11103cba-4a08-4397-84a5-22ac125ed2f6/transactions/10c78e30-331e-4e27-b9b6-8feab591cd53,https://au-api.basiq.io/users/11103cba-4a08-4397-84a5-22ac125ed2f6/accounts/49544383-c19c-4c97-b8d1-5322d0faa6af,https://au-api.basiq.io/institutions/AU00000,,"Cafes, Restaurants and Takeaway Food Services",451
transaction,cb2cfe16-afec-44e4-ad00-3c3eb0e4253b,posted,HEMMINGWAYS MANLY,-17.00,49544383-c19c-4c97-b8d1-5322d0faa6af,8364.35,debit,payment,AU00000,5453f0a3-083c-43c6-9086-adfe94df9918,,,2022-12-14T00:00:00Z,,https://au-api.basiq.io/users/11103cba-4a08-4397-84a5-22ac125ed2f6/transactions/cb2cfe16-afec-44e4-ad00-3c3eb0e4253b,https://au-api.basiq.io/users/11103cba-4a08-4397-84a5-22ac125ed2f6/accounts/49544383-c19c-4c97-b8d1-5322d0faa6af,https://au-api.basiq.io/institutions/AU00000,,Unknown,0
transaction,67173943-2bca-4889-a143-dfa069e75ccf,posted,OPTUS PREPAID MELBOURN,-40.00,49544383-c19c-4c97-b8d1-5322d0faa6af,8381.35,debit,payment,AU00000,5453f0a3-083c-43c6-9086-adfe94df9918,,,2022-12-14T00:00:00Z,,https://au-api.basiq.io/users/11103cba-4a08-4397-84a5-22ac125ed2f6/transactions/67173943-2bca-4889-a143-dfa069e75ccf,https://au-api.basiq.io/users/11103cba-4a08-4397-84a5-22ac125ed2f6/accounts/49544383-c19c-4c97-b8d1-5322d0faa6af,https://au-api.basiq.io/institutions/AU00000,,Telecommunications Services,580
transaction,147e1839-d7fd-4aed-b955-50e938cbef63,posted,LUSH WARRINGAH BROO,-56.45,49544383-c19c-4c97-b8d1-5322d0faa6af,8421.35,debit,payment,AU00000,5453f0a3-083c-43c6-9086-adfe94df9918,,,2022-12-13T00:00:00Z,,https://au-api.basiq.io/users/11103cba-4a08-4397-84a5-22ac125ed2f6/transactions/147e1839-d7fd-4aed-b955-50e938cbef63,https://au-api.basiq.io/users/11103cba-4a08-4397-84a5-22ac125ed2f6/accounts/49544383-c19c-4c97-b8d1-5322d0faa6af,https://au-api.basiq.io/institutions/AU00000,,Pharmaceutical and Other Store-Based Retailing,427
transaction,a3b6082f-cb6c-4ea8-a15e-ee250c051bd6,posted,HEADYS PTY LTD BROO,-20.78,49544383-c19c-4c97-b8d1-5322d0faa6af,8477.80,debit,payment,AU00000,5453f0a3-083c-43c6-9086-adfe94df9918,,,2022-12-13T00:00:00Z,,https://au-api.basiq.io/users/11103cba-4a08-4397-84a5-22ac125ed2f6/transactions/a3b6082f-cb6c-4ea8-a15e-ee250c051bd6,https://au-api.basiq.io/users/11103cba-4a08-4397-84a5-22ac125ed2f6/accounts/49544383-c19c-4c97-b8d1-5322d0faa6af,https://au-api.basiq.io/institutions/AU00000,,Specialised Food Retailing,412
transaction,b4c28eb6-949f-4fed-9940-09a10f7d120e,posted,OFARM ORGANIC GROCER BROO,-5.25,49544383-c19c-4c97-b8d1-5322d0faa6af,8498.58,debit,payment,AU00000,5453f0a3-083c-43c6-9086-adfe94df9918,,,2022-12-13T00:00:00Z,,https://au-api.basiq.io/users/11103cba-4a08-4397-84a5-22ac125ed2f6/transactions/b4c28eb6-949f-4fed-9940-09a10f7d120e,https://au-api.basiq.io/users/11103cba-4a08-4397-84a5-22ac125ed2f6/accounts/49544383-c19c-4c97-b8d1-5322d0faa6af,https://au-api.basiq.io/institutions/AU00000,,Supermarket and Grocery Stores,411
transaction,f86fd87c-6755-4bb1-9bfd-d211d89b2748,posted,WOOLWORTHS 1262 BELR,-84.74,49544383-c19c-4c97-b8d1-5322d0faa6af,8503.83,debit,payment,AU00000,5453f0a3-083c-43c6-9086-adfe94df9918,,,2022-12-12T00:00:00Z,,https://au-api.basiq.io/users/11103cba-4a08-4397-84a5-22ac125ed2f6/transactions/f86fd87c-6755-4bb1-9bfd-d211d89b2748,https://au-api.basiq.io/users/11103cba-4a08-4397-84a5-22ac125ed2f6/accounts/49544383-c19c-4c97-b8d1-5322d0faa6af,https://au-api.basiq.io/institutions/AU00000,,Supermarket and Grocery Stores,411
transaction,c318c8ba-1749-4baa-a39e-57fdd886a7bc,posted,WOOLWORTHS 1063 FR FREN,-77.30,49544383-c19c-4c97-b8d1-5322d0faa6af,8588.57,debit,payment,AU00000,5453f0a3-083c-43c6-9086-adfe94df9918,,,2022-12-12T00:00:00Z,,https://au-api.basiq.io/users/11103cba-4a08-4397-84a5-22ac125ed2f6/transactions/c318c8ba-1749-4baa-a39e-57fdd886a7bc,https://au-api.basiq.io/users/11103cba-4a08-4397-84a5-22ac125ed2f6/accounts/49544383-c19c-4c97-b8d1-5322d0faa6af,https://au-api.basiq.io/institutions/AU00000,,Supermarket and Grocery Stores,411
transaction,f842fbab-9a7e-4ca1-8388-a0f189188923,posted,AVANTI PIZZERIA REST WHEE,-75.00,49544383-c19c-4c97-b8d1-5322d0faa6af,8665.87,debit,payment,AU00000,5453f0a3-083c-43c6-9086-adfe94df9918,,,2022-12-12T00:00:00Z,,https://au-api.basiq.io/users/11103cba-4a08-4397-84a5-22ac125ed2f6/transactions/f842fbab-9a7e-4ca1-8388-a0f189188923,https://au-api.basiq.io/users/11103cba-4a08-4397-84a5-22ac125ed2f6/accounts/49544383-c19c-4c97-b8d1-5322d0faa6af,https://au-api.basiq.io/institutions/AU00000,,"Cafes, Restaurants and Takeaway Food Services",451
transaction,f942a91d-8282-4e66-857c-c0ef793fbf28,posted,WOOLWORTHS 1063 FR FREN,-69.39,49544383-c19c-4c97-b8d1-5322d0faa6af,8740.87,debit,payment,AU00000,5453f0a3-083c-43c6-9086-adfe94df9918,,,2022-12-12T00:00:00Z,,https://au-api.basiq.io/users/11103cba-4a08-4397-84a5-22ac125ed2f6/transactions/f942a91d-8282-4e66-857c-c0ef793fbf28,https://au-api.basiq.io/users/11103cba-4a08-4397-84a5-22ac125ed2f6/accounts/49544383-c19c-4c97-b8d1-5322d0faa6af,https://au-api.basiq.io/institutions/AU00000,,Supermarket and Grocery Stores,411
transaction,b1562c8e-d2ba-4d77-8f6f-3547b25b451d,posted,WOOLWORTHS 1063 FR FREN,-35.90,49544383-c19c-4c97-b8d1-5322d0faa6af,8810.26,debit,payment,AU00000,5453f0a3-083c-43c6-9086-adfe94df9918,,,2022-12-12T00:00:00Z,,https://au-api.basiq.io/users/11103cba-4a08-4397-84a5-22ac125ed2f6/transactions/b1562c8e-d2ba-4d77-8f6f-3547b25b451d,https://au-api.basiq.io/users/11103cba-4a08-4397-84a5-22ac125ed2f6/accounts/49544383-c19c-4c97-b8d1-5322d0faa6af,https://au-api.basiq.io/institutions/AU00000,,Supermarket and Grocery Stores,411
transaction,51a9d79e-a6f4-4b9b-8af9-936a040807a9,posted,SUSHI PLUS MANLY MANL,-33.50,49544383-c19c-4c97-b8d1-5322d0faa6af,8846.16,debit,payment,AU00000,5453f0a3-083c-43c6-9086-adfe94df9918,,,2022-12-12T00:00:00Z,,https://au-api.basiq.io/users/11103cba-4a08-4397-84a5-22ac125ed2f6/transactions/51a9d79e-a6f4-4b9b-8af9-936a040807a9,https://au-api.basiq.io/users/11103cba-4a08-4397-84a5-22ac125ed2f6/accounts/49544383-c19c-4c97-b8d1-5322d0faa6af,https://au-api.basiq.io/institutions/AU00000,,"Cafes, Restaurants and Takeaway Food Services",451
transaction,ac9510d9-7c8f-4ad8-bc5f-3eb4c41c93ee,posted,Only About Children Seaforth 1244301,-163.00,49544383-c19c-4c97-b8d1-5322d0faa6af,8879.66,debit,payment,AU00000,5453f0a3-083c-43c6-9086-adfe94df9918,,,2022-12-08T00:00:00Z,,https://au-api.basiq.io/users/11103cba-4a08-4397-84a5-22ac125ed2f6/transactions/ac9510d9-7c8f-4ad8-bc5f-3eb4c41c93ee,https://au-api.basiq.io/users/11103cba-4a08-4397-84a5-22ac125ed2f6/accounts/49544383-c19c-4c97-b8d1-5322d0faa6af,https://au-api.basiq.io/institutions/AU00000,,Other Health Care Services,859
transaction,d82b4cda-d3ec-4667-b311-8a617931b6ae,posted,TPG Internet PTY LTD Nort,-60.99,49544383-c19c-4c97-b8d1-5322d0faa6af,9042.66,debit,payment,AU00000,5453f0a3-083c-43c6-9086-adfe94df9918,,,2022-12-07T00:00:00Z,,https://au-api.basiq.io/users/11103cba-4a08-4397-84a5-22ac125ed2f6/transactions/d82b4cda-d3ec-4667-b311-8a617931b6ae,https://au-api.basiq.io/users/11103cba-4a08-4397-84a5-22ac125ed2f6/accounts/49544383-c19c-4c97-b8d1-5322d0faa6af,https://au-api.basiq.io/institutions/AU00000,,Internet Service Providers and Web Search Portals,591
transaction,afd68a17-b18b-49e4-8b8d-df813bd99584,posted,Only About Children Seaforth 1244301,-163.00,49544383-c19c-4c97-b8d1-5322d0faa6af,9103.65,debit,payment,AU00000,5453f0a3-083c-43c6-9086-adfe94df9918,,,2022-12-01T00:00:00Z,,https://au-api.basiq.io/users/11103cba-4a08-4397-84a5-22ac125ed2f6/transactions/afd68a17-b18b-49e4-8b8d-df813bd99584,https://au-api.basiq.io/users/11103cba-4a08-4397-84a5-22ac125ed2f6/accounts/49544383-c19c-4c97-b8d1-5322d0faa6af,https://au-api.basiq.io/institutions/AU00000,,Other Health Care Services,859
transaction,2be14666-1517-4977-b054-2cdfe11d7cc0,posted,TFR From Transaction to CC Acc 13,9346.00,49544383-c19c-4c97-b8d1-5322d0faa6af,9266.65,credit,transfer,AU00000,5453f0a3-083c-43c6-9086-adfe94df9918,,,2022-11-27T00:00:00Z,,https://au-api.basiq.io/users/11103cba-4a08-4397-84a5-22ac125ed2f6/transactions/2be14666-1517-4977-b054-2cdfe11d7cc0,https://au-api.basiq.io/users/11103cba-4a08-4397-84a5-22ac125ed2f6/accounts/49544383-c19c-4c97-b8d1-5322d0faa6af,https://au-api.basiq.io/institutions/AU00000,,,
transaction,75b7c9df-16b9-429f-b5e4-21a91b4ccc32,posted,Only About Children Seaforth 1244301,-163.00,49544383-c19c-4c97-b8d1-5322d0faa6af,-79.35,debit,payment,AU00000,5453f0a3-083c-43c6-9086-adfe94df9918,,,2022-11-24T00:00:00Z,,https://au-api.basiq.io/users/11103cba-4a08-4397-84a5-22ac125ed2f6/transactions/75b7c9df-16b9-429f-b5e4-21a91b4ccc32,https://au-api.basiq.io/users/11103cba-4a08-4397-84a5-22ac125ed2f6/accounts/49544383-c19c-4c97-b8d1-5322d0faa6af,https://au-api.basiq.io/institutions/AU00000,,Other Health Care Services,859
transaction,61ff61dd-ae9c-4552-844e-f568a1bf3de5,posted,Only About Children Seaforth 1244301,-163.00,49544383-c19c-4c97-b8d1-5322d0faa6af,83.65,debit,payment,AU00000,5453f0a3-083c-43c6-9086-adfe94df9918,,,2022-11-17T00:00:00Z,,https://au-api.basiq.io/users/11103cba-4a08-4397-84a5-22ac125ed2f6/transactions/61ff61dd-ae9c-4552-844e-f568a1bf3de5,https://au-api.basiq.io/users/11103cba-4a08-4397-84a5-22ac125ed2f6/accounts/49544383-c19c-4c97-b8d1-5322d0faa6af,https://au-api.basiq.io/institutions/AU00000,,Other Health Care Services,859
transaction,7e00743c-c936-4158-822b-c74a354e7eda,posted,OPTUS PREPAID MELBOURN,-40.00,49544383-c19c-4c97-b8d1-5322d0faa6af,246.65,debit,payment,AU00000,5453f0a3-083c-43c6-9086-adfe94df9918,,,2022-11-13T00:00:00Z,,https://au-api.basiq.io/users/11103cba-4a08-4397-84a5-22ac125ed2f6/transactions/7e00743c-c936-4158-822b-c74a354e7eda,https://au-api.basiq.io/users/11103cba-4a08-4397-84a5-22ac125ed2f6/accounts/49544383-c19c-4c97-b8d1-5322d0faa6af,https://au-api.basiq.io/institutions/AU00000,,Telecommunications Services,580
transaction,64d0c9ff-edb9-4958-a57a-4d292e35f691,posted,TPG Internet PTY LTD Nort,-60.99,49544383-c19c-4c97-b8d1-5322d0faa6af,286.65,debit,payment,AU00000,5453f0a3-083c-43c6-9086-adfe94df9918,,,2022-11-07T00:00:00Z,,https://au-api.basiq.io/users/11103cba-4a08-4397-84a5-22ac125ed2f6/transactions/64d0c9ff-edb9-4958-a57a-4d292e35f691,https://au-api.basiq.io/users/11103cba-4a08-4397-84a5-22ac125ed2f6/accounts/49544383-c19c-4c97-b8d1-5322d0faa6af,https://au-api.basiq.io/institutions/AU00000,,Internet Service Providers and Web Search Portals,591
transaction,2e2bcef5-51ad-4c0a-b8e0-8eacc1a5ee2b,posted,SYDNEY T1 LANDSIDE T MASC,-100.23,49544383-c19c-4c97-b8d1-5322d0faa6af,347.64,debit,payment,AU00000,5453f0a3-083c-43c6-9086-adfe94df9918,,,2022-11-01T00:00:00Z,,https://au-api.basiq.io/users/11103cba-4a08-4397-84a5-22ac125ed2f6/transactions/2e2bcef5-51ad-4c0a-b8e0-8eacc1a5ee2b,https://au-api.basiq.io/users/11103cba-4a08-4397-84a5-22ac125ed2f6/accounts/49544383-c19c-4c97-b8d1-5322d0faa6af,https://au-api.basiq.io/institutions/AU00000,,Recreational Goods Retailing,424
transaction,1eb03390-2b3c-4c5b-85ad-e198f031a5f0,posted,MISTER MINIT WARRNGH BROO,-18.90,49544383-c19c-4c97-b8d1-5322d0faa6af,447.87,debit,payment,AU00000,5453f0a3-083c-43c6-9086-adfe94df9918,,,2022-11-01T00:00:00Z,,https://au-api.basiq.io/users/11103cba-4a08-4397-84a5-22ac125ed2f6/transactions/1eb03390-2b3c-4c5b-85ad-e198f031a5f0,https://au-api.basiq.io/users/11103cba-4a08-4397-84a5-22ac125ed2f6/accounts/49544383-c19c-4c97-b8d1-5322d0faa6af,https://au-api.basiq.io/institutions/AU00000,,Other Repair and Maintenance,949
transaction,c395eddb-8150-485e-aabb-73b40258c359,posted,GIRDLERS GRIND BROO,-70.00,49544383-c19c-4c97-b8d1-5322d0faa6af,466.77,debit,payment,AU00000,5453f0a3-083c-43c6-9086-adfe94df9918,,,2022-10-31T00:00:00Z,,https://au-api.basiq.io/users/11103cba-4a08-4397-84a5-22ac125ed2f6/transactions/c395eddb-8150-485e-aabb-73b40258c359,https://au-api.basiq.io/users/11103cba-4a08-4397-84a5-22ac125ed2f6/accounts/49544383-c19c-4c97-b8d1-5322d0faa6af,https://au-api.basiq.io/institutions/AU00000,,"Cafes, Restaurants and Takeaway Food Services",451
transaction,ab7029c2-cf92-4cbb-83aa-b5d142e41e81,posted,FLIP OUT BROO,-46.00,49544383-c19c-4c97-b8d1-5322d0faa6af,536.77,debit,payment,AU00000,5453f0a3-083c-43c6-9086-adfe94df9918,,,2022-10-31T00:00:00Z,,https://au-api.basiq.io/users/11103cba-4a08-4397-84a5-22ac125ed2f6/transactions/ab7029c2-cf92-4cbb-83aa-b5d142e41e81,https://au-api.basiq.io/users/11103cba-4a08-4397-84a5-22ac125ed2f6/accounts/49544383-c19c-4c97-b8d1-5322d0faa6af,https://au-api.basiq.io/institutions/AU00000,,Amusement and Other Recreation Activities,913
transaction,96edcbc3-b355-4ab8-a8a7-75b4e59cfc71,posted,HERO SUSHI WORLD WID MASC,-45.20,49544383-c19c-4c97-b8d1-5322d0faa6af,582.77,debit,payment,AU00000,5453f0a3-083c-43c6-9086-adfe94df9918,,,2022-10-31T00:00:00Z,,https://au-api.basiq.io/users/11103cba-4a08-4397-84a5-22ac125ed2f6/transactions/96edcbc3-b355-4ab8-a8a7-75b4e59cfc71,https://au-api.basiq.io/users/11103cba-4a08-4397-84a5-22ac125ed2f6/accounts/49544383-c19c-4c97-b8d1-5322d0faa6af,https://au-api.basiq.io/institutions/AU00000,,"Cafes, Restaurants and Takeaway Food Services",451
transaction,5ff675d2-8e54-46d1-bbcb-a5cce84ca151,posted,CHOP ARTISAN BUTCHER BELR,-21.50,49544383-c19c-4c97-b8d1-5322d0faa6af,627.97,debit,payment,AU00000,5453f0a3-083c-43c6-9086-adfe94df9918,,,2022-10-31T00:00:00Z,,https://au-api.basiq.io/users/11103cba-4a08-4397-84a5-22ac125ed2f6/transactions/5ff675d2-8e54-46d1-bbcb-a5cce84ca151,https://au-api.basiq.io/users/11103cba-4a08-4397-84a5-22ac125ed2f6/accounts/49544383-c19c-4c97-b8d1-5322d0faa6af,https://au-api.basiq.io/institutions/AU00000,,Specialised Food Retailing,412
transaction,6885e164-7e61-4eb4-82d7-c0cc5062a3d2,posted,Harry Hartog Warr,-20.98,49544383-c19c-4c97-b8d1-5322d0faa6af,649.47,debit,payment,AU00000,5453f0a3-083c-43c6-9086-adfe94df9918,,,2022-10-31T00:00:00Z,,https://au-api.basiq.io/users/11103cba-4a08-4397-84a5-22ac125ed2f6/transactions/6885e164-7e61-4eb4-82d7-c0cc5062a3d2,https://au-api.basiq.io/users/11103cba-4a08-4397-84a5-22ac125ed2f6/accounts/49544383-c19c-4c97-b8d1-5322d0faa6af,https://au-api.basiq.io/institutions/AU00000,,Recreational Goods Retailing,424
transaction,627bd585-ad34-4701-b9ef-b84ceac97cf8,posted,THINK SYDNEY SYDN,-14.59,49544383-c19c-4c97-b8d1-5322d0faa6af,670.45,debit,payment,AU00000,5453f0a3-083c-43c6-9086-adfe94df9918,,,2022-10-31T00:00:00Z,,https://au-api.basiq.io/users/11103cba-4a08-4397-84a5-22ac125ed2f6/transactions/627bd585-ad34-4701-b9ef-b84ceac97cf8,https://au-api.basiq.io/users/11103cba-4a08-4397-84a5-22ac125ed2f6/accounts/49544383-c19c-4c97-b8d1-5322d0faa6af,https://au-api.basiq.io/institutions/AU00000,,Unknown,0
transaction,6b2d0eed-479f-4ef7-ba11-d2a6e977b9bc,posted,WOOLWORTHS 1282 BROO,-8.00,49544383-c19c-4c97-b8d1-5322d0faa6af,685.04,debit,payment,AU00000,5453f0a3-083c-43c6-9086-adfe94df9918,,,2022-10-31T00:00:00Z,,https://au-api.basiq.io/users/11103cba-4a08-4397-84a5-22ac125ed2f6/transactions/6b2d0eed-479f-4ef7-ba11-d2a6e977b9bc,https://au-api.basiq.io/users/11103cba-4a08-4397-84a5-22ac125ed2f6/accounts/49544383-c19c-4c97-b8d1-5322d0faa6af,https://au-api.basiq.io/institutions/AU00000,,Supermarket and Grocery Stores,411
transaction,b529a182-f9b7-4623-bb71-c3c23b40b3f7,posted,FIKA SWEDISH KITCHEN MANL,-46.00,49544383-c19c-4c97-b8d1-5322d0faa6af,693.04,debit,payment,AU00000,5453f0a3-083c-43c6-9086-adfe94df9918,,,2022-10-30T00:00:00Z,,https://au-api.basiq.io/users/11103cba-4a08-4397-84a5-22ac125ed2f6/transactions/b529a182-f9b7-4623-bb71-c3c23b40b3f7,https://au-api.basiq.io/users/11103cba-4a08-4397-84a5-22ac125ed2f6/accounts/49544383-c19c-4c97-b8d1-5322d0faa6af,https://au-api.basiq.io/institutions/AU00000,,"Cafes, Restaurants and Takeaway Food Services",451
transaction,5d432a38-60ba-42f2-8a60-c626571206e2,posted,MANLY SURF SHACK MANL,-40.95,49544383-c19c-4c97-b8d1-5322d0faa6af,739.04,debit,payment,AU00000,5453f0a3-083c-43c6-9086-adfe94df9918,,,2022-10-30T00:00:00Z,,https://au-api.basiq.io/users/11103cba-4a08-4397-84a5-22ac125ed2f6/transactions/5d432a38-60ba-42f2-8a60-c626571206e2,https://au-api.basiq.io/users/11103cba-4a08-4397-84a5-22ac125ed2f6/accounts/49544383-c19c-4c97-b8d1-5322d0faa6af,https://au-api.basiq.io/institutions/AU00000,,Recreational Goods Retailing,424
transaction,8f85c726-945d-437e-b3f9-bc95df6a50f4,posted,CAVALLINO TRADING TERREY HILLS AU,-121.00,49544383-c19c-4c97-b8d1-5322d0faa6af,779.99,debit,payment,AU00000,5453f0a3-083c-43c6-9086-adfe94df9918,,,2022-10-28T00:00:00Z,,https://au-api.basiq.io/users/11103cba-4a08-4397-84a5-22ac125ed2f6/transactions/8f85c726-945d-437e-b3f9-bc95df6a50f4,https://au-api.basiq.io/users/11103cba-4a08-4397-84a5-22ac125ed2f6/accounts/49544383-c19c-4c97-b8d1-5322d0faa6af,https://au-api.basiq.io/institutions/AU00000,,"Cafes, Restaurants and Takeaway Food Services",451
transaction,37dbd48e-6652-4118-b404-dfe0f16a0e1d,posted,Venture Health Manly Manl,-19.40,49544383-c19c-4c97-b8d1-5322d0faa6af,900.99,debit,payment,AU00000,5453f0a3-083c-43c6-9086-adfe94df9918,,,2022-10-27T00:00:00Z,,https://au-api.basiq.io/users/11103cba-4a08-4397-84a5-22ac125ed2f6/transactions/37dbd48e-6652-4118-b404-dfe0f16a0e1d,https://au-api.basiq.io/users/11103cba-4a08-4397-84a5-22ac125ed2f6/accounts/49544383-c19c-4c97-b8d1-5322d0faa6af,https://au-api.basiq.io/institutions/AU00000,,Specialised Food Retailing,412
transaction,54009fa8-8d8f-4b06-b04a-70a77f6fe17b,posted,FORESTWAY PHARMACY FREN,-15.98,49544383-c19c-4c97-b8d1-5322d0faa6af,920.39,debit,payment,AU00000,5453f0a3-083c-43c6-9086-adfe94df9918,,,2022-10-27T00:00:00Z,,https://au-api.basiq.io/users/11103cba-4a08-4397-84a5-22ac125ed2f6/transactions/54009fa8-8d8f-4b06-b04a-70a77f6fe17b,https://au-api.basiq.io/users/11103cba-4a08-4397-84a5-22ac125ed2f6/accounts/49544383-c19c-4c97-b8d1-5322d0faa6af,https://au-api.basiq.io/institutions/AU00000,,Pharmaceutical and Other Store-Based Retailing,427
transaction,3cad6add-e5d2-41f9-aa0b-d1e8d4057ea1,posted,SCANCCELLI CAFE BELR,-14.50,49544383-c19c-4c97-b8d1-5322d0faa6af,936.37,debit,payment,AU00000,5453f0a3-083c-43c6-9086-adfe94df9918,,,2022-10-27T00:00:00Z,,https://au-api.basiq.io/users/11103cba-4a08-4397-84a5-22ac125ed2f6/transactions/3cad6add-e5d2-41f9-aa0b-d1e8d4057ea1,https://au-api.basiq.io/users/11103cba-4a08-4397-84a5-22ac125ed2f6/accounts/49544383-c19c-4c97-b8d1-5322d0faa6af,https://au-api.basiq.io/institutions/AU00000,,"Cafes, Restaurants and Takeaway Food Services",451
transaction,12716657-535c-4193-b525-a6da4ef8381e,posted,COLES 0869 MANL,-7.00,49544383-c19c-4c97-b8d1-5322d0faa6af,950.87,debit,payment,AU00000,5453f0a3-083c-43c6-9086-adfe94df9918,,,2022-10-27T00:00:00Z,,https://au-api.basiq.io/users/11103cba-4a08-4397-84a5-22ac125ed2f6/transactions/12716657-535c-4193-b525-a6da4ef8381e,https://au-api.basiq.io/users/11103cba-4a08-4397-84a5-22ac125ed2f6/accounts/49544383-c19c-4c97-b8d1-5322d0faa6af,https://au-api.basiq.io/institutions/AU00000,,Supermarket and Grocery Stores,411
transaction,4931042f-3f89-410e-85c0-38b20ad2a1a2,posted,TFR From Transaction to CC Acc 13,9338.50,49544383-c19c-4c97-b8d1-5322d0faa6af,957.87,credit,transfer,AU00000,5453f0a3-083c-43c6-9086-adfe94df9918,,,2022-10-27T00:00:00Z,,https://au-api.basiq.io/users/11103cba-4a08-4397-84a5-22ac125ed2f6/transactions/4931042f-3f89-410e-85c0-38b20ad2a1a2,https://au-api.basiq.io/users/11103cba-4a08-4397-84a5-22ac125ed2f6/accounts/49544383-c19c-4c97-b8d1-5322d0faa6af,https://au-api.basiq.io/institutions/AU00000,,,
transaction,b8b96bfe-6a84-498d-8c1d-958fff0b946a,posted,Only About Children Seaforth 1244301,-157.00,49544383-c19c-4c97-b8d1-5322d0faa6af,-8380.63,debit,payment,AU00000,5453f0a3-083c-43c6-9086-adfe94df9918,,,2022-10-27T00:00:00Z,,https://au-api.basiq.io/users/11103cba-4a08-4397-84a5-22ac125ed2f6/transactions/b8b96bfe-6a84-498d-8c1d-958fff0b946a,https://au-api.basiq.io/users/11103cba-4a08-4397-84a5-22ac125ed2f6/accounts/49544383-c19c-4c97-b8d1-5322d0faa6af,https://au-api.basiq.io/institutions/AU00000,,Other Health Care Services,859
transaction,18b9c383-c3c4-448b-b480-d79592f7d395,posted,WOOLWORTHS 1262 BELR,-83.49,49544383-c19c-4c97-b8d1-5322d0faa6af,-8223.63,debit,payment,AU00000,5453f0a3-083c-43c6-9086-adfe94df9918,,,2022-10-27T00:00:00Z,,https://au-api.basiq.io/users/11103cba-4a08-4397-84a5-22ac125ed2f6/transactions/18b9c383-c3c4-448b-b480-d79592f7d395,https://au-api.basiq.io/users/11103cba-4a08-4397-84a5-22ac125ed2f6/accounts/49544383-c19c-4c97-b8d1-5322d0faa6af,https://au-api.basiq.io/institutions/AU00000,,Supermarket and Grocery Stores,411
transaction,98220497-790c-43e7-babd-af509ad99e23,posted,DISCOUNT TOY CO BELR,-44.83,49544383-c19c-4c97-b8d1-5322d0faa6af,-8140.14,debit,payment,AU00000,5453f0a3-083c-43c6-9086-adfe94df9918,,,2022-10-26T00:00:00Z,,https://au-api.basiq.io/users/11103cba-4a08-4397-84a5-22ac125ed2f6/transactions/98220497-790c-43e7-babd-af509ad99e23,https://au-api.basiq.io/users/11103cba-4a08-4397-84a5-22ac125ed2f6/accounts/49544383-c19c-4c97-b8d1-5322d0faa6af,https://au-api.basiq.io/institutions/AU00000,,Recreational Goods Retailing,424
transaction,a9afa085-affc-43fe-958d-6ea3844b3556,posted,FOREST THERAPEUTIC MAS FREN,-36.00,49544383-c19c-4c97-b8d1-5322d0faa6af,-8095.31,debit,payment,AU00000,5453f0a3-083c-43c6-9086-adfe94df9918,,,2022-10-26T00:00:00Z,,https://au-api.basiq.io/users/11103cba-4a08-4397-84a5-22ac125ed2f6/transactions/a9afa085-affc-43fe-958d-6ea3844b3556,https://au-api.basiq.io/users/11103cba-4a08-4397-84a5-22ac125ed2f6/accounts/49544383-c19c-4c97-b8d1-5322d0faa6af,https://au-api.basiq.io/institutions/AU00000,,Other Health Care Services,859
transaction,338a6022-22a0-42b1-abe7-d0da7893bc7e,posted,COSTI SEAFOOD CO PL BELR,-24.85,49544383-c19c-4c97-b8d1-5322d0faa6af,-8059.31,debit,payment,AU00000,5453f0a3-083c-43c6-9086-adfe94df9918,,,2022-10-26T00:00:00Z,,https://au-api.basiq.io/users/11103cba-4a08-4397-84a5-22ac125ed2f6/transactions/338a6022-22a0-42b1-abe7-d0da7893bc7e,https://au-api.basiq.io/users/11103cba-4a08-4397-84a5-22ac125ed2f6/accounts/49544383-c19c-4c97-b8d1-5322d0faa6af,https://au-api.basiq.io/institutions/AU00000,,Specialised Food Retailing,412
transaction,39740353-9998-4abe-bba8-968a59a0cafc,posted,WOOLWORTHS 1063 FR FREN,-21.95,49544383-c19c-4c97-b8d1-5322d0faa6af,-8034.46,debit,payment,AU00000,5453f0a3-083c-43c6-9086-adfe94df9918,,,2022-10-26T00:00:00Z,,https://au-api.basiq.io/users/11103cba-4a08-4397-84a5-22ac125ed2f6/transactions/39740353-9998-4abe-bba8-968a59a0cafc,https://au-api.basiq.io/users/11103cba-4a08-4397-84a5-22ac125ed2f6/accounts/49544383-c19c-4c97-b8d1-5322d0faa6af,https://au-api.basiq.io/institutions/AU00000,,Supermarket and Grocery Stores,411
transaction,b58f7cef-42cd-48ee-ac65-b3b01ce91ed2,posted,MEAMM PTY LTD BELR,-21.50,49544383-c19c-4c97-b8d1-5322d0faa6af,-8012.51,debit,payment,AU00000,5453f0a3-083c-43c6-9086-adfe94df9918,,,2022-10-26T00:00:00Z,,https://au-api.basiq.io/users/11103cba-4a08-4397-84a5-22ac125ed2f6/transactions/b58f7cef-42cd-48ee-ac65-b3b01ce91ed2,https://au-api.basiq.io/users/11103cba-4a08-4397-84a5-22ac125ed2f6/accounts/49544383-c19c-4c97-b8d1-5322d0faa6af,https://au-api.basiq.io/institutions/AU00000,,Unknown,0
transaction,b3492e79-9cd7-442a-978f-927a2f4b804c,posted,MEDIC ALERT,-20.38,49544383-c19c-4c97-b8d1-5322d0faa6af,-7991.01,debit,payment,AU00000,5453f0a3-083c-43c6-9086-adfe94df9918,,,2022-10-26T00:00:00Z,,https://au-api.basiq.io/users/11103cba-4a08-4397-84a5-22ac125ed2f6/transactions/b3492e79-9cd7-442a-978f-927a2f4b804c,https://au-api.basiq.io/users/11103cba-4a08-4397-84a5-22ac125ed2f6/accounts/49544383-c19c-4c97-b8d1-5322d0faa6af,https://au-api.basiq.io/institutions/AU00000,,Other Health Care Services,859
transaction,bece9298-3d3d-4f05-ad4f-4b2a7221e0b0,posted,AGL RETAIL ENERGY LTD (GAS),-103.83,49544383-c19c-4c97-b8d1-5322d0faa6af,-7970.63,debit,payment,AU00000,5453f0a3-083c-43c6-9086-adfe94df9918,,,2022-10-26T00:00:00Z,,https://au-api.basiq.io/users/11103cba-4a08-4397-84a5-22ac125ed2f6/transactions/bece9298-3d3d-4f05-ad4f-4b2a7221e0b0,https://au-api.basiq.io/users/11103cba-4a08-4397-84a5-22ac125ed2f6/accounts/49544383-c19c-4c97-b8d1-5322d0faa6af,https://au-api.basiq.io/institutions/AU00000,,Electricity Distribution,263
transaction,ba5127fc-6c5c-4c43-a576-7e914bfa3dd3,posted,AGL SALES PTY LIMITED (ELEC  AND GAS),-35.75,49544383-c19c-4c97-b8d1-5322d0faa6af,-7866.80,debit,payment,AU00000,5453f0a3-083c-43c6-9086-adfe94df9918,,,2022-10-26T00:00:00Z,,https://au-api.basiq.io/users/11103cba-4a08-4397-84a5-22ac125ed2f6/transactions/ba5127fc-6c5c-4c43-a576-7e914bfa3dd3,https://au-api.basiq.io/users/11103cba-4a08-4397-84a5-22ac125ed2f6/accounts/49544383-c19c-4c97-b8d1-5322d0faa6af,https://au-api.basiq.io/institutions/AU00000,,Electricity Distribution,263
transaction,050b6176-a678-4ee1-964a-f8297dec3ad2,posted,COLLAROY AIRPORT TRA COLL,-97.00,49544383-c19c-4c97-b8d1-5322d0faa6af,-7831.05,debit,payment,AU00000,5453f0a3-083c-43c6-9086-adfe94df9918,,,2022-10-25T00:00:00Z,,https://au-api.basiq.io/users/11103cba-4a08-4397-84a5-22ac125ed2f6/transactions/050b6176-a678-4ee1-964a-f8297dec3ad2,https://au-api.basiq.io/users/11103cba-4a08-4397-84a5-22ac125ed2f6/accounts/49544383-c19c-4c97-b8d1-5322d0faa6af,https://au-api.basiq.io/institutions/AU00000,,Airport Operations and Other Air Transport Support Services,522
transaction,a93739d6-2dcd-4626-8bb7-22b74455ccb8,posted,FRTLLI PLITO PROD PL CROM,-66.00,49544383-c19c-4c97-b8d1-5322d0faa6af,-7734.05,debit,payment,AU00000,5453f0a3-083c-43c6-9086-adfe94df9918,,,2022-10-25T00:00:00Z,,https://au-api.basiq.io/users/11103cba-4a08-4397-84a5-22ac125ed2f6/transactions/a93739d6-2dcd-4626-8bb7-22b74455ccb8,https://au-api.basiq.io/users/11103cba-4a08-4397-84a5-22ac125ed2f6/accounts/49544383-c19c-4c97-b8d1-5322d0faa6af,https://au-api.basiq.io/institutions/AU00000,,Specialised Food Retailing,412
transaction,863d8bef-5ccb-4dd7-a134-986fa76af519,posted,CHOP ARTISAN BUTCHER BELR,-19.70,49544383-c19c-4c97-b8d1-5322d0faa6af,-7668.05,debit,payment,AU00000,5453f0a3-083c-43c6-9086-adfe94df9918,,,2022-10-25T00:00:00Z,,https://au-api.basiq.io/users/11103cba-4a08-4397-84a5-22ac125ed2f6/transactions/863d8bef-5ccb-4dd7-a134-986fa76af519,https://au-api.basiq.io/users/11103cba-4a08-4397-84a5-22ac125ed2f6/accounts/49544383-c19c-4c97-b8d1-5322d0faa6af,https://au-api.basiq.io/institutions/AU00000,,Specialised Food Retailing,412
transaction,c104428a-0370-41ae-b164-749b96d894f4,posted,TASTE BAGUETTE GLNRS BELR,-16.40,49544383-c19c-4c97-b8d1-5322d0faa6af,-7648.35,debit,payment,AU00000,5453f0a3-083c-43c6-9086-adfe94df9918,,,2022-10-25T00:00:00Z,,https://au-api.basiq.io/users/11103cba-4a08-4397-84a5-22ac125ed2f6/transactions/c104428a-0370-41ae-b164-749b96d894f4,https://au-api.basiq.io/users/11103cba-4a08-4397-84a5-22ac125ed2f6/accounts/49544383-c19c-4c97-b8d1-5322d0faa6af,https://au-api.basiq.io/institutions/AU00000,,"Cafes, Restaurants and Takeaway Food Services",451
transaction,93c8094e-1bf9-4409-b52c-6e059ad864af,posted,TASTE BAGUETTE GLNRS BELR,-10.30,49544383-c19c-4c97-b8d1-5322d0faa6af,-7631.95,debit,payment,AU00000,5453f0a3-083c-43c6-9086-adfe94df9918,,,2022-10-25T00:00:00Z,,https://au-api.basiq.io/users/11103cba-4a08-4397-84a5-22ac125ed2f6/transactions/93c8094e-1bf9-4409-b52c-6e059ad864af,https://au-api.basiq.io/users/11103cba-4a08-4397-84a5-22ac125ed2f6/accounts/49544383-c19c-4c97-b8d1-5322d0faa6af,https://au-api.basiq.io/institutions/AU00000,,"Cafes, Restaurants and Takeaway Food Services",451
transaction,7d1b1117-b13d-4706-a31e-0e7f57aa7a90,posted,TASTE BAGUETTE GLNRS BELR,-9.20,49544383-c19c-4c97-b8d1-5322d0faa6af,-7621.65,debit,payment,AU00000,5453f0a3-083c-43c6-9086-adfe94df9918,,,2022-10-25T00:00:00Z,,https://au-api.basiq.io/users/11103cba-4a08-4397-84a5-22ac125ed2f6/transactions/7d1b1117-b13d-4706-a31e-0e7f57aa7a90,https://au-api.basiq.io/users/11103cba-4a08-4397-84a5-22ac125ed2f6/accounts/49544383-c19c-4c97-b8d1-5322d0faa6af,https://au-api.basiq.io/institutions/AU00000,,"Cafes, Restaurants and Takeaway Food Services",451
transaction,cfeccf15-89b0-4199-b479-b2f7a40985ae,posted,ANN TERESA MCCARTHY MANL,-136.00,49544383-c19c-4c97-b8d1-5322d0faa6af,-7612.45,debit,payment,AU00000,5453f0a3-083c-43c6-9086-adfe94df9918,,,2022-10-24T00:00:00Z,,https://au-api.basiq.io/users/11103cba-4a08-4397-84a5-22ac125ed2f6/transactions/cfeccf15-89b0-4199-b479-b2f7a40985ae,https://au-api.basiq.io/users/11103cba-4a08-4397-84a5-22ac125ed2f6/accounts/49544383-c19c-4c97-b8d1-5322d0faa6af,https://au-api.basiq.io/institutions/AU00000,,Allied Health Services,853
transaction,e581606c-cc2e-4400-b7d6-264d2be489b1,posted,NORTHERN BEACHES APP FAIR,-111.00,49544383-c19c-4c97-b8d1-5322d0faa6af,-7476.45,debit,payment,AU00000,5453f0a3-083c-43c6-9086-adfe94df9918,,,2022-10-24T00:00:00Z,,https://au-api.basiq.io/users/11103cba-4a08-4397-84a5-22ac125ed2f6/transactions/e581606c-cc2e-4400-b7d6-264d2be489b1,https://au-api.basiq.io/users/11103cba-4a08-4397-84a5-22ac125ed2f6/accounts/49544383-c19c-4c97-b8d1-5322d0faa6af,https://au-api.basiq.io/institutions/AU00000,,Machinery and Equipment Repair and Maintenance,942
transaction,0fac6ffb-3db9-4524-af41-066fe97db6a0,posted,STELLABLUBELROSE BELR,-69.00,49544383-c19c-4c97-b8d1-5322d0faa6af,-7365.45,debit,payment,AU00000,5453f0a3-083c-43c6-9086-adfe94df9918,,,2022-10-24T00:00:00Z,,https://au-api.basiq.io/users/11103cba-4a08-4397-84a5-22ac125ed2f6/transactions/0fac6ffb-3db9-4524-af41-066fe97db6a0,https://au-api.basiq.io/users/11103cba-4a08-4397-84a5-22ac125ed2f6/accounts/49544383-c19c-4c97-b8d1-5322d0faa6af,https://au-api.basiq.io/institutions/AU00000,,"Cafes, Restaurants and Takeaway Food Services",451
transaction,9230eb2b-b7ae-48ef-b9de-7aa9726ebc0b,posted,7-ELEVEN 2253 NEWP,-51.10,49544383-c19c-4c97-b8d1-5322d0faa6af,-7296.45,debit,payment,AU00000,5453f0a3-083c-43c6-9086-adfe94df9918,,,2022-10-24T00:00:00Z,,https://au-api.basiq.io/users/11103cba-4a08-4397-84a5-22ac125ed2f6/transactions/9230eb2b-b7ae-48ef-b9de-7aa9726ebc0b,https://au-api.basiq.io/users/11103cba-4a08-4397-84a5-22ac125ed2f6/accounts/49544383-c19c-4c97-b8d1-5322d0faa6af,https://au-api.basiq.io/institutions/AU00000,,Fuel Retailing,400
transaction,cdee5e8e-2a55-4ea0-bd48-d86659fcb3bb,posted,LE PARISIEN KILL,-43.50,49544383-c19c-4c97-b8d1-5322d0faa6af,-7245.35,debit,payment,AU00000,5453f0a3-083c-43c6-9086-adfe94df9918,,,2022-10-24T00:00:00Z,,https://au-api.basiq.io/users/11103cba-4a08-4397-84a5-22ac125ed2f6/transactions/cdee5e8e-2a55-4ea0-bd48-d86659fcb3bb,https://au-api.basiq.io/users/11103cba-4a08-4397-84a5-22ac125ed2f6/accounts/49544383-c19c-4c97-b8d1-5322d0faa6af,https://au-api.basiq.io/institutions/AU00000,,"Cafes, Restaurants and Takeaway Food Services",451
transaction,fd85df53-563f-4bc8-9a3a-44d144019dc6,posted,KENNARDS HIRE NSW SEVE,-43.00,49544383-c19c-4c97-b8d1-5322d0faa6af,-7201.85,debit,payment,AU00000,5453f0a3-083c-43c6-9086-adfe94df9918,,,2022-10-24T00:00:00Z,,https://au-api.basiq.io/users/11103cba-4a08-4397-84a5-22ac125ed2f6/transactions/fd85df53-563f-4bc8-9a3a-44d144019dc6,https://au-api.basiq.io/users/11103cba-4a08-4397-84a5-22ac125ed2f6/accounts/49544383-c19c-4c97-b8d1-5322d0faa6af,https://au-api.basiq.io/institutions/AU00000,,Other Goods and Equipment Rental and Hiring,663
transaction,5579e4d8-7fed-4944-9701-01ca72e9e688,posted,GUZMAN Y GOMEZ MANLY MANL,-16.00,49544383-c19c-4c97-b8d1-5322d0faa6af,-7158.85,debit,payment,AU00000,5453f0a3-083c-43c6-9086-adfe94df9918,,,2022-10-24T00:00:00Z,,https://au-api.basiq.io/users/11103cba-4a08-4397-84a5-22ac125ed2f6/transactions/5579e4d8-7fed-4944-9701-01ca72e9e688,https://au-api.basiq.io/users/11103cba-4a08-4397-84a5-22ac125ed2f6/accounts/49544383-c19c-4c97-b8d1-5322d0faa6af,https://au-api.basiq.io/institutions/AU00000,,"Cafes, Restaurants and Takeaway Food Services",451
transaction,2cbb3383-956e-43b1-913d-985aea8a5a59,posted,WOOLWORTHS 1063 FR FREN,-15.25,49544383-c19c-4c97-b8d1-5322d0faa6af,-7142.85,debit,payment,AU00000,5453f0a3-083c-43c6-9086-adfe94df9918,,,2022-10-24T00:00:00Z,,https://au-api.basiq.io/users/11103cba-4a08-4397-84a5-22ac125ed2f6/transactions/2cbb3383-956e-43b1-913d-985aea8a5a59,https://au-api.basiq.io/users/11103cba-4a08-4397-84a5-22ac125ed2f6/accounts/49544383-c19c-4c97-b8d1-5322d0faa6af,https://au-api.basiq.io/institutions/AU00000,,Supermarket and Grocery Stores,411
transaction,fff3fd0a-0bc6-4eb2-916b-22dc6ac469b3,posted,BLOND CATERING DARL,-11.00,49544383-c19c-4c97-b8d1-5322d0faa6af,-7127.60,debit,payment,AU00000,5453f0a3-083c-43c6-9086-adfe94df9918,,,2022-10-24T00:00:00Z,,https://au-api.basiq.io/users/11103cba-4a08-4397-84a5-22ac125ed2f6/transactions/fff3fd0a-0bc6-4eb2-916b-22dc6ac469b3,https://au-api.basiq.io/users/11103cba-4a08-4397-84a5-22ac125ed2f6/accounts/49544383-c19c-4c97-b8d1-5322d0faa6af,https://au-api.basiq.io/institutions/AU00000,,"Cafes, Restaurants and Takeaway Food Services",451
transaction,38778797-cc18-411d-9cd8-954727048a4f,posted,KOKO BLACK AUSTRALIA SYDN,-9.50,49544383-c19c-4c97-b8d1-5322d0faa6af,-7116.60,debit,payment,AU00000,5453f0a3-083c-43c6-9086-adfe94df9918,,,2022-10-24T00:00:00Z,,https://au-api.basiq.io/users/11103cba-4a08-4397-84a5-22ac125ed2f6/transactions/38778797-cc18-411d-9cd8-954727048a4f,https://au-api.basiq.io/users/11103cba-4a08-4397-84a5-22ac125ed2f6/accounts/49544383-c19c-4c97-b8d1-5322d0faa6af,https://au-api.basiq.io/institutions/AU00000,,"Cafes, Restaurants and Takeaway Food Services",451
transaction,034f47b9-3aaa-45bb-8187-e70c2c585718,posted,Cash Wdr  eetBelrose      02AU,-401.00,49544383-c19c-4c97-b8d1-5322d0faa6af,-7107.10,debit,cash-withdrawal,AU00000,5453f0a3-083c-43c6-9086-adfe94df9918,,,2022-10-24T00:00:00Z,,https://au-api.basiq.io/users/11103cba-4a08-4397-84a5-22ac125ed2f6/transactions/034f47b9-3aaa-45bb-8187-e70c2c585718,https://au-api.basiq.io/users/11103cba-4a08-4397-84a5-22ac125ed2f6/accounts/49544383-c19c-4c97-b8d1-5322d0faa6af,https://au-api.basiq.io/institutions/AU00000,,,
transaction,3811c906-0daa-40f6-9b9c-a4cd4517d692,posted,THE WATER SHOP AUS P CAMM,-97.00,49544383-c19c-4c97-b8d1-5322d0faa6af,-6706.10,debit,payment,AU00000,5453f0a3-083c-43c6-9086-adfe94df9918,,,2022-10-23T00:00:00Z,,https://au-api.basiq.io/users/11103cba-4a08-4397-84a5-22ac125ed2f6/transactions/3811c906-0daa-40f6-9b9c-a4cd4517d692,https://au-api.basiq.io/users/11103cba-4a08-4397-84a5-22ac125ed2f6/accounts/49544383-c19c-4c97-b8d1-5322d0faa6af,https://au-api.basiq.io/institutions/AU00000,,Pharmaceutical and Other Store-Based Retailing,427
transaction,ef90902e-2fcf-4be2-92be-4873a1242b63,posted,KENNARDS HIRE NSW SEVE,-92.00,49544383-c19c-4c97-b8d1-5322d0faa6af,-6609.10,debit,payment,AU00000,5453f0a3-083c-43c6-9086-adfe94df9918,,,2022-10-23T00:00:00Z,,https://au-api.basiq.io/users/11103cba-4a08-4397-84a5-22ac125ed2f6/transactions/ef90902e-2fcf-4be2-92be-4873a1242b63,https://au-api.basiq.io/users/11103cba-4a08-4397-84a5-22ac125ed2f6/accounts/49544383-c19c-4c97-b8d1-5322d0faa6af,https://au-api.basiq.io/institutions/AU00000,,Other Goods and Equipment Rental and Hiring,663
transaction,15038a79-7522-408d-9924-660cfc214751,posted,MOMOKKO BELR,-68.00,49544383-c19c-4c97-b8d1-5322d0faa6af,-6517.10,debit,payment,AU00000,5453f0a3-083c-43c6-9086-adfe94df9918,,,2022-10-23T00:00:00Z,,https://au-api.basiq.io/users/11103cba-4a08-4397-84a5-22ac125ed2f6/transactions/15038a79-7522-408d-9924-660cfc214751,https://au-api.basiq.io/users/11103cba-4a08-4397-84a5-22ac125ed2f6/accounts/49544383-c19c-4c97-b8d1-5322d0faa6af,https://au-api.basiq.io/institutions/AU00000,,"Cafes, Restaurants and Takeaway Food Services",451
transaction,e2363d28-178d-47d2-8527-7dea9383e4eb,posted,VICTOIRE PTY LTD CAMM,-49.50,49544383-c19c-4c97-b8d1-5322d0faa6af,-6449.10,debit,payment,AU00000,5453f0a3-083c-43c6-9086-adfe94df9918,,,2022-10-23T00:00:00Z,,https://au-api.basiq.io/users/11103cba-4a08-4397-84a5-22ac125ed2f6/transactions/e2363d28-178d-47d2-8527-7dea9383e4eb,https://au-api.basiq.io/users/11103cba-4a08-4397-84a5-22ac125ed2f6/accounts/49544383-c19c-4c97-b8d1-5322d0faa6af,https://au-api.basiq.io/institutions/AU00000,,Bakery Product Manufacturing,117
transaction,be654208-be3b-4d38-80f2-238b461671f2,posted,Sydney Living Museums Sydn,-21.00,49544383-c19c-4c97-b8d1-5322d0faa6af,-6399.60,debit,payment,AU00000,5453f0a3-083c-43c6-9086-adfe94df9918,,,2022-10-23T00:00:00Z,,https://au-api.basiq.io/users/11103cba-4a08-4397-84a5-22ac125ed2f6/transactions/be654208-be3b-4d38-80f2-238b461671f2,https://au-api.basiq.io/users/11103cba-4a08-4397-84a5-22ac125ed2f6/accounts/49544383-c19c-4c97-b8d1-5322d0faa6af,https://au-api.basiq.io/institutions/AU00000,,Amusement and Other Recreation Activities,913
transaction,1052e64d-7cac-469c-b5db-f501938ab0e4,posted,Impulse Chiropractic Nort,-86.00,49544383-c19c-4c97-b8d1-5322d0faa6af,-6378.60,debit,payment,AU00000,5453f0a3-083c-43c6-9086-adfe94df9918,,,2022-10-20T00:00:00Z,,https://au-api.basiq.io/users/11103cba-4a08-4397-84a5-22ac125ed2f6/transactions/1052e64d-7cac-469c-b5db-f501938ab0e4,https://au-api.basiq.io/users/11103cba-4a08-4397-84a5-22ac125ed2f6/accounts/49544383-c19c-4c97-b8d1-5322d0faa6af,https://au-api.basiq.io/institutions/AU00000,,Allied Health Services,853
transaction,bf4ada4c-9e05-4b4b-a615-9692f1735b3d,posted,WOOLWORTHS 1262 BELR,-18.45,49544383-c19c-4c97-b8d1-5322d0faa6af,-6292.60,debit,payment,AU00000,5453f0a3-083c-43c6-9086-adfe94df9918,,,2022-10-20T00:00:00Z,,https://au-api.basiq.io/users/11103cba-4a08-4397-84a5-22ac125ed2f6/transactions/bf4ada4c-9e05-4b4b-a615-9692f1735b3d,https://au-api.basiq.io/users/11103cba-4a08-4397-84a5-22ac125ed2f6/accounts/49544383-c19c-4c97-b8d1-5322d0faa6af,https://au-api.basiq.io/institutions/AU00000,,Supermarket and Grocery Stores,411
transaction,076889a1-b8c3-4cea-bffa-e4c5fb38a742,posted,WOOLWORTHS 1063 FR FREN,-13.00,49544383-c19c-4c97-b8d1-5322d0faa6af,-6274.15,debit,payment,AU00000,5453f0a3-083c-43c6-9086-adfe94df9918,,,2022-10-20T00:00:00Z,,https://au-api.basiq.io/users/11103cba-4a08-4397-84a5-22ac125ed2f6/transactions/076889a1-b8c3-4cea-bffa-e4c5fb38a742,https://au-api.basiq.io/users/11103cba-4a08-4397-84a5-22ac125ed2f6/accounts/49544383-c19c-4c97-b8d1-5322d0faa6af,https://au-api.basiq.io/institutions/AU00000,,Supermarket and Grocery Stores,411
transaction,ec40bfb6-5f36-40d3-8a0b-ce887764dfe9,posted,Only About Children Seaforth 1244301,-157.00,49544383-c19c-4c97-b8d1-5322d0faa6af,-6261.15,debit,payment,AU00000,5453f0a3-083c-43c6-9086-adfe94df9918,,,2022-10-20T00:00:00Z,,https://au-api.basiq.io/users/11103cba-4a08-4397-84a5-22ac125ed2f6/transactions/ec40bfb6-5f36-40d3-8a0b-ce887764dfe9,https://au-api.basiq.io/users/11103cba-4a08-4397-84a5-22ac125ed2f6/accounts/49544383-c19c-4c97-b8d1-5322d0faa6af,https://au-api.basiq.io/institutions/AU00000,,Other Health Care Services,859
transaction,78dd210b-2d74-45a5-a7d6-18cb576ca5ec,posted,HEADYS PTY LTD BROO,-30.57,49544383-c19c-4c97-b8d1-5322d0faa6af,-6104.15,debit,payment,AU00000,5453f0a3-083c-43c6-9086-adfe94df9918,,,2022-10-19T00:00:00Z,,https://au-api.basiq.io/users/11103cba-4a08-4397-84a5-22ac125ed2f6/transactions/78dd210b-2d74-45a5-a7d6-18cb576ca5ec,https://au-api.basiq.io/users/11103cba-4a08-4397-84a5-22ac125ed2f6/accounts/49544383-c19c-4c97-b8d1-5322d0faa6af,https://au-api.basiq.io/institutions/AU00000,,Specialised Food Retailing,412
transaction,ad9d84ed-af61-4203-8554-181d257e01b2,posted,FORESTWAY PHARMACY FREN,-27.36,49544383-c19c-4c97-b8d1-5322d0faa6af,-6073.58,debit,payment,AU00000,5453f0a3-083c-43c6-9086-adfe94df9918,,,2022-10-19T00:00:00Z,,https://au-api.basiq.io/users/11103cba-4a08-4397-84a5-22ac125ed2f6/transactions/ad9d84ed-af61-4203-8554-181d257e01b2,https://au-api.basiq.io/users/11103cba-4a08-4397-84a5-22ac125ed2f6/accounts/49544383-c19c-4c97-b8d1-5322d0faa6af,https://au-api.basiq.io/institutions/AU00000,,Pharmaceutical and Other Store-Based Retailing,427
transaction,8758fe21-7249-4f08-a18c-a956b8904fe0,posted,IMBUE CAFE DAVI,-26.70,49544383-c19c-4c97-b8d1-5322d0faa6af,-6046.22,debit,payment,AU00000,5453f0a3-083c-43c6-9086-adfe94df9918,,,2022-10-19T00:00:00Z,,https://au-api.basiq.io/users/11103cba-4a08-4397-84a5-22ac125ed2f6/transactions/8758fe21-7249-4f08-a18c-a956b8904fe0,https://au-api.basiq.io/users/11103cba-4a08-4397-84a5-22ac125ed2f6/accounts/49544383-c19c-4c97-b8d1-5322d0faa6af,https://au-api.basiq.io/institutions/AU00000,,"Cafes, Restaurants and Takeaway Food Services",451
transaction,9cfad4e4-18e2-4db7-aa94-5fb56556b0f9,posted,IMBUE CAFE DAVI,-17.70,49544383-c19c-4c97-b8d1-5322d0faa6af,-6019.52,debit,payment,AU00000,5453f0a3-083c-43c6-9086-adfe94df9918,,,2022-10-19T00:00:00Z,,https://au-api.basiq.io/users/11103cba-4a08-4397-84a5-22ac125ed2f6/transactions/9cfad4e4-18e2-4db7-aa94-5fb56556b0f9,https://au-api.basiq.io/users/11103cba-4a08-4397-84a5-22ac125ed2f6/accounts/49544383-c19c-4c97-b8d1-5322d0faa6af,https://au-api.basiq.io/institutions/AU00000,,"Cafes, Restaurants and Takeaway Food Services",451
transaction,bb52b20b-6502-4b75-8c10-ec920542557c,posted,BLUEFIN SUSHI CHAT,-52.00,49544383-c19c-4c97-b8d1-5322d0faa6af,-6001.82,debit,payment,AU00000,5453f0a3-083c-43c6-9086-adfe94df9918,,,2022-10-18T00:00:00Z,,https://au-api.basiq.io/users/11103cba-4a08-4397-84a5-22ac125ed2f6/transactions/bb52b20b-6502-4b75-8c10-ec920542557c,https://au-api.basiq.io/users/11103cba-4a08-4397-84a5-22ac125ed2f6/accounts/49544383-c19c-4c97-b8d1-5322d0faa6af,https://au-api.basiq.io/institutions/AU00000,,"Cafes, Restaurants and Takeaway Food Services",451
transaction,e8406d7b-8f01-4951-b44c-473c92d76dd3,posted,FIKA SWEDISH KITCHEN MANL,-26.00,49544383-c19c-4c97-b8d1-5322d0faa6af,-5949.82,debit,payment,AU00000,5453f0a3-083c-43c6-9086-adfe94df9918,,,2022-10-18T00:00:00Z,,https://au-api.basiq.io/users/11103cba-4a08-4397-84a5-22ac125ed2f6/transactions/e8406d7b-8f01-4951-b44c-473c92d76dd3,https://au-api.basiq.io/users/11103cba-4a08-4397-84a5-22ac125ed2f6/accounts/49544383-c19c-4c97-b8d1-5322d0faa6af,https://au-api.basiq.io/institutions/AU00000,,"Cafes, Restaurants and Takeaway Food Services",451
transaction,5cb7ef20-0127-40c5-b34c-8bbac36c2eaa,posted,TASTE BAGUETTE GLNRS BELR,-21.90,49544383-c19c-4c97-b8d1-5322d0faa6af,-5923.82,debit,payment,AU00000,5453f0a3-083c-43c6-9086-adfe94df9918,,,2022-10-18T00:00:00Z,,https://au-api.basiq.io/users/11103cba-4a08-4397-84a5-22ac125ed2f6/transactions/5cb7ef20-0127-40c5-b34c-8bbac36c2eaa,https://au-api.basiq.io/users/11103cba-4a08-4397-84a5-22ac125ed2f6/accounts/49544383-c19c-4c97-b8d1-5322d0faa6af,https://au-api.basiq.io/institutions/AU00000,,"Cafes, Restaurants and Takeaway Food Services",451
transaction,54858ac7-ae1a-463a-ae87-863ba66c8213,posted,WOOLWORTHS 1063 FR FREN,-19.00,49544383-c19c-4c97-b8d1-5322d0faa6af,-5901.92,debit,payment,AU00000,5453f0a3-083c-43c6-9086-adfe94df9918,,,2022-10-18T00:00:00Z,,https://au-api.basiq.io/users/11103cba-4a08-4397-84a5-22ac125ed2f6/transactions/54858ac7-ae1a-463a-ae87-863ba66c8213,https://au-api.basiq.io/users/11103cba-4a08-4397-84a5-22ac125ed2f6/accounts/49544383-c19c-4c97-b8d1-5322d0faa6af,https://au-api.basiq.io/institutions/AU00000,,Supermarket and Grocery Stores,411
transaction,0819a2bc-6eea-4b0c-950c-12237a685296,posted,ART OF CHURRO PL CHAT,-15.95,49544383-c19c-4c97-b8d1-5322d0faa6af,-5882.92,debit,payment,AU00000,5453f0a3-083c-43c6-9086-adfe94df9918,,,2022-10-18T00:00:00Z,,https://au-api.basiq.io/users/11103cba-4a08-4397-84a5-22ac125ed2f6/transactions/0819a2bc-6eea-4b0c-950c-12237a685296,https://au-api.basiq.io/users/11103cba-4a08-4397-84a5-22ac125ed2f6/accounts/49544383-c19c-4c97-b8d1-5322d0faa6af,https://au-api.basiq.io/institutions/AU00000,,"Cafes, Restaurants and Takeaway Food Services",451
transaction,40c96b0a-1067-4fd0-b61e-c6071db13717,posted,NTH BEACHES CNL- SOUTH MANL,-10.60,49544383-c19c-4c97-b8d1-5322d0faa6af,-5866.97,debit,payment,AU00000,5453f0a3-083c-43c6-9086-adfe94df9918,,,2022-10-18T00:00:00Z,,https://au-api.basiq.io/users/11103cba-4a08-4397-84a5-22ac125ed2f6/transactions/40c96b0a-1067-4fd0-b61e-c6071db13717,https://au-api.basiq.io/users/11103cba-4a08-4397-84a5-22ac125ed2f6/accounts/49544383-c19c-4c97-b8d1-5322d0faa6af,https://au-api.basiq.io/institutions/AU00000,,Regulatory Services,772
transaction,2117440d-a002-40be-92f5-9a8db765ed43,posted,DOMINIE BOOKS BROOKVALE NSWAU,-15.95,49544383-c19c-4c97-b8d1-5322d0faa6af,-5856.37,debit,payment,AU00000,5453f0a3-083c-43c6-9086-adfe94df9918,,,2022-10-18T00:00:00Z,,https://au-api.basiq.io/users/11103cba-4a08-4397-84a5-22ac125ed2f6/transactions/2117440d-a002-40be-92f5-9a8db765ed43,https://au-api.basiq.io/users/11103cba-4a08-4397-84a5-22ac125ed2f6/accounts/49544383-c19c-4c97-b8d1-5322d0faa6af,https://au-api.basiq.io/institutions/AU00000,,Recreational Goods Retailing,424
transaction,8280270f-c7de-44f0-ad61-bba28a50866d,posted,ANN TERESA MCCARTHY MANL,-160.50,49544383-c19c-4c97-b8d1-5322d0faa6af,-5840.42,debit,payment,AU00000,5453f0a3-083c-43c6-9086-adfe94df9918,,,2022-10-17T00:00:00Z,,https://au-api.basiq.io/users/11103cba-4a08-4397-84a5-22ac125ed2f6/transactions/8280270f-c7de-44f0-ad61-bba28a50866d,https://au-api.basiq.io/users/11103cba-4a08-4397-84a5-22ac125ed2f6/accounts/49544383-c19c-4c97-b8d1-5322d0faa6af,https://au-api.basiq.io/institutions/AU00000,,Allied Health Services,853
transaction,c4ee978c-b5db-4d68-9b43-2dbf56406061,posted,WOOLWORTHS 1262 BELR,-97.24,49544383-c19c-4c97-b8d1-5322d0faa6af,-5679.92,debit,payment,AU00000,5453f0a3-083c-43c6-9086-adfe94df9918,,,2022-10-17T00:00:00Z,,https://au-api.basiq.io/users/11103cba-4a08-4397-84a5-22ac125ed2f6/transactions/c4ee978c-b5db-4d68-9b43-2dbf56406061,https://au-api.basiq.io/users/11103cba-4a08-4397-84a5-22ac125ed2f6/accounts/49544383-c19c-4c97-b8d1-5322d0faa6af,https://au-api.basiq.io/institutions/AU00000,,Supermarket and Grocery Stores,411
transaction,14915227-9d36-4daf-b9eb-972bb7abdf3d,posted,HEADYS PTY LTD BROO,-73.48,49544383-c19c-4c97-b8d1-5322d0faa6af,-5582.68,debit,payment,AU00000,5453f0a3-083c-43c6-9086-adfe94df9918,,,2022-10-17T00:00:00Z,,https://au-api.basiq.io/users/11103cba-4a08-4397-84a5-22ac125ed2f6/transactions/14915227-9d36-4daf-b9eb-972bb7abdf3d,https://au-api.basiq.io/users/11103cba-4a08-4397-84a5-22ac125ed2f6/accounts/49544383-c19c-4c97-b8d1-5322d0faa6af,https://au-api.basiq.io/institutions/AU00000,,Specialised Food Retailing,412
transaction,0773f017-88c1-4a90-888f-ce05314babe8,posted,REBEL BROOKVALE BROO,-33.98,49544383-c19c-4c97-b8d1-5322d0faa6af,-5509.20,debit,payment,AU00000,5453f0a3-083c-43c6-9086-adfe94df9918,,,2022-10-17T00:00:00Z,,https://au-api.basiq.io/users/11103cba-4a08-4397-84a5-22ac125ed2f6/transactions/0773f017-88c1-4a90-888f-ce05314babe8,https://au-api.basiq.io/users/11103cba-4a08-4397-84a5-22ac125ed2f6/accounts/49544383-c19c-4c97-b8d1-5322d0faa6af,https://au-api.basiq.io/institutions/AU00000,,Recreational Goods Retailing,424
transaction,bc714fe1-4def-4d99-8371-32aebeecaacd,posted,MLI HOLDINGS PTY LIM ST L,-24.50,49544383-c19c-4c97-b8d1-5322d0faa6af,-5475.22,debit,payment,AU00000,5453f0a3-083c-43c6-9086-adfe94df9918,,,2022-10-17T00:00:00Z,,https://au-api.basiq.io/users/11103cba-4a08-4397-84a5-22ac125ed2f6/transactions/bc714fe1-4def-4d99-8371-32aebeecaacd,https://au-api.basiq.io/users/11103cba-4a08-4397-84a5-22ac125ed2f6/accounts/49544383-c19c-4c97-b8d1-5322d0faa6af,https://au-api.basiq.io/institutions/AU00000,,"Cafes, Restaurants and Takeaway Food Services",451
transaction,cbde4c10-fb1d-4891-8478-f9014fa21006,posted,Momo Bar Manl,-16.00,49544383-c19c-4c97-b8d1-5322d0faa6af,-5450.72,debit,payment,AU00000,5453f0a3-083c-43c6-9086-adfe94df9918,,,2022-10-17T00:00:00Z,,https://au-api.basiq.io/users/11103cba-4a08-4397-84a5-22ac125ed2f6/transactions/cbde4c10-fb1d-4891-8478-f9014fa21006,https://au-api.basiq.io/users/11103cba-4a08-4397-84a5-22ac125ed2f6/accounts/49544383-c19c-4c97-b8d1-5322d0faa6af,https://au-api.basiq.io/institutions/AU00000,,"Cafes, Restaurants and Takeaway Food Services",451
transaction,bd31c6f7-1f21-4ed9-898e-2500495932e6,posted,WESTFIELD S/C CHAT,-8.00,49544383-c19c-4c97-b8d1-5322d0faa6af,-5434.72,debit,payment,AU00000,5453f0a3-083c-43c6-9086-adfe94df9918,,,2022-10-17T00:00:00Z,,https://au-api.basiq.io/users/11103cba-4a08-4397-84a5-22ac125ed2f6/transactions/bd31c6f7-1f21-4ed9-898e-2500495932e6,https://au-api.basiq.io/users/11103cba-4a08-4397-84a5-22ac125ed2f6/accounts/49544383-c19c-4c97-b8d1-5322d0faa6af,https://au-api.basiq.io/institutions/AU00000,,Property Operators,671
transaction,4ca3a3b6-db27-4b17-8098-cd1a9f23ee90,posted,HEADYS PTY LTD BROOKVALE AU,-20.36,49544383-c19c-4c97-b8d1-5322d0faa6af,-5426.72,debit,payment,AU00000,5453f0a3-083c-43c6-9086-adfe94df9918,,,2022-10-17T00:00:00Z,,https://au-api.basiq.io/users/11103cba-4a08-4397-84a5-22ac125ed2f6/transactions/4ca3a3b6-db27-4b17-8098-cd1a9f23ee90,https://au-api.basiq.io/users/11103cba-4a08-4397-84a5-22ac125ed2f6/accounts/49544383-c19c-4c97-b8d1-5322d0faa6af,https://au-api.basiq.io/institutions/AU00000,,Specialised Food Retailing,412
transaction,aae2ecb7-fc42-42e2-a918-38ec471b9d31,posted,OFARM ORGANIC GROCER BROOKVALE AU,-74.36,49544383-c19c-4c97-b8d1-5322d0faa6af,-5406.36,debit,payment,AU00000,5453f0a3-083c-43c6-9086-adfe94df9918,,,2022-10-17T00:00:00Z,,https://au-api.basiq.io/users/11103cba-4a08-4397-84a5-22ac125ed2f6/transactions/aae2ecb7-fc42-42e2-a918-38ec471b9d31,https://au-api.basiq.io/users/11103cba-4a08-4397-84a5-22ac125ed2f6/accounts/49544383-c19c-4c97-b8d1-5322d0faa6af,https://au-api.basiq.io/institutions/AU00000,,Supermarket and Grocery Stores,411
transaction,60b2f27b-a212-48e1-bb13-1f5b85598198,posted,Cash Wdr  MANLY MANLY,-101.00,49544383-c19c-4c97-b8d1-5322d0faa6af,-5332.00,debit,cash-withdrawal,AU00000,5453f0a3-083c-43c6-9086-adfe94df9918,,,2022-10-17T00:00:00Z,,https://au-api.basiq.io/users/11103cba-4a08-4397-84a5-22ac125ed2f6/transactions/60b2f27b-a212-48e1-bb13-1f5b85598198,https://au-api.basiq.io/users/11103cba-4a08-4397-84a5-22ac125ed2f6/accounts/49544383-c19c-4c97-b8d1-5322d0faa6af,https://au-api.basiq.io/institutions/AU00000,,,
transaction,c3572e9a-d5f1-4753-a404-7c84ad2d0fce,posted,BP ALLAMBIE 0754 ALLA,-63.25,49544383-c19c-4c97-b8d1-5322d0faa6af,-5231.00,debit,payment,AU00000,5453f0a3-083c-43c6-9086-adfe94df9918,,,2022-10-16T00:00:00Z,,https://au-api.basiq.io/users/11103cba-4a08-4397-84a5-22ac125ed2f6/transactions/c3572e9a-d5f1-4753-a404-7c84ad2d0fce,https://au-api.basiq.io/users/11103cba-4a08-4397-84a5-22ac125ed2f6/accounts/49544383-c19c-4c97-b8d1-5322d0faa6af,https://au-api.basiq.io/institutions/AU00000,,Fuel Retailing,400
transaction,6a4f69a7-5a12-4fbf-9880-a5aebeb4b217,posted,WARRINGAH MEDICAL WARR,-3.00,49544383-c19c-4c97-b8d1-5322d0faa6af,-5167.75,debit,payment,AU00000,5453f0a3-083c-43c6-9086-adfe94df9918,,,2022-10-16T00:00:00Z,,https://au-api.basiq.io/users/11103cba-4a08-4397-84a5-22ac125ed2f6/transactions/6a4f69a7-5a12-4fbf-9880-a5aebeb4b217,https://au-api.basiq.io/users/11103cba-4a08-4397-84a5-22ac125ed2f6/accounts/49544383-c19c-4c97-b8d1-5322d0faa6af,https://au-api.basiq.io/institutions/AU00000,,Other Personal Services,953
transaction,1d743bc3-719d-41c7-8fef-7e4de7bd4860,posted,WOOLWORTHS 1063 FRENCHS FRST NSW AU,-121.60,49544383-c19c-4c97-b8d1-5322d0faa6af,-5164.75,debit,payment,AU00000,5453f0a3-083c-43c6-9086-adfe94df9918,,,2022-10-16T00:00:00Z,,https://au-api.basiq.io/users/11103cba-4a08-4397-84a5-22ac125ed2f6/transactions/1d743bc3-719d-41c7-8fef-7e4de7bd4860,https://au-api.basiq.io/users/11103cba-4a08-4397-84a5-22ac125ed2f6/accounts/49544383-c19c-4c97-b8d1-5322d0faa6af,https://au-api.basiq.io/institutions/AU00000,,Supermarket and Grocery Stores,411
transaction,3ef50596-a715-4b48-a835-0341eeca690a,posted,STELLABLUBELROSE BELROSE AU,-71.30,49544383-c19c-4c97-b8d1-5322d0faa6af,-5043.15,debit,payment,AU00000,5453f0a3-083c-43c6-9086-adfe94df9918,,,2022-10-14T00:00:00Z,,https://au-api.basiq.io/users/11103cba-4a08-4397-84a5-22ac125ed2f6/transactions/3ef50596-a715-4b48-a835-0341eeca690a,https://au-api.basiq.io/users/11103cba-4a08-4397-84a5-22ac125ed2f6/accounts/49544383-c19c-4c97-b8d1-5322d0faa6af,https://au-api.basiq.io/institutions/AU00000,,"Cafes, Restaurants and Takeaway Food Services",451
transaction,87665535-b2a9-4a90-906d-0e7ac3961696,posted,Ruby Lane Wholefoods Manl,-31.50,49544383-c19c-4c97-b8d1-5322d0faa6af,-4971.85,debit,payment,AU00000,5453f0a3-083c-43c6-9086-adfe94df9918,,,2022-10-13T00:00:00Z,,https://au-api.basiq.io/users/11103cba-4a08-4397-84a5-22ac125ed2f6/transactions/87665535-b2a9-4a90-906d-0e7ac3961696,https://au-api.basiq.io/users/11103cba-4a08-4397-84a5-22ac125ed2f6/accounts/49544383-c19c-4c97-b8d1-5322d0faa6af,https://au-api.basiq.io/institutions/AU00000,,Specialised Food Retailing,412
transaction,a1237069-d337-47e8-815f-4127b2c167bf,posted,Only About Children Seaforth 1244301,-105.00,49544383-c19c-4c97-b8d1-5322d0faa6af,-4940.35,debit,payment,AU00000,5453f0a3-083c-43c6-9086-adfe94df9918,,,2022-10-13T00:00:00Z,,https://au-api.basiq.io/users/11103cba-4a08-4397-84a5-22ac125ed2f6/transactions/a1237069-d337-47e8-815f-4127b2c167bf,https://au-api.basiq.io/users/11103cba-4a08-4397-84a5-22ac125ed2f6/accounts/49544383-c19c-4c97-b8d1-5322d0faa6af,https://au-api.basiq.io/institutions/AU00000,,Other Health Care Services,859
transaction,c33a3135-e314-472f-b9a1-44b511d832c4,posted,OPTUS PREPAID MELBOURN,-40.00,49544383-c19c-4c97-b8d1-5322d0faa6af,-4835.35,debit,payment,AU00000,5453f0a3-083c-43c6-9086-adfe94df9918,,,2022-10-13T00:00:00Z,,https://au-api.basiq.io/users/11103cba-4a08-4397-84a5-22ac125ed2f6/transactions/c33a3135-e314-472f-b9a1-44b511d832c4,https://au-api.basiq.io/users/11103cba-4a08-4397-84a5-22ac125ed2f6/accounts/49544383-c19c-4c97-b8d1-5322d0faa6af,https://au-api.basiq.io/institutions/AU00000,,Telecommunications Services,580
transaction,b99843f9-a409-4cdf-adb5-8bcd34cccd4a,posted,ANN TERESA MCCARTHY MANL,-71.00,49544383-c19c-4c97-b8d1-5322d0faa6af,-4795.35,debit,payment,AU00000,5453f0a3-083c-43c6-9086-adfe94df9918,,,2022-10-12T00:00:00Z,,https://au-api.basiq.io/users/11103cba-4a08-4397-84a5-22ac125ed2f6/transactions/b99843f9-a409-4cdf-adb5-8bcd34cccd4a,https://au-api.basiq.io/users/11103cba-4a08-4397-84a5-22ac125ed2f6/accounts/49544383-c19c-4c97-b8d1-5322d0faa6af,https://au-api.basiq.io/institutions/AU00000,,Allied Health Services,853
transaction,b5f9ceb2-f3e0-42ea-a3c8-aa87c14af860,posted,HEADYS PTY LTD BROO,-45.16,49544383-c19c-4c97-b8d1-5322d0faa6af,-4724.35,debit,payment,AU00000,5453f0a3-083c-43c6-9086-adfe94df9918,,,2022-10-12T00:00:00Z,,https://au-api.basiq.io/users/11103cba-4a08-4397-84a5-22ac125ed2f6/transactions/b5f9ceb2-f3e0-42ea-a3c8-aa87c14af860,https://au-api.basiq.io/users/11103cba-4a08-4397-84a5-22ac125ed2f6/accounts/49544383-c19c-4c97-b8d1-5322d0faa6af,https://au-api.basiq.io/institutions/AU00000,,Specialised Food Retailing,412
transaction,91a9aedf-abe9-44a1-8e18-2898f8ed4306,posted,NAKED FOOD WARRINGAH BOND,-34.00,49544383-c19c-4c97-b8d1-5322d0faa6af,-4679.19,debit,payment,AU00000,5453f0a3-083c-43c6-9086-adfe94df9918,,,2022-10-12T00:00:00Z,,https://au-api.basiq.io/users/11103cba-4a08-4397-84a5-22ac125ed2f6/transactions/91a9aedf-abe9-44a1-8e18-2898f8ed4306,https://au-api.basiq.io/users/11103cba-4a08-4397-84a5-22ac125ed2f6/accounts/49544383-c19c-4c97-b8d1-5322d0faa6af,https://au-api.basiq.io/institutions/AU00000,,Specialised Food Retailing,412
transaction,755e49e2-3be8-4a10-8fda-16feba36b62a,posted,WARRINGAH MEDICAL WARR,-3.00,49544383-c19c-4c97-b8d1-5322d0faa6af,-4645.19,debit,payment,AU00000,5453f0a3-083c-43c6-9086-adfe94df9918,,,2022-10-12T00:00:00Z,,https://au-api.basiq.io/users/11103cba-4a08-4397-84a5-22ac125ed2f6/transactions/755e49e2-3be8-4a10-8fda-16feba36b62a,https://au-api.basiq.io/users/11103cba-4a08-4397-84a5-22ac125ed2f6/accounts/49544383-c19c-4c97-b8d1-5322d0faa6af,https://au-api.basiq.io/institutions/AU00000,,Other Personal Services,953
transaction,ea320d14-3731-4029-b172-b16ddaa14656,posted,WOOLWORTHS 1063 FRENCHS FRST NSW AU,-51.00,49544383-c19c-4c97-b8d1-5322d0faa6af,-4642.19,debit,payment,AU00000,5453f0a3-083c-43c6-9086-adfe94df9918,,,2022-10-12T00:00:00Z,,https://au-api.basiq.io/users/11103cba-4a08-4397-84a5-22ac125ed2f6/transactions/ea320d14-3731-4029-b172-b16ddaa14656,https://au-api.basiq.io/users/11103cba-4a08-4397-84a5-22ac125ed2f6/accounts/49544383-c19c-4c97-b8d1-5322d0faa6af,https://au-api.basiq.io/institutions/AU00000,,Supermarket and Grocery Stores,411
transaction,67bd6a23-b00b-4115-8f79-d95944dcbeed,posted,WOOLWORTHS 1262 BELR,-51.00,49544383-c19c-4c97-b8d1-5322d0faa6af,-4591.19,debit,payment,AU00000,5453f0a3-083c-43c6-9086-adfe94df9918,,,2022-10-11T00:00:00Z,,https://au-api.basiq.io/users/11103cba-4a08-4397-84a5-22ac125ed2f6/transactions/67bd6a23-b00b-4115-8f79-d95944dcbeed,https://au-api.basiq.io/users/11103cba-4a08-4397-84a5-22ac125ed2f6/accounts/49544383-c19c-4c97-b8d1-5322d0faa6af,https://au-api.basiq.io/institutions/AU00000,,Supermarket and Grocery Stores,411
transaction,e0c84894-751d-41f9-bb60-c04e2783b8bc,posted,LAISSEZ-FAIRE CATERE DARL,-70.50,49544383-c19c-4c97-b8d1-5322d0faa6af,-4540.19,debit,payment,AU00000,5453f0a3-083c-43c6-9086-adfe94df9918,,,2022-10-11T00:00:00Z,,https://au-api.basiq.io/users/11103cba-4a08-4397-84a5-22ac125ed2f6/transactions/e0c84894-751d-41f9-bb60-c04e2783b8bc,https://au-api.basiq.io/users/11103cba-4a08-4397-84a5-22ac125ed2f6/accounts/49544383-c19c-4c97-b8d1-5322d0faa6af,https://au-api.basiq.io/institutions/AU00000,,"Cafes, Restaurants and Takeaway Food Services",451
transaction,8ad8d252-0b60-4af5-974b-7843e74f0615,posted,FRTLLI PLITO PROD PL CROM,-53.00,49544383-c19c-4c97-b8d1-5322d0faa6af,-4469.69,debit,payment,AU00000,5453f0a3-083c-43c6-9086-adfe94df9918,,,2022-10-11T00:00:00Z,,https://au-api.basiq.io/users/11103cba-4a08-4397-84a5-22ac125ed2f6/transactions/8ad8d252-0b60-4af5-974b-7843e74f0615,https://au-api.basiq.io/users/11103cba-4a08-4397-84a5-22ac125ed2f6/accounts/49544383-c19c-4c97-b8d1-5322d0faa6af,https://au-api.basiq.io/institutions/AU00000,,Specialised Food Retailing,412
transaction,597ae7b6-3ead-4523-b6c6-1a375961b12c,posted,WOOLWORTHS 1282 BROO,-19.29,49544383-c19c-4c97-b8d1-5322d0faa6af,-4416.69,debit,payment,AU00000,5453f0a3-083c-43c6-9086-adfe94df9918,,,2022-10-11T00:00:00Z,,https://au-api.basiq.io/users/11103cba-4a08-4397-84a5-22ac125ed2f6/transactions/597ae7b6-3ead-4523-b6c6-1a375961b12c,https://au-api.basiq.io/users/11103cba-4a08-4397-84a5-22ac125ed2f6/accounts/49544383-c19c-4c97-b8d1-5322d0faa6af,https://au-api.basiq.io/institutions/AU00000,,Supermarket and Grocery Stores,411
transaction,c7087a75-a443-40ae-9ab6-1a7a91810110,posted,CITYOFSYDNEY PARKING SYDN,-11.80,49544383-c19c-4c97-b8d1-5322d0faa6af,-4397.40,debit,payment,AU00000,5453f0a3-083c-43c6-9086-adfe94df9918,,,2022-10-11T00:00:00Z,,https://au-api.basiq.io/users/11103cba-4a08-4397-84a5-22ac125ed2f6/transactions/c7087a75-a443-40ae-9ab6-1a7a91810110,https://au-api.basiq.io/users/11103cba-4a08-4397-84a5-22ac125ed2f6/accounts/49544383-c19c-4c97-b8d1-5322d0faa6af,https://au-api.basiq.io/institutions/AU00000,,Other Personal Services,953
transaction,6393a47d-39cb-48e0-8e1e-0aa67a1bf1ee,posted,MENULOG PTY LTD SYDN,-49.24,49544383-c19c-4c97-b8d1-5322d0faa6af,-4385.60,debit,payment,AU00000,5453f0a3-083c-43c6-9086-adfe94df9918,,,2022-10-10T00:00:00Z,,https://au-api.basiq.io/users/11103cba-4a08-4397-84a5-22ac125ed2f6/transactions/6393a47d-39cb-48e0-8e1e-0aa67a1bf1ee,https://au-api.basiq.io/users/11103cba-4a08-4397-84a5-22ac125ed2f6/accounts/49544383-c19c-4c97-b8d1-5322d0faa6af,https://au-api.basiq.io/institutions/AU00000,,"Cafes, Restaurants and Takeaway Food Services",451
transaction,5be8210e-33fc-4ebe-9fe6-69d1d9b19e53,posted,TRYBOOK,-42.20,49544383-c19c-4c97-b8d1-5322d0faa6af,-4336.36,debit,payment,AU00000,5453f0a3-083c-43c6-9086-adfe94df9918,,,2022-10-10T00:00:00Z,,https://au-api.basiq.io/users/11103cba-4a08-4397-84a5-22ac125ed2f6/transactions/5be8210e-33fc-4ebe-9fe6-69d1d9b19e53,https://au-api.basiq.io/users/11103cba-4a08-4397-84a5-22ac125ed2f6/accounts/49544383-c19c-4c97-b8d1-5322d0faa6af,https://au-api.basiq.io/institutions/AU00000,,Creative and Performing Arts Activities,900
transaction,59b36413-e71e-4e09-b217-fb861b795d94,posted,BOOKDEPOSITORY.COM 4414,-20.16,49544383-c19c-4c97-b8d1-5322d0faa6af,-4294.16,debit,payment,AU00000,5453f0a3-083c-43c6-9086-adfe94df9918,,,2022-10-10T00:00:00Z,,https://au-api.basiq.io/users/11103cba-4a08-4397-84a5-22ac125ed2f6/transactions/59b36413-e71e-4e09-b217-fb861b795d94,https://au-api.basiq.io/users/11103cba-4a08-4397-84a5-22ac125ed2f6/accounts/49544383-c19c-4c97-b8d1-5322d0faa6af,https://au-api.basiq.io/institutions/AU00000,,Recreational Goods Retailing,424
transaction,a6164621-03ed-4951-99cb-2d23427ca652,posted,WOOLWORTHS 1063 FR FREN,-13.60,49544383-c19c-4c97-b8d1-5322d0faa6af,-4274.00,debit,payment,AU00000,5453f0a3-083c-43c6-9086-adfe94df9918,,,2022-10-10T00:00:00Z,,https://au-api.basiq.io/users/11103cba-4a08-4397-84a5-22ac125ed2f6/transactions/a6164621-03ed-4951-99cb-2d23427ca652,https://au-api.basiq.io/users/11103cba-4a08-4397-84a5-22ac125ed2f6/accounts/49544383-c19c-4c97-b8d1-5322d0faa6af,https://au-api.basiq.io/institutions/AU00000,,Supermarket and Grocery Stores,411
transaction,fde92341-5720-4f8e-985b-ed9bd17f3715,posted,WOOLWORTHS 1262 BELR,-11.80,49544383-c19c-4c97-b8d1-5322d0faa6af,-4260.40,debit,payment,AU00000,5453f0a3-083c-43c6-9086-adfe94df9918,,,2022-10-10T00:00:00Z,,https://au-api.basiq.io/users/11103cba-4a08-4397-84a5-22ac125ed2f6/transactions/fde92341-5720-4f8e-985b-ed9bd17f3715,https://au-api.basiq.io/users/11103cba-4a08-4397-84a5-22ac125ed2f6/accounts/49544383-c19c-4c97-b8d1-5322d0faa6af,https://au-api.basiq.io/institutions/AU00000,,Supermarket and Grocery Stores,411
transaction,22b21e95-f118-4240-bd1d-50037586959a,posted,WOOLWORTHS 1262 BELR,-65.49,49544383-c19c-4c97-b8d1-5322d0faa6af,-4248.60,debit,payment,AU00000,5453f0a3-083c-43c6-9086-adfe94df9918,,,2022-10-09T00:00:00Z,,https://au-api.basiq.io/users/11103cba-4a08-4397-84a5-22ac125ed2f6/transactions/22b21e95-f118-4240-bd1d-50037586959a,https://au-api.basiq.io/users/11103cba-4a08-4397-84a5-22ac125ed2f6/accounts/49544383-c19c-4c97-b8d1-5322d0faa6af,https://au-api.basiq.io/institutions/AU00000,,Supermarket and Grocery Stores,411
transaction,c43b566f-a38c-4973-967c-e43cf4128662,posted,TPG Internet PTY LTD Nort,-60.99,49544383-c19c-4c97-b8d1-5322d0faa6af,-4183.11,debit,payment,AU00000,5453f0a3-083c-43c6-9086-adfe94df9918,,,2022-10-09T00:00:00Z,,https://au-api.basiq.io/users/11103cba-4a08-4397-84a5-22ac125ed2f6/transactions/c43b566f-a38c-4973-967c-e43cf4128662,https://au-api.basiq.io/users/11103cba-4a08-4397-84a5-22ac125ed2f6/accounts/49544383-c19c-4c97-b8d1-5322d0faa6af,https://au-api.basiq.io/institutions/AU00000,,Internet Service Providers and Web Search Portals,591
transaction,86438aaa-90b6-4729-840b-e466db5dcba9,posted,Pure Wholefoods MANL,-30.50,49544383-c19c-4c97-b8d1-5322d0faa6af,-4122.12,debit,payment,AU00000,5453f0a3-083c-43c6-9086-adfe94df9918,,,2022-10-09T00:00:00Z,,https://au-api.basiq.io/users/11103cba-4a08-4397-84a5-22ac125ed2f6/transactions/86438aaa-90b6-4729-840b-e466db5dcba9,https://au-api.basiq.io/users/11103cba-4a08-4397-84a5-22ac125ed2f6/accounts/49544383-c19c-4c97-b8d1-5322d0faa6af,https://au-api.basiq.io/institutions/AU00000,,"Cafes, Restaurants and Takeaway Food Services",451
transaction,a13038b4-b903-4f25-8ad1-5d51a976332c,posted,HOYTS SYDN,-73.00,49544383-c19c-4c97-b8d1-5322d0faa6af,-4091.62,debit,payment,AU00000,5453f0a3-083c-43c6-9086-adfe94df9918,,,2022-10-06T00:00:00Z,,https://au-api.basiq.io/users/11103cba-4a08-4397-84a5-22ac125ed2f6/transactions/a13038b4-b903-4f25-8ad1-5d51a976332c,https://au-api.basiq.io/users/11103cba-4a08-4397-84a5-22ac125ed2f6/accounts/49544383-c19c-4c97-b8d1-5322d0faa6af,https://au-api.basiq.io/institutions/AU00000,,Motion Picture and Video Activities,551
transaction,68afcd1f-e1f4-4733-8fec-43dcd580522e,posted,CTX WOW BELROSE BELR,-65.03,49544383-c19c-4c97-b8d1-5322d0faa6af,-4018.62,debit,payment,AU00000,5453f0a3-083c-43c6-9086-adfe94df9918,,,2022-10-06T00:00:00Z,,https://au-api.basiq.io/users/11103cba-4a08-4397-84a5-22ac125ed2f6/transactions/68afcd1f-e1f4-4733-8fec-43dcd580522e,https://au-api.basiq.io/users/11103cba-4a08-4397-84a5-22ac125ed2f6/accounts/49544383-c19c-4c97-b8d1-5322d0faa6af,https://au-api.basiq.io/institutions/AU00000,,Fuel Retailing,400
transaction,916d95c0-8ba0-4992-884f-dbc96d2061fc,posted,Kidstuff Manly Corso Manl,-40.99,49544383-c19c-4c97-b8d1-5322d0faa6af,-3953.59,debit,payment,AU00000,5453f0a3-083c-43c6-9086-adfe94df9918,,,2022-10-06T00:00:00Z,,https://au-api.basiq.io/users/11103cba-4a08-4397-84a5-22ac125ed2f6/transactions/916d95c0-8ba0-4992-884f-dbc96d2061fc,https://au-api.basiq.io/users/11103cba-4a08-4397-84a5-22ac125ed2f6/accounts/49544383-c19c-4c97-b8d1-5322d0faa6af,https://au-api.basiq.io/institutions/AU00000,,Recreational Goods Retailing,424
transaction,ec43344e-99e7-4dad-846b-125a5905cdc2,posted,FIKA SWEDISH KITCHEN MANL,-40.00,49544383-c19c-4c97-b8d1-5322d0faa6af,-3912.60,debit,payment,AU00000,5453f0a3-083c-43c6-9086-adfe94df9918,,,2022-10-06T00:00:00Z,,https://au-api.basiq.io/users/11103cba-4a08-4397-84a5-22ac125ed2f6/transactions/ec43344e-99e7-4dad-846b-125a5905cdc2,https://au-api.basiq.io/users/11103cba-4a08-4397-84a5-22ac125ed2f6/accounts/49544383-c19c-4c97-b8d1-5322d0faa6af,https://au-api.basiq.io/institutions/AU00000,,"Cafes, Restaurants and Takeaway Food Services",451
transaction,0db20aec-96f6-45ce-96ba-5c3213f919b4,posted,CHEMIST WAREHOUSE MANL,-30.98,49544383-c19c-4c97-b8d1-5322d0faa6af,-3872.60,debit,payment,AU00000,5453f0a3-083c-43c6-9086-adfe94df9918,,,2022-10-06T00:00:00Z,,https://au-api.basiq.io/users/11103cba-4a08-4397-84a5-22ac125ed2f6/transactions/0db20aec-96f6-45ce-96ba-5c3213f919b4,https://au-api.basiq.io/users/11103cba-4a08-4397-84a5-22ac125ed2f6/accounts/49544383-c19c-4c97-b8d1-5322d0faa6af,https://au-api.basiq.io/institutions/AU00000,,Pharmaceutical and Other Store-Based Retailing,427
transaction,4213859f-df9a-4f0f-9413-d7a3b7578415,posted,NTH BEACHES CNL- SOUTH MANL,-10.60,49544383-c19c-4c97-b8d1-5322d0faa6af,-3841.62,debit,payment,AU00000,5453f0a3-083c-43c6-9086-adfe94df9918,,,2022-10-06T00:00:00Z,,https://au-api.basiq.io/users/11103cba-4a08-4397-84a5-22ac125ed2f6/transactions/4213859f-df9a-4f0f-9413-d7a3b7578415,https://au-api.basiq.io/users/11103cba-4a08-4397-84a5-22ac125ed2f6/accounts/49544383-c19c-4c97-b8d1-5322d0faa6af,https://au-api.basiq.io/institutions/AU00000,,Regulatory Services,772
transaction,b5f89f71-ad93-4006-b36c-9368be1ae097,posted,Only About Children Seaforth 1244301,-157.00,49544383-c19c-4c97-b8d1-5322d0faa6af,-3831.02,debit,payment,AU00000,5453f0a3-083c-43c6-9086-adfe94df9918,,,2022-10-06T00:00:00Z,,https://au-api.basiq.io/users/11103cba-4a08-4397-84a5-22ac125ed2f6/transactions/b5f89f71-ad93-4006-b36c-9368be1ae097,https://au-api.basiq.io/users/11103cba-4a08-4397-84a5-22ac125ed2f6/accounts/49544383-c19c-4c97-b8d1-5322d0faa6af,https://au-api.basiq.io/institutions/AU00000,,Other Health Care Services,859
transaction,303dc2d1-5b5a-444e-ae63-01aabe1de0bf,posted,ANN TERESA MCCARTHY MANLY AU,-299.00,49544383-c19c-4c97-b8d1-5322d0faa6af,-3674.02,debit,payment,AU00000,5453f0a3-083c-43c6-9086-adfe94df9918,,,2022-10-06T00:00:00Z,,https://au-api.basiq.io/users/11103cba-4a08-4397-84a5-22ac125ed2f6/transactions/303dc2d1-5b5a-444e-ae63-01aabe1de0bf,https://au-api.basiq.io/users/11103cba-4a08-4397-84a5-22ac125ed2f6/accounts/49544383-c19c-4c97-b8d1-5322d0faa6af,https://au-api.basiq.io/institutions/AU00000,,Allied Health Services,853
transaction,d91e6a88-5f7c-4f13-952b-2cfaf8f25622,posted,WOOLWORTHS 1262 BELR,-12.64,49544383-c19c-4c97-b8d1-5322d0faa6af,-3375.02,debit,payment,AU00000,5453f0a3-083c-43c6-9086-adfe94df9918,,,2022-10-05T00:00:00Z,,https://au-api.basiq.io/users/11103cba-4a08-4397-84a5-22ac125ed2f6/transactions/d91e6a88-5f7c-4f13-952b-2cfaf8f25622,https://au-api.basiq.io/users/11103cba-4a08-4397-84a5-22ac125ed2f6/accounts/49544383-c19c-4c97-b8d1-5322d0faa6af,https://au-api.basiq.io/institutions/AU00000,,Supermarket and Grocery Stores,411
transaction,ba848064-4280-4e0c-81ef-4249beb0bb37,posted,ANN TERESA MCCARTHY MANLY AU,-86.00,49544383-c19c-4c97-b8d1-5322d0faa6af,-3362.38,debit,payment,AU00000,5453f0a3-083c-43c6-9086-adfe94df9918,,,2022-10-05T00:00:00Z,,https://au-api.basiq.io/users/11103cba-4a08-4397-84a5-22ac125ed2f6/transactions/ba848064-4280-4e0c-81ef-4249beb0bb37,https://au-api.basiq.io/users/11103cba-4a08-4397-84a5-22ac125ed2f6/accounts/49544383-c19c-4c97-b8d1-5322d0faa6af,https://au-api.basiq.io/institutions/AU00000,,Allied Health Services,853
transaction,e3c64331-acfa-4560-9219-fe622707c5db,posted,WOOLWORTHS 1262 BELR,-101.00,49544383-c19c-4c97-b8d1-5322d0faa6af,-3276.38,debit,payment,AU00000,5453f0a3-083c-43c6-9086-adfe94df9918,,,2022-10-04T00:00:00Z,,https://au-api.basiq.io/users/11103cba-4a08-4397-84a5-22ac125ed2f6/transactions/e3c64331-acfa-4560-9219-fe622707c5db,https://au-api.basiq.io/users/11103cba-4a08-4397-84a5-22ac125ed2f6/accounts/49544383-c19c-4c97-b8d1-5322d0faa6af,https://au-api.basiq.io/institutions/AU00000,,Supermarket and Grocery Stores,411
transaction,ec631ad3-7db6-45fd-b3ca-0a9e1dd0869a,posted,SERVICE NSW SYDN,-515.25,49544383-c19c-4c97-b8d1-5322d0faa6af,-3175.38,debit,payment,AU00000,5453f0a3-083c-43c6-9086-adfe94df9918,,,2022-10-04T00:00:00Z,,https://au-api.basiq.io/users/11103cba-4a08-4397-84a5-22ac125ed2f6/transactions/ec631ad3-7db6-45fd-b3ca-0a9e1dd0869a,https://au-api.basiq.io/users/11103cba-4a08-4397-84a5-22ac125ed2f6/accounts/49544383-c19c-4c97-b8d1-5322d0faa6af,https://au-api.basiq.io/institutions/AU00000,,Regulatory Services,772
transaction,5dd8050a-ab4b-4544-8e51-a9066b9cab18,posted,FRTLLI PLITO PROD PL CROM,-90.00,49544383-c19c-4c97-b8d1-5322d0faa6af,-2660.13,debit,payment,AU00000,5453f0a3-083c-43c6-9086-adfe94df9918,,,2022-10-04T00:00:00Z,,https://au-api.basiq.io/users/11103cba-4a08-4397-84a5-22ac125ed2f6/transactions/5dd8050a-ab4b-4544-8e51-a9066b9cab18,https://au-api.basiq.io/users/11103cba-4a08-4397-84a5-22ac125ed2f6/accounts/49544383-c19c-4c97-b8d1-5322d0faa6af,https://au-api.basiq.io/institutions/AU00000,,Specialised Food Retailing,412
transaction,c08c5032-f61f-4594-a180-f99c8a81198a,posted,HEADYS PTY LTD BROO,-42.82,49544383-c19c-4c97-b8d1-5322d0faa6af,-2570.13,debit,payment,AU00000,5453f0a3-083c-43c6-9086-adfe94df9918,,,2022-10-04T00:00:00Z,,https://au-api.basiq.io/users/11103cba-4a08-4397-84a5-22ac125ed2f6/transactions/c08c5032-f61f-4594-a180-f99c8a81198a,https://au-api.basiq.io/users/11103cba-4a08-4397-84a5-22ac125ed2f6/accounts/49544383-c19c-4c97-b8d1-5322d0faa6af,https://au-api.basiq.io/institutions/AU00000,,Specialised Food Retailing,412
transaction,a84f3a3d-2f22-4281-8958-6ab0f3b75273,posted,COLES 0897 BROO,-35.80,49544383-c19c-4c97-b8d1-5322d0faa6af,-2527.31,debit,payment,AU00000,5453f0a3-083c-43c6-9086-adfe94df9918,,,2022-10-04T00:00:00Z,,https://au-api.basiq.io/users/11103cba-4a08-4397-84a5-22ac125ed2f6/transactions/a84f3a3d-2f22-4281-8958-6ab0f3b75273,https://au-api.basiq.io/users/11103cba-4a08-4397-84a5-22ac125ed2f6/accounts/49544383-c19c-4c97-b8d1-5322d0faa6af,https://au-api.basiq.io/institutions/AU00000,,Supermarket and Grocery Stores,411
transaction,5e23f890-cdb4-46b6-b859-b644b08a14c1,posted,THAI KITCHEN GELNROS BELR,-23.90,49544383-c19c-4c97-b8d1-5322d0faa6af,-2491.51,debit,payment,AU00000,5453f0a3-083c-43c6-9086-adfe94df9918,,,2022-10-04T00:00:00Z,,https://au-api.basiq.io/users/11103cba-4a08-4397-84a5-22ac125ed2f6/transactions/5e23f890-cdb4-46b6-b859-b644b08a14c1,https://au-api.basiq.io/users/11103cba-4a08-4397-84a5-22ac125ed2f6/accounts/49544383-c19c-4c97-b8d1-5322d0faa6af,https://au-api.basiq.io/institutions/AU00000,,"Cafes, Restaurants and Takeaway Food Services",451
transaction,d2052b56-7445-4610-8be2-231f0599f2ef,posted,TASTE BAGUETTE GLNRS BELR,-21.20,49544383-c19c-4c97-b8d1-5322d0faa6af,-2467.61,debit,payment,AU00000,5453f0a3-083c-43c6-9086-adfe94df9918,,,2022-10-04T00:00:00Z,,https://au-api.basiq.io/users/11103cba-4a08-4397-84a5-22ac125ed2f6/transactions/d2052b56-7445-4610-8be2-231f0599f2ef,https://au-api.basiq.io/users/11103cba-4a08-4397-84a5-22ac125ed2f6/accounts/49544383-c19c-4c97-b8d1-5322d0faa6af,https://au-api.basiq.io/institutions/AU00000,,"Cafes, Restaurants and Takeaway Food Services",451
transaction,17d9c083-ab03-4a07-8767-924bb92aa3c1,posted,TARGET 5078 BROO,-9.00,49544383-c19c-4c97-b8d1-5322d0faa6af,-2446.41,debit,payment,AU00000,5453f0a3-083c-43c6-9086-adfe94df9918,,,2022-10-04T00:00:00Z,,https://au-api.basiq.io/users/11103cba-4a08-4397-84a5-22ac125ed2f6/transactions/17d9c083-ab03-4a07-8767-924bb92aa3c1,https://au-api.basiq.io/users/11103cba-4a08-4397-84a5-22ac125ed2f6/accounts/49544383-c19c-4c97-b8d1-5322d0faa6af,https://au-api.basiq.io/institutions/AU00000,,Department Stores,426
transaction,d32788ac-b00e-4e75-b301-52b0d44efa2e,posted,GIO BRIS,-885.49,49544383-c19c-4c97-b8d1-5322d0faa6af,-2437.41,debit,payment,AU00000,5453f0a3-083c-43c6-9086-adfe94df9918,,,2022-10-03T00:00:00Z,,https://au-api.basiq.io/users/11103cba-4a08-4397-84a5-22ac125ed2f6/transactions/d32788ac-b00e-4e75-b301-52b0d44efa2e,https://au-api.basiq.io/users/11103cba-4a08-4397-84a5-22ac125ed2f6/accounts/49544383-c19c-4c97-b8d1-5322d0faa6af,https://au-api.basiq.io/institutions/AU00000,,Health and General Insurance,632
transaction,35f817d1-034c-4e80-a17b-cafe6d886881,posted,SERVICE NSW SYDN,-273.19,49544383-c19c-4c97-b8d1-5322d0faa6af,-1551.92,debit,payment,AU00000,5453f0a3-083c-43c6-9086-adfe94df9918,,,2022-10-03T00:00:00Z,,https://au-api.basiq.io/users/11103cba-4a08-4397-84a5-22ac125ed2f6/transactions/35f817d1-034c-4e80-a17b-cafe6d886881,https://au-api.basiq.io/users/11103cba-4a08-4397-84a5-22ac125ed2f6/accounts/49544383-c19c-4c97-b8d1-5322d0faa6af,https://au-api.basiq.io/institutions/AU00000,,Regulatory Services,772
transaction,963afc35-4edb-4f68-b4f8-42d038505016,posted,ENERGYAUSTRALIA PTY LT MELB,-98.45,49544383-c19c-4c97-b8d1-5322d0faa6af,-1278.73,debit,payment,AU00000,5453f0a3-083c-43c6-9086-adfe94df9918,,,2022-10-03T00:00:00Z,,https://au-api.basiq.io/users/11103cba-4a08-4397-84a5-22ac125ed2f6/transactions/963afc35-4edb-4f68-b4f8-42d038505016,https://au-api.basiq.io/users/11103cba-4a08-4397-84a5-22ac125ed2f6/accounts/49544383-c19c-4c97-b8d1-5322d0faa6af,https://au-api.basiq.io/institutions/AU00000,,Electricity Distribution,263
transaction,a8238a5a-b25a-423e-b125-c7bf2c220c78,posted,WOOLWORTHS 1262 BELR,-36.30,49544383-c19c-4c97-b8d1-5322d0faa6af,-1180.28,debit,payment,AU00000,5453f0a3-083c-43c6-9086-adfe94df9918,,,2022-10-03T00:00:00Z,,https://au-api.basiq.io/users/11103cba-4a08-4397-84a5-22ac125ed2f6/transactions/a8238a5a-b25a-423e-b125-c7bf2c220c78,https://au-api.basiq.io/users/11103cba-4a08-4397-84a5-22ac125ed2f6/accounts/49544383-c19c-4c97-b8d1-5322d0faa6af,https://au-api.basiq.io/institutions/AU00000,,Supermarket and Grocery Stores,411
transaction,30bb53e5-c01e-47dd-8785-c8f21dacb5be,posted,GINSENG HEALTH FOODS FREN,-27.95,49544383-c19c-4c97-b8d1-5322d0faa6af,-1143.98,debit,payment,AU00000,5453f0a3-083c-43c6-9086-adfe94df9918,,,2022-10-03T00:00:00Z,,https://au-api.basiq.io/users/11103cba-4a08-4397-84a5-22ac125ed2f6/transactions/30bb53e5-c01e-47dd-8785-c8f21dacb5be,https://au-api.basiq.io/users/11103cba-4a08-4397-84a5-22ac125ed2f6/accounts/49544383-c19c-4c97-b8d1-5322d0faa6af,https://au-api.basiq.io/institutions/AU00000,,Specialised Food Retailing,412
transaction,35aa4eb2-5dcd-470a-9b11-9fe443db1c80,posted,NORTHERN BEACHES COUNCIL WARR,-21.00,49544383-c19c-4c97-b8d1-5322d0faa6af,-1116.03,debit,payment,AU00000,5453f0a3-083c-43c6-9086-adfe94df9918,,,2022-10-03T00:00:00Z,,https://au-api.basiq.io/users/11103cba-4a08-4397-84a5-22ac125ed2f6/transactions/35aa4eb2-5dcd-470a-9b11-9fe443db1c80,https://au-api.basiq.io/users/11103cba-4a08-4397-84a5-22ac125ed2f6/accounts/49544383-c19c-4c97-b8d1-5322d0faa6af,https://au-api.basiq.io/institutions/AU00000,,Regulatory Services,772
transaction,175bb092-f24e-48aa-9290-5c773b057f5a,posted,eDebit 201465-10558,-59.55,49544383-c19c-4c97-b8d1-5322d0faa6af,-1095.03,debit,payment,AU00000,5453f0a3-083c-43c6-9086-adfe94df9918,,,2022-10-03T00:00:00Z,,https://au-api.basiq.io/users/11103cba-4a08-4397-84a5-22ac125ed2f6/transactions/175bb092-f24e-48aa-9290-5c773b057f5a,https://au-api.basiq.io/users/11103cba-4a08-4397-84a5-22ac125ed2f6/accounts/49544383-c19c-4c97-b8d1-5322d0faa6af,https://au-api.basiq.io/institutions/AU00000,,Unknown,0
transaction,bd38363f-a3f8-40ec-bfaa-c9aad815d00f,posted,WOOLWORTHS 1262 BELR,-23.93,49544383-c19c-4c97-b8d1-5322d0faa6af,-1035.48,debit,payment,AU00000,5453f0a3-083c-43c6-9086-adfe94df9918,,,2022-10-02T00:00:00Z,,https://au-api.basiq.io/users/11103cba-4a08-4397-84a5-22ac125ed2f6/transactions/bd38363f-a3f8-40ec-bfaa-c9aad815d00f,https://au-api.basiq.io/users/11103cba-4a08-4397-84a5-22ac125ed2f6/accounts/49544383-c19c-4c97-b8d1-5322d0faa6af,https://au-api.basiq.io/institutions/AU00000,,Supermarket and Grocery Stores,411
transaction,45c30ec0-6430-40cd-8973-c4e22c8d53a2,posted,FORESTWAY PHARMACY FREN,-10.99,49544383-c19c-4c97-b8d1-5322d0faa6af,-1011.55,debit,payment,AU00000,5453f0a3-083c-43c6-9086-adfe94df9918,,,2022-10-02T00:00:00Z,,https://au-api.basiq.io/users/11103cba-4a08-4397-84a5-22ac125ed2f6/transactions/45c30ec0-6430-40cd-8973-c4e22c8d53a2,https://au-api.basiq.io/users/11103cba-4a08-4397-84a5-22ac125ed2f6/accounts/49544383-c19c-4c97-b8d1-5322d0faa6af,https://au-api.basiq.io/institutions/AU00000,,Pharmaceutical and Other Store-Based Retailing,427
transaction,1c70294a-349d-4700-a9d5-20ab24d4fe52,posted,TASTE BAGUETTE GLNRS BELR,-8.90,49544383-c19c-4c97-b8d1-5322d0faa6af,-1000.56,debit,payment,AU00000,5453f0a3-083c-43c6-9086-adfe94df9918,,,2022-10-02T00:00:00Z,,https://au-api.basiq.io/users/11103cba-4a08-4397-84a5-22ac125ed2f6/transactions/1c70294a-349d-4700-a9d5-20ab24d4fe52,https://au-api.basiq.io/users/11103cba-4a08-4397-84a5-22ac125ed2f6/accounts/49544383-c19c-4c97-b8d1-5322d0faa6af,https://au-api.basiq.io/institutions/AU00000,,"Cafes, Restaurants and Takeaway Food Services",451
transaction,110a806f-1408-4c94-bd27-3de5988a5740,posted,Savings Interest CR Bal @0%%,111.79,b2360b69-e3f3-49f3-bbc4-65d04865db02,26978.76,credit,interest,AU00000,5453f0a3-083c-43c6-9086-adfe94df9918,,,2022-12-29T00:00:00Z,,https://au-api.basiq.io/users/11103cba-4a08-4397-84a5-22ac125ed2f6/transactions/110a806f-1408-4c94-bd27-3de5988a5740,https://au-api.basiq.io/users/11103cba-4a08-4397-84a5-22ac125ed2f6/accounts/b2360b69-e3f3-49f3-bbc4-65d04865db02,https://au-api.basiq.io/institutions/AU00000,,,
transaction,25528073-263e-4533-aaed-609aaf2fb42b,posted,TFR Acc14000 TO 12389,500.00,b2360b69-e3f3-49f3-bbc4-65d04865db02,26866.97,credit,transfer,AU00000,5453f0a3-083c-43c6-9086-adfe94df9918,,,2022-12-12T00:00:00Z,,https://au-api.basiq.io/users/11103cba-4a08-4397-84a5-22ac125ed2f6/transactions/25528073-263e-4533-aaed-609aaf2fb42b,https://au-api.basiq.io/users/11103cba-4a08-4397-84a5-22ac125ed2f6/accounts/b2360b69-e3f3-49f3-bbc4-65d04865db02,https://au-api.basiq.io/institutions/AU00000,,,
transaction,5acd9335-b188-4544-a2fb-97ffcfa42af7,posted,Savings Interest CR Bal @0%%,109.91,b2360b69-e3f3-49f3-bbc4-65d04865db02,26366.97,credit,interest,AU00000,5453f0a3-083c-43c6-9086-adfe94df9918,,,2022-11-28T00:00:00Z,,https://au-api.basiq.io/users/11103cba-4a08-4397-84a5-22ac125ed2f6/transactions/5acd9335-b188-4544-a2fb-97ffcfa42af7,https://au-api.basiq.io/users/11103cba-4a08-4397-84a5-22ac125ed2f6/accounts/b2360b69-e3f3-49f3-bbc4-65d04865db02,https://au-api.basiq.io/institutions/AU00000,,,
transaction,1c47fdea-d566-4708-a887-419f5bad6ea0,posted,TFR Acc14000 TO 12389,500.00,b2360b69-e3f3-49f3-bbc4-65d04865db02,26257.06,credit,transfer,AU00000,5453f0a3-083c-43c6-9086-adfe94df9918,,,2022-11-11T00:00:00Z,,https://au-api.basiq.io/users/11103cba-4a08-4397-84a5-22ac125ed2f6/transactions/1c47fdea-d566-4708-a887-419f5bad6ea0,https://au-api.basiq.io/users/11103cba-4a08-4397-84a5-22ac125ed2f6/accounts/b2360b69-e3f3-49f3-bbc4-65d04865db02,https://au-api.basiq.io/institutions/AU00000,,,
transaction,d3ee9d6f-44cd-4105-9837-798a188b45db,posted,Savings Interest CR Bal @0%%,89.63,b2360b69-e3f3-49f3-bbc4-65d04865db02,25757.06,credit,interest,AU00000,5453f0a3-083c-43c6-9086-adfe94df9918,,,2022-10-28T00:00:00Z,,https://au-api.basiq.io/users/11103cba-4a08-4397-84a5-22ac125ed2f6/transactions/d3ee9d6f-44cd-4105-9837-798a188b45db,https://au-api.basiq.io/users/11103cba-4a08-4397-84a5-22ac125ed2f6/accounts/b2360b69-e3f3-49f3-bbc4-65d04865db02,https://au-api.basiq.io/institutions/AU00000,,,
transaction,c69dca85-b1f1-4fed-9122-41c25da2a888,posted,TFR Acc14000 TO 12389,500.00,b2360b69-e3f3-49f3-bbc4-65d04865db02,25667.43,credit,transfer,AU00000,5453f0a3-083c-43c6-9086-adfe94df9918,,,2022-10-12T00:00:00Z,,https://au-api.basiq.io/users/11103cba-4a08-4397-84a5-22ac125ed2f6/transactions/c69dca85-b1f1-4fed-9122-41c25da2a888,https://au-api.basiq.io/users/11103cba-4a08-4397-84a5-22ac125ed2f6/accounts/b2360b69-e3f3-49f3-bbc4-65d04865db02,https://au-api.basiq.io/institutions/AU00000,,,
